section_id;distributed_ballots;pre_registered_voters;registered_voters;onsite_listed_voters;voted_voters;unused_paper_ballots;destroyed_paper_ballots;urn_paper_ballots;invalid_paper_ballots;support_noone_paper_ballots;valid_paper_votes_for_parties;urn_machine_ballots;support_noone_machine_ballots;valid_machine_votes_for_parties
010100001;600;608;625;4;296;450;1;149;12;3;134;147;7;140
010100002;500;540;540;3;248;380;1;119;3;4;112;129;10;119
010100003;500;506;509;0;212;384;1;115;6;5;104;97;11;86
010100004;600;579;579;0;249;473;1;126;4;5;117;123;11;112
010100005;500;477;477;2;240;379;1;120;3;6;111;120;5;115
010100006;500;467;467;0;207;369;1;130;6;4;120;77;4;73
010100007;500;566;567;0;251;348;1;151;1;8;142;100;14;86
010100008;500;494;494;1;229;374;1;125;0;5;120;104;5;99
010100009;600;619;619;1;239;475;1;124;4;4;116;115;9;106
010100010;600;699;699;7;277;445;1;154;3;2;149;123;9;114
010100011;700;687;687;2;241;487;1;212;27;4;181;29;1;28
010100012;600;646;647;2;268;447;1;152;5;5;142;116;3;113
010100013;800;859;859;0;345;635;1;164;16;5;143;181;9;172
010100014;600;645;646;2;241;466;3;131;8;6;117;110;5;105
010100015;600;616;616;2;236;448;0;152;5;5;142;84;1;83
010100016;500;434;439;4;170;386;1;113;2;2;109;57;3;54
010100017;600;594;594;2;255;430;0;170;9;8;153;85;2;83
010100018;100;25;25;6;23;76;1;23;1;0;22;0;0;0
010100019;100;38;38;7;30;69;1;30;1;0;29;0;0;0
010100020;100;73;73;2;43;53;4;43;3;0;40;0;0;0
010100021;200;130;126;5;70;129;1;70;5;1;64;0;0;0
010100022;200;187;188;3;93;106;1;93;5;3;85;0;0;0
010100023;500;526;526;3;257;273;1;226;15;1;210;31;0;31
010200001;400;562;587;0;221;231;1;168;6;0;162;53;3;50
010200002;700;819;819;1;306;418;1;281;8;3;270;25;0;25
010200003;600;697;701;4;328;332;1;268;6;4;258;60;3;57
010200004;500;551;555;0;265;296;1;203;14;7;182;62;1;61
010200005;600;626;626;5;414;189;1;410;20;11;379;4;0;4
010200006;700;722;743;3;463;327;1;372;2;4;366;91;2;89
010200007;700;703;717;6;364;508;1;191;8;4;179;173;1;172
010200008;600;627;644;7;303;400;2;198;8;5;185;105;2;103
010200009;800;945;957;3;569;232;1;567;17;7;543;2;0;2
010200010;200;165;165;4;144;55;1;144;2;0;142;0;0;0
010200011;600;564;590;3;507;471;1;128;0;0;128;379;0;379
010200012;100;31;31;5;22;77;1;22;0;0;22;0;0;0
010200013;200;188;188;3;147;52;1;147;0;0;147;0;0;0
010200014;200;170;170;4;135;64;1;135;3;0;132;0;0;0
010200015;200;200;200;5;197;1;2;197;1;0;196;0;0;0
010200016;130;121;121;5;100;29;1;100;5;1;94;0;0;0
010200017;70;66;66;5;30;39;1;30;0;0;30;0;0;0
010200018;80;75;75;0;74;5;1;74;5;0;69;0;0;0
010200019;120;110;110;0;108;12;0;108;0;0;108;0;0;0
010300001;500;321;574;5;212;393;4;103;3;2;98;109;3;106
010300002;300;343;343;9;126;231;1;68;4;2;62;58;3;55
010300003;500;441;484;7;175;415;1;84;5;3;76;91;5;86
010300004;500;176;548;7;176;407;1;92;6;1;85;84;1;83
010300005;600;625;625;8;232;473;3;124;1;4;119;108;7;101
010300006;600;614;614;8;187;484;1;115;5;6;104;72;3;69
010300007;600;645;645;9;123;488;2;110;26;0;84;13;0;13
010300008;600;665;667;9;184;474;3;123;7;4;112;61;2;59
010300009;600;683;683;6;171;460;1;139;8;1;130;32;2;30
010300010;600;672;672;5;181;476;1;123;12;2;109;58;0;58
010300011;600;595;595;5;196;464;1;135;1;7;127;61;2;59
010300012;500;578;578;3;183;402;1;97;1;2;94;86;4;82
010300013;500;562;562;6;188;397;1;102;4;1;97;86;5;81
010300014;500;539;539;4;215;393;1;106;2;1;103;109;2;107
010300015;500;475;475;4;180;395;2;103;1;0;102;77;5;72
010300016;500;581;582;7;261;360;1;139;3;3;133;122;2;120
010300017;500;517;517;5;173;425;1;74;2;2;70;99;2;97
010300018;600;595;596;7;229;479;1;120;3;2;115;109;3;106
010300019;500;528;528;7;126;432;3;65;2;1;62;61;2;59
010300020;500;550;550;5;206;392;1;107;0;0;107;99;1;98
010300021;400;384;386;4;149;333;1;66;1;1;64;83;3;80
010300022;500;488;532;6;176;410;2;88;2;3;83;88;5;83
010300023;600;618;618;7;231;493;1;106;3;3;100;125;5;120
010300024;500;519;521;6;218;371;1;128;3;1;124;90;1;89
010300025;600;589;590;7;195;441;1;158;3;4;151;37;1;36
010300026;700;715;718;7;251;569;1;130;3;4;123;121;3;118
010300027;600;567;649;7;225;504;2;94;1;2;91;131;1;130
010300028;600;614;614;12;244;485;1;114;2;2;110;130;4;126
010300029;600;618;618;6;250;473;6;121;6;2;113;129;5;124
010300030;600;694;694;2;231;479;1;120;1;1;118;111;4;107
010300031;600;662;663;7;227;481;1;118;2;2;114;109;3;106
010300032;300;310;310;7;107;250;1;49;0;0;49;58;3;55
010300033;800;863;864;17;363;612;1;187;1;7;179;176;5;171
010300034;600;630;633;3;257;466;1;133;5;2;126;124;1;123
010300035;500;569;571;6;176;415;1;84;4;2;78;92;0;92
010300036;700;664;721;5;292;543;2;155;7;2;146;137;7;130
010300037;600;629;630;12;233;485;1;114;0;2;112;119;2;117
010300038;500;472;472;7;178;410;1;89;3;2;84;89;3;86
010300039;500;585;585;5;271;374;1;125;2;3;120;146;2;144
010300040;700;721;721;7;270;577;1;122;3;1;118;148;6;142
010300041;500;533;536;7;176;425;1;74;2;0;72;102;5;97
010300042;600;620;620;5;242;479;1;120;7;3;110;122;2;120
010300043;700;715;716;4;258;549;8;143;7;2;134;115;6;109
010300044;400;462;462;6;160;300;1;99;4;4;91;61;2;59
010300045;400;411;412;6;139;350;1;49;3;0;46;90;2;88
010300046;600;617;619;7;232;497;1;102;3;3;96;130;5;125
010300047;600;645;645;17;214;483;7;110;5;2;103;104;5;99
010300048;600;630;632;4;232;489;1;110;3;3;104;122;4;118
010300049;600;602;603;5;217;1;1;92;0;1;91;125;3;122
010300050;400;429;429;6;172;297;1;102;4;1;97;70;4;66
010300051;600;632;632;8;249;481;1;118;0;2;116;131;5;126
010300052;400;411;411;6;158;317;2;81;2;2;77;77;6;71
010300053;500;565;565;9;179;389;1;110;4;4;102;69;1;68
010300054;500;583;585;4;183;389;2;109;2;1;106;74;5;69
010300055;500;524;524;5;141;409;2;89;3;4;82;52;4;48
010300056;500;573;573;6;180;398;2;100;3;0;97;80;2;78
010300057;600;616;616;4;213;472;1;127;10;1;116;86;5;81
010300058;600;605;607;5;198;487;1;112;3;4;105;86;2;84
010300059;600;618;618;6;197;481;1;118;1;4;113;79;3;76
010300060;500;543;570;7;159;399;1;100;6;3;91;59;2;57
010300061;500;498;522;8;209;373;1;126;6;2;118;83;2;81
010300062;400;441;441;3;146;303;3;94;4;1;89;52;2;50
010300063;500;471;471;5;148;407;1;92;6;1;85;56;4;52
010300064;600;596;596;5;173;489;1;110;4;0;106;63;3;60
010300065;500;472;474;5;155;404;1;95;5;2;88;60;2;58
010300066;500;551;551;5;182;396;1;103;1;1;101;79;2;77
010300067;500;572;572;7;173;401;1;98;5;3;90;75;3;72
010300068;500;535;537;5;154;401;1;98;4;3;91;56;2;54
010300069;500;575;575;9;183;387;2;111;0;3;108;72;3;69
010300070;600;613;613;4;174;501;1;98;4;3;91;76;6;70
010300071;500;582;584;6;205;385;1;114;5;0;109;91;2;89
010300072;500;524;524;6;193;390;1;109;1;1;107;84;6;78
010300073;500;557;559;5;202;362;3;135;5;2;128;67;3;64
010300074;500;534;534;8;166;414;2;84;2;0;82;82;2;80
010300075;500;571;571;4;217;385;1;114;1;3;110;103;1;102
010300076;400;414;414;7;158;327;1;72;1;1;70;86;4;82
010300077;600;616;616;7;189;486;1;113;6;3;104;76;2;74
010300078;500;549;549;7;193;396;1;103;1;1;101;90;3;87
010300079;500;528;528;6;196;367;2;131;3;4;124;65;1;64
010300080;500;486;486;5;181;381;1;118;4;2;112;63;2;61
010300081;400;440;440;4;129;289;1;110;5;4;101;19;0;19
010300082;600;602;602;6;182;485;2;113;6;1;106;69;0;69
010300083;500;583;584;7;193;360;1;139;4;1;134;54;6;48
010300084;600;601;601;5;217;469;2;129;6;4;119;88;4;84
010300085;500;511;511;5;190;390;1;109;7;0;102;81;3;78
010300086;500;540;540;5;189;393;1;106;5;4;97;83;3;80
010300087;500;499;499;6;131;412;1;87;0;0;87;44;1;43
010300088;600;592;592;6;189;486;2;112;5;1;106;77;5;72
010300089;500;566;567;6;170;401;1;98;4;1;93;72;1;71
010300090;500;529;530;6;157;408;2;90;5;2;83;67;2;65
010300091;400;454;454;5;154;314;2;84;3;0;81;70;2;68
010300092;600;606;607;7;232;461;1;138;9;1;128;94;2;92
010300093;600;644;645;8;225;480;1;119;3;2;114;106;5;101
010300094;500;514;514;7;173;409;1;90;4;2;84;83;1;82
010300095;700;750;751;9;281;550;1;149;2;6;141;132;7;125
010300096;800;929;929;9;351;627;3;170;3;0;167;181;3;178
010300097;400;401;401;5;128;341;1;58;2;0;56;70;2;68
010300098;600;629;629;8;243;461;2;137;5;1;131;106;3;103
010300099;500;567;569;6;165;363;1;136;29;2;105;29;1;28
010300100;600;650;650;6;165;490;1;109;10;0;99;56;1;55
010300101;500;518;518;8;204;310;1;189;1;5;183;15;0;15
010300102;500;549;550;8;179;413;1;86;2;2;82;93;3;90
010300103;400;354;356;6;101;355;1;44;0;1;43;57;2;55
010300104;600;290;700;5;290;442;1;157;1;5;151;133;3;130
010300105;500;489;489;4;189;383;1;116;2;3;111;73;2;71
010300106;400;345;379;7;112;349;1;50;1;1;48;62;4;58
010300107;400;415;415;5;140;349;1;50;0;1;49;90;8;82
010300108;500;582;583;7;236;359;1;140;4;4;132;96;3;93
010300109;500;482;483;8;142;414;1;85;3;3;79;57;0;57
010300110;400;437;437;7;166;303;2;95;5;2;88;71;5;66
010300111;500;573;576;6;187;380;1;119;5;5;109;68;4;64
010300112;600;640;640;5;220;495;1;104;4;2;98;116;3;113
010300113;500;561;561;8;182;378;1;121;4;1;116;61;1;60
010300114;500;509;509;6;175;384;4;112;3;2;107;63;3;60
010300115;600;595;595;9;232;464;1;135;4;1;130;97;10;87
010300116;500;539;539;10;19;480;1;19;0;0;19;0;0;0
010300117;500;513;513;8;30;469;1;30;1;0;29;0;0;0
010300118;100;81;81;6;15;84;1;15;1;0;14;0;0;0
010300119;600;512;658;7;193;480;1;119;2;1;116;74;1;73
010300120;600;605;609;4;287;351;1;248;21;3;224;39;0;39
010300121;2500;2500;2824;7;330;2300;1;199;8;4;187;131;4;127
010300122;100;22;22;6;18;81;1;18;0;0;18;0;0;0
010300123;400;452;452;7;137;309;1;90;6;1;83;47;3;44
010300124;500;553;553;9;47;455;2;43;3;0;40;4;0;4
010300125;700;706;706;10;20;679;1;20;0;1;19;0;0;0
010300126;100;48;48;8;8;91;1;8;0;0;8;0;0;0
010300127;1200;1299;1299;9;54;1154;1;45;3;0;42;9;0;9
010300128;800;913;913;7;29;778;1;21;1;0;20;8;0;8
010300129;3400;11650;11651;5;188;3272;1;127;9;5;113;61;1;60
010300130;900;749;1057;6;245;759;1;140;7;3;130;105;2;103
010300131;600;628;628;9;101;519;1;80;3;2;75;21;0;21
010300132;200;201;201;6;96;103;1;96;5;1;90;0;0;0
010300133;700;769;769;8;98;624;2;74;4;0;70;24;1;23
010300134;400;374;374;7;33;367;1;32;0;0;32;1;0;1
010300135;300;295;295;5;85;213;2;85;5;1;79;0;0;0
010300136;200;157;157;6;56;143;1;56;2;3;51;0;0;0
010300137;5100;5899;5892;7;91;5022;1;77;2;0;75;14;0;14
010300138;100;72;72;7;30;69;1;30;2;0;28;0;0;0
010300139;500;472;472;7;93;438;2;60;3;1;56;33;1;32
010300140;100;13;13;7;16;81;3;16;0;0;16;0;0;0
010300146;100;17;17;1;18;81;1;18;0;0;18;0;0;0
010300147;100;55;55;7;31;68;1;31;5;1;25;0;0;0
011100001;800;935;935;1;360;590;2;208;2;4;202;152;11;141
011100002;800;840;845;0;268;607;10;183;5;5;173;85;3;82
011100003;900;932;932;4;337;689;1;210;10;5;195;127;6;121
011100004;700;705;712;0;294;516;3;181;2;6;173;113;7;106
011100005;700;639;645;1;241;562;2;136;4;5;127;105;6;99
011100006;700;704;742;2;303;529;5;166;4;0;162;137;4;133
011100007;600;537;537;5;207;478;1;121;1;3;117;86;3;83
011100008;800;829;830;1;334;594;7;199;6;4;189;135;4;131
011100009;700;718;720;0;296;440;1;259;6;8;245;37;0;37
011100010;600;578;579;0;211;465;1;134;8;1;125;77;6;71
011100011;600;623;626;6;234;457;1;142;10;1;131;92;10;82
011100012;800;798;779;0;300;586;1;213;5;6;202;87;1;86
011100013;700;702;704;2;274;524;0;176;6;5;165;98;6;92
011100014;900;841;842;3;248;761;3;136;4;2;130;112;3;109
011100015;900;836;837;3;210;770;1;129;5;4;120;81;3;78
011100016;700;812;812;1;266;554;1;145;10;3;132;121;5;116
011100017;700;965;965;0;274;535;3;162;6;3;153;112;3;109
011100018;800;991;991;1;229;607;1;192;17;0;175;37;1;36
011100019;800;1139;1139;1;209;578;27;195;27;1;167;14;0;14
011100020;700;691;693;3;255;539;2;159;6;4;149;96;5;91
011100021;700;822;846;4;350;498;1;201;9;7;185;149;11;138
011100022;700;842;846;3;323;501;8;191;7;4;180;132;7;125
011100024;700;651;655;1;236;500;1;199;4;2;193;37;2;35
011100025;600;604;604;2;198;457;2;141;6;1;134;57;4;53
011100026;500;470;470;2;179;347;2;151;5;8;138;28;0;28
011100027;500;462;463;0;155;381;1;118;5;3;110;37;6;31
011100028;500;438;438;1;142;379;1;120;5;5;110;22;0;22
011100029;500;467;467;3;184;342;1;157;7;3;147;27;1;26
011100030;500;388;388;3;165;356;1;143;4;0;139;22;1;21
011100031;900;853;853;3;574;341;1;558;23;4;531;16;1;15
011100032;700;715;720;4;375;328;1;371;21;1;349;4;1;3
011100033;700;664;696;6;381;344;0;356;16;5;335;25;1;24
011100034;800;833;834;3;435;365;2;433;31;3;399;2;1;1
011100035;800;810;810;7;399;407;1;392;31;6;355;7;0;7
011100036;500;489;491;5;178;366;1;133;9;3;121;45;1;44
011100037;600;563;567;6;175;445;1;154;2;1;151;21;1;20
011100038;700;662;662;12;188;543;1;156;3;2;151;32;0;32
011100039;900;823;823;1;295;625;2;273;14;2;257;22;0;22
011100040;800;730;739;6;265;537;1;262;17;6;239;3;0;3
011100041;50;22;22;8;17;32;1;17;0;1;16;0;0;0
011100042;50;27;27;7;20;28;2;20;1;0;19;0;0;0
011100043;200;90;90;0;88;112;0;88;0;1;87;0;0;0
011100044;100;54;54;0;50;50;0;50;1;0;49;0;0;0
011300001;800;822;822;3;346;492;1;307;6;0;301;39;0;39
011300002;700;705;710;2;286;511;2;187;5;4;178;99;3;96
011300003;150;150;150;0;63;86;1;63;3;2;58;0;0;0
011300004;900;843;845;2;571;362;1;537;0;0;537;34;0;34
011300005;800;761;767;1;597;274;1;525;0;0;525;72;3;69
011300006;700;654;659;1;546;190;1;509;7;0;502;37;0;37
011300007;600;615;623;4;452;159;1;440;4;5;431;12;1;11
011300008;1000;1020;1031;4;450;566;1;433;0;5;428;17;0;17
011300009;900;940;965;1;592;340;2;558;3;3;552;34;0;34
011300010;800;832;848;4;374;431;17;352;16;3;333;22;1;21
011300011;100;43;43;0;21;78;1;21;0;1;20;0;0;0
011300012;200;208;205;3;72;127;1;72;0;0;72;0;0;0
011300013;200;127;127;1;68;131;1;68;2;5;61;0;0;0
011300014;700;654;656;3;298;460;2;238;13;5;220;60;2;58
011300015;700;736;740;0;355;425;1;274;22;6;246;81;3;78
011300016;200;158;158;4;100;98;2;100;9;0;91;0;0;0
011300017;500;444;444;3;254;245;1;254;11;2;241;0;0;0
011300018;900;888;908;6;775;136;2;762;13;9;740;13;0;13
011300019;800;706;720;0;426;377;12;411;9;7;395;15;1;14
011300020;800;702;713;0;423;415;2;383;15;6;362;40;3;37
011300021;300;231;231;3;160;139;1;160;3;1;156;0;0;0
011300022;1000;1040;1040;0;380;619;1;380;3;5;372;0;0;0
011300023;100;47;47;0;45;55;0;45;1;0;44;0;0;0
011300024;100;61;61;1;61;39;0;61;0;0;61;0;0;0
012800001;600;559;566;4;230;456;1;143;10;2;131;87;2;85
012800002;600;587;591;2;180;485;1;114;7;2;105;66;0;66
012800003;600;525;528;0;232;480;1;119;4;4;111;113;4;109
012800004;600;573;573;2;260;412;1;187;1;6;180;73;3;70
012800005;600;592;592;1;215;458;1;141;14;0;127;74;2;72
012800006;400;365;366;6;122;297;1;102;5;2;95;20;0;20
012800007;450;482;489;5;194;312;1;137;4;1;132;57;0;57
012800008;400;450;458;2;195;236;2;162;14;1;147;33;1;32
012800009;100;50;50;3;26;73;1;26;2;0;24;0;0;0
012800010;100;72;72;5;52;47;1;52;5;0;47;0;0;0
012800011;50;28;28;1;29;20;1;29;1;0;28;0;0;0
013300001;800;871;871;6;254;654;1;145;8;3;134;109;2;107
013300002;800;842;842;3;241;646;1;153;4;3;146;88;1;87
013300003;900;238;931;7;238;760;1;139;0;3;136;99;3;96
013300004;900;916;916;3;238;741;1;158;5;2;151;80;2;78
013300005;900;958;958;2;230;764;1;135;2;1;132;95;2;93
013300006;800;863;863;0;240;661;10;129;9;5;115;111;5;106
013300007;900;735;890;10;250;726;1;173;1;3;169;77;19;58
013300008;900;919;919;3;292;710;11;179;8;2;169;113;0;113
013300009;900;918;918;2;270;743;2;155;5;3;147;115;3;112
013300010;900;987;983;4;249;737;1;162;7;7;148;87;2;85
013300011;900;981;981;5;222;791;1;108;11;1;96;114;1;113
013300012;1000;675;1007;5;170;909;1;90;3;2;85;80;2;78
013300013;900;862;856;6;220;754;1;145;4;3;138;75;1;74
013300014;900;881;881;4;232;721;1;178;9;5;164;54;1;53
013300015;900;928;928;0;142;813;1;86;5;1;80;56;2;54
013300016;900;921;921;3;248;734;1;165;7;5;153;83;3;80
013300017;900;891;892;6;230;691;1;208;11;4;193;22;0;18
013300018;1000;801;966;3;239;851;2;147;18;2;127;92;1;91
013300019;1000;947;947;5;176;865;2;133;8;0;125;43;1;42
013300020;1000;1063;1063;8;284;858;1;141;2;0;139;143;7;136
013300021;1000;974;977;4;189;891;1;108;7;3;98;81;1;80
013300022;1000;984;984;1;249;831;1;168;8;2;158;81;1;80
013300023;700;794;794;6;291;521;1;178;4;1;173;113;8;105
013300024;700;813;814;5;213;573;1;126;2;3;121;87;0;87
013300025;900;923;924;4;240;771;1;128;5;2;121;112;2;110
013300026;900;970;970;6;268;750;1;149;9;1;139;119;3;116
013300027;1000;988;988;4;178;899;1;100;5;3;92;78;1;77
013300028;900;936;936;4;266;730;0;170;5;1;164;96;7;89
013300029;800;795;795;4;196;688;2;110;5;6;99;86;2;84
013300030;900;653;911;2;172;733;1;166;31;0;135;6;0;6
013300031;800;770;771;1;264;535;1;264;53;0;211;0;0;0
013300032;900;878;903;0;170;730;1;169;0;1;168;1;0;1
013300033;900;734;926;1;218;730;2;168;17;0;151;50;4;46
013300034;900;891;891;1;246;759;1;140;12;2;126;106;4;102
013300035;900;913;913;7;219;761;1;138;17;1;120;81;4;77
013300036;800;809;809;4;199;682;1;117;5;3;109;82;3;79
013300037;400;425;439;5;207;237;3;160;13;3;144;47;1;46
013300038;600;585;585;4;302;358;0;242;9;3;230;60;1;59
013300039;400;329;329;7;97;309;0;91;5;1;85;6;0;6
013300040;200;230;230;4;97;95;8;97;7;1;89;0;0;0
013300041;500;499;499;2;197;359;1;140;6;6;128;57;1;56
013300042;600;545;545;4;215;444;1;155;7;4;144;60;5;55
013300043;100;95;95;3;57;42;1;57;11;0;46;0;0;0
013300044;200;139;140;5;76;124;0;76;2;0;74;0;0;0
013300045;100;109;109;5;49;51;0;49;3;0;46;0;0;0
013300046;600;554;554;2;234;409;1;190;13;1;176;44;1;43
013300047;600;609;626;8;270;411;0;189;6;3;180;81;1;80
013300048;100;89;89;3;47;52;1;47;3;0;44;0;0;0
013300049;300;88;260;4;92;206;2;92;2;0;90;0;0;0
013300050;200;172;173;4;113;86;1;113;3;0;110;0;0;0
013300051;800;815;815;5;272;578;2;220;8;1;211;52;0;52
013300052;600;604;604;0;215;414;1;185;5;2;178;30;6;24
013300053;400;421;424;4;173;253;1;146;2;1;143;27;0;27
013300054;400;401;401;4;172;265;1;134;7;2;125;38;0;38
013300055;500;157;454;157;161;410;1;89;4;0;84;73;3;70
013300056;400;437;437;2;130;298;1;101;3;1;97;29;1;28
013300057;426;426;426;1;159;279;1;146;2;2;142;13;0;13
013300058;100;111;111;4;38;61;1;38;4;0;34;0;0;0
013300059;600;615;615;6;215;479;1;120;2;3;115;95;2;93
013300060;600;589;589;3;159;493;0;107;9;3;95;52;1;51
013300061;600;546;569;2;176;469;2;129;5;0;124;47;1;46
013300062;600;573;575;1;164;493;1;106;6;3;97;58;1;57
013300063;600;560;582;6;180;490;1;109;5;2;102;71;0;71
013300064;700;716;716;7;340;387;1;312;25;1;286;28;3;25
013300065;600;556;556;2;198;428;0;172;8;2;162;26;0;26
013300066;300;325;325;3;98;218;1;81;5;0;76;17;0;17
013300067;100;103;103;7;49;50;1;49;8;1;40;0;0;0
013300068;100;78;80;5;43;50;7;43;6;0;37;0;0;0
013300069;100;24;52;6;24;75;1;24;0;2;22;0;0;0
013300070;200;140;140;7;60;139;1;60;5;0;55;0;0;0
013300071;200;183;183;4;81;118;1;81;4;1;76;0;0;0
013300072;200;120;120;5;47;152;1;47;5;1;41;0;0;0
013300073;400;327;327;3;150;272;1;127;0;0;127;23;3;20
013300074;100;77;77;6;31;68;1;31;0;2;29;0;0;0
013300075;100;74;74;8;53;46;1;53;2;0;51;0;0;0
013300076;100;37;37;6;18;81;1;18;0;0;18;0;0;0
013300077;100;90;90;7;67;30;3;67;2;0;65;0;0;0
013300078;100;78;78;6;29;70;1;29;0;0;29;0;0;0
013300079;500;509;509;5;192;367;0;133;7;0;126;59;2;57
013300080;500;469;469;1;198;348;1;151;12;0;139;47;0;47
013300081;600;586;586;0;200;432;4;164;13;2;149;36;2;34
013300082;600;566;567;0;216;413;0;187;8;7;172;29;2;27
013300083;600;424;542;4;159;468;0;132;6;4;122;27;1;26
013300084;800;753;753;3;268;609;1;190;5;3;182;78;2;76
013300085;300;242;242;6;109;190;1;109;19;0;90;0;0;0
013300086;900;849;851;2;334;600;1;299;29;1;269;35;0;35
013300087;900;835;835;4;252;692;1;207;11;3;193;45;1;44
013300088;800;745;745;0;148;696;1;103;3;0;100;45;4;41
013300089;500;469;469;2;108;432;0;68;4;5;59;40;0;40
013300090;800;795;795;8;165;668;1;131;4;2;125;34;0;34
013300091;100;25;25;0;22;78;0;22;0;3;19;0;0;0
013300092;100;23;23;0;23;73;4;23;3;0;20;0;0;0
013700001;600;644;644;0;293;425;7;168;7;5;156;125;7;118
013700002;600;604;604;2;262;461;4;135;4;3;128;127;1;126
013700003;700;705;705;1;344;483;1;216;11;9;196;128;6;122
013700004;700;684;685;0;301;501;1;198;15;5;178;103;2;101
013700005;600;626;626;1;242;480;1;119;9;3;107;123;7;116
013700006;600;657;658;0;295;419;10;171;10;4;157;124;4;120
013700007;600;552;552;4;255;467;1;132;3;3;126;123;5;118
013700008;700;697;698;0;332;468;1;231;22;15;194;101;8;93
013700009;600;675;675;0;313;417;1;182;4;3;175;131;8;123
013700010;700;752;754;1;275;484;1;215;21;8;186;60;1;59
013700011;500;544;545;1;245;362;2;136;9;5;122;109;7;102
013700012;700;662;662;2;319;498;2;200;21;7;172;119;5;114
013700013;500;528;529;3;217;375;1;124;7;7;110;93;5;88
013700014;600;590;592;1;280;424;1;175;9;4;162;105;5;100
013700015;800;780;780;4;691;108;1;691;19;5;667;0;0;0
013700016;700;702;702;0;377;335;1;364;22;1;341;13;0;13
013700017;700;656;656;1;261;514;1;185;11;6;168;76;3;73
013700018;700;656;656;0;220;534;1;165;12;3;150;55;4;51
013700019;500;409;409;3;199;310;3;187;9;1;177;12;0;12
013700020;800;791;803;2;366;520;1;279;16;7;256;87;4;83
013700021;800;749;749;0;335;572;1;227;18;10;199;108;7;101
013700022;800;520;789;0;520;299;1;500;0;0;500;20;0;20
013700023;500;481;509;2;264;304;1;195;14;4;177;69;1;68
013700024;800;742;743;1;276;592;2;206;13;1;192;70;1;69
013700025;500;482;482;4;221;313;1;186;11;3;172;35;0;35
013700026;600;577;578;0;258;395;1;204;12;6;186;54;5;49
013700027;500;501;502;0;212;354;1;145;5;2;138;67;3;64
013700028;100;33;33;2;34;65;1;34;1;1;32;0;0;0
014000001;500;772;772;5;259;335;1;164;8;3;153;95;3;92
014000002;500;732;732;4;235;342;1;157;7;3;147;78;2;76
014000003;500;802;802;5;218;368;1;131;3;3;125;87;6;81
014000004;500;871;871;6;223;389;1;110;2;1;107;113;6;107
014000005;500;757;784;8;261;368;5;127;4;1;122;134;3;131
014000006;500;847;847;7;242;353;1;146;8;5;133;96;3;93
014000007;500;835;838;9;290;355;2;143;5;3;135;147;6;141
014000008;500;694;695;4;226;381;0;119;5;1;113;107;6;101
014000009;200;435;435;7;131;139;1;60;4;0;56;71;2;69
014000010;300;492;492;5;141;216;1;83;0;1;82;58;2;56
014000011;500;789;789;7;267;350;1;149;4;5;140;118;3;115
014000012;500;730;730;8;255;354;1;145;6;2;137;110;3;107
014000013;500;835;835;6;282;352;1;147;12;1;134;135;12;123
014000014;500;830;830;0;245;345;1;154;9;1;144;87;4;87
014000015;500;690;690;3;225;362;1;137;1;1;135;88;1;87
014000016;500;793;793;4;243;357;2;141;5;5;131;102;2;100
014000017;500;755;755;8;264;326;1;173;8;3;162;91;2;89
014000018;500;899;899;0;313;331;1;168;6;6;156;145;3;142
014000019;500;815;815;7;281;365;1;134;6;1;127;147;5;142
014000020;500;792;792;4;260;241;1;258;7;7;244;2;0;2
014000021;500;677;702;5;240;373;1;126;6;1;119;114;12;102
014000022;500;505;505;9;184;404;4;92;3;0;89;92;0;92
014000023;500;721;721;8;218;376;1;123;3;3;117;95;4;91
014000024;500;592;592;4;144;423;1;76;2;0;74;68;0;68
014000025;500;889;889;7;238;364;6;130;5;6;119;108;2;106
014000026;500;840;840;7;285;287;1;212;17;2;193;73;2;71
014000027;500;903;903;4;337;269;1;230;6;5;219;107;1;106
014000028;500;935;935;5;256;337;1;162;24;3;135;94;4;90
014000029;500;944;945;8;189;357;1;142;18;1;123;47;0;47
014000030;500;983;983;3;194;351;1;148;19;1;128;46;0;46
014000031;500;944;945;5;170;363;1;136;17;4;115;34;3;31
014000032;500;519;522;4;330;183;2;315;12;1;302;15;1;14
014000033;200;318;318;4;145;73;2;125;13;1;111;20;0;20
014000034;300;487;487;5;180;148;1;151;5;3;143;29;1;28
014000035;200;314;314;4;149;84;1;115;6;0;109;34;1;33
014000036;200;243;243;1;131;64;5;131;11;5;115;0;0;0
014000037;100;40;40;3;14;85;1;14;0;1;13;0;0;0
014000038;200;588;588;3;187;73;1;126;12;4;110;61;1;60
014000039;200;451;451;4;144;107;1;92;1;2;89;52;3;49
014000040;300;586;589;0;179;136;1;163;16;0;147;16;2;14
014000041;300;622;627;3;241;108;1;191;6;3;182;50;2;48
014000042;200;448;449;4;124;90;2;108;12;1;95;16;1;15
014000043;300;563;563;3;185;149;2;149;15;3;131;36;0;36
014000044;300;509;509;4;175;157;2;141;5;2;134;34;2;32
014000045;200;396;396;4;131;97;1;102;2;3;97;29;0;29
014000046;300;650;650;5;263;63;1;236;27;3;206;27;0;27
014000047;200;464;464;3;177;70;2;128;2;2;124;49;0;49
014000048;200;160;160;5;80;119;1;80;7;3;70;0;0;0
014000049;100;31;31;8;29;70;1;29;4;1;24;0;0;0
014000050;100;73;73;6;39;60;1;39;2;1;36;0;0;0
014000051;100;61;61;8;38;61;1;38;0;1;37;0;0;0
014000052;100;51;51;5;33;66;1;33;1;1;31;0;0;0
014000053;100;69;69;8;39;60;1;39;4;0;35;0;0;0
014000054;100;43;43;8;31;68;1;31;1;0;30;0;0;0
014000055;200;149;149;7;49;150;1;49;1;1;47;0;0;0
014000056;500;533;533;5;218;357;2;141;12;2;127;77;1;76
014000057;200;195;195;6;110;89;1;110;5;6;99;0;0;0
014000058;100;72;72;8;58;40;2;58;1;0;57;0;0;0
014000059;500;571;571;4;188;328;1;171;8;3;160;17;1;16
014000060;500;468;468;3;176;342;1;157;6;19;132;19;0;19
014000061;100;95;95;5;50;49;1;50;3;0;47;0;0;0
014000062;500;386;386;6;153;375;1;124;7;1;116;29;1;28
014000063;200;141;141;6;65;131;4;65;3;0;61;0;0;0
014000064;100;61;61;8;36;63;1;36;0;1;35;0;0;0
014000065;200;125;125;5;58;141;1;58;7;0;51;0;0;0
014000066;100;32;32;9;22;77;1;22;3;0;19;0;0;0
014000067;100;81;81;6;48;51;1;48;0;3;45;0;0;0
014000068;100;37;37;8;25;74;1;25;1;0;24;0;0;0
014000069;100;82;82;6;30;69;1;30;3;0;27;0;0;0
014200001;300;385;385;1;260;142;1;157;0;0;157;103;0;103
014200002;400;530;532;1;191;222;1;177;14;2;161;14;1;13
014200003;400;498;516;0;155;260;1;139;0;5;134;16;0;16
014200004;600;686;720;0;439;251;1;348;1;3;344;91;0;91
014200005;600;719;758;0;488;111;1;488;0;0;488;0;0;0
014200006;600;716;733;1;362;300;1;299;0;0;299;63;0;63
014200007;600;697;747;2;394;223;1;376;0;1;375;18;0;18
014200008;300;308;308;5;142;172;1;127;1;1;125;15;0;15
014200009;300;292;294;0;132;167;1;132;2;3;127;0;0;0
014200010;700;885;907;0;284;418;2;280;0;3;277;4;0;4
014200011;700;816;853;0;291;439;1;260;6;3;251;31;4;27
014200012;900;992;1029;2;376;601;2;297;7;5;285;79;3;76
014200013;300;327;327;1;233;113;0;187;0;0;187;46;0;46
014200014;400;499;499;0;203;209;1;190;0;7;183;13;0;13
014200015;700;804;828;2;387;326;1;373;9;6;358;14;0;14
014200016;700;745;745;3;349;382;0;318;0;4;314;31;1;30
014200017;800;973;994;2;400;458;1;341;15;3;323;59;3;56
014200018;800;909;938;1;400;480;1;319;14;8;297;81;1;80
014200019;700;852;909;2;279;475;1;224;1;1;222;55;0;55
014200020;800;888;935;3;335;499;1;300;6;3;291;35;1;34
014200021;600;726;726;3;366;263;1;336;0;3;333;30;0;30
014200022;300;390;391;10;247;58;1;241;1;1;239;6;1;5
014200023;100;90;90;2;87;13;0;87;0;0;87;0;0;0
014200024;200;134;134;2;133;67;0;133;0;0;133;0;0;0
014200025;100;88;88;0;81;19;0;81;0;0;81;0;0;0
014200026;200;185;185;0;183;16;1;183;0;0;183;0;0;0
014400001;600;637;649;2;377;280;1;319;11;4;304;58;0;58
014400002;700;722;728;0;426;381;1;318;19;8;291;108;2;106
014400003;600;559;563;2;366;322;1;277;14;3;260;89;1;88
014400004;800;887;891;1;456;371;1;428;39;4;385;28;2;26
014400005;700;758;763;1;449;293;2;405;3;8;394;44;1;43
014400006;600;634;634;2;388;273;2;325;11;0;314;63;6;57
014400007;600;673;673;2;343;347;1;252;16;4;232;91;6;85
014400008;600;571;600;2;329;357;3;240;7;4;229;89;2;87
014400009;600;571;571;2;352;291;1;308;5;5;298;44;3;41
014400010;300;303;309;3;151;148;1;151;16;1;134;0;0;0
014400011;300;323;328;2;191;124;1;175;9;3;163;16;0;16
014400012;800;828;829;0;502;319;1;480;36;3;441;22;1;21
014400013;400;414;414;1;236;171;1;228;22;2;204;8;0;8
014400014;200;136;137;6;84;115;1;84;6;0;78;0;0;0
014400015;300;254;254;3;152;147;1;152;5;3;144;0;0;0
014400016;100;27;27;4;23;76;1;23;1;1;21;0;0;0
014400017;700;663;682;3;399;347;1;352;6;6;340;47;0;47
014400018;700;632;650;1;325;382;14;304;14;0;290;21;0;21
014400019;500;503;510;0;317;221;2;277;14;4;259;40;3;37
014400020;100;21;21;6;17;82;1;17;0;0;17;0;0;0
014400021;600;610;611;3;359;339;1;260;15;4;241;99;1;98
014400022;600;532;550;0;312;327;8;265;7;2;256;47;0;47
014400023;100;72;72;3;55;44;1;55;0;0;55;0;0;0
014400024;100;8;25;6;14;85;1;14;0;0;14;0;0;0
014400025;500;507;507;1;327;227;1;272;1;1;270;55;3;52
014400026;400;260;396;3;261;187;1;212;7;4;201;49;0;49
014400027;100;65;65;0;65;34;1;65;3;0;62;0;0;0
014400028;100;43;43;1;43;56;1;43;0;0;43;0;0;0
014400029;100;30;30;0;29;70;1;29;1;0;28;0;0;0
014900001;300;341;341;3;123;203;1;96;2;2;92;27;1;26
014900002;300;357;357;0;126;209;2;89;2;1;86;37;1;36
014900003;300;374;374;0;137;190;1;109;2;2;105;28;1;27
014900004;300;322;322;3;145;170;1;129;5;4;120;16;1;15
014900005;500;552;552;2;294;213;1;286;25;0;261;8;0;8
014900006;500;541;541;1;305;194;1;305;10;4;291;0;0;0
014900007;300;297;297;3;91;208;1;91;4;1;86;0;0;0
014900008;300;320;320;0;103;218;1;81;2;0;79;22;0;22
014900009;100;35;35;8;29;70;1;29;1;0;28;0;0;0
014900010;100;132;132;5;47;52;1;47;2;1;44;0;0;0
014900011;200;135;135;3;68;131;1;68;2;2;64;0;0;0
014900012;100;61;62;6;31;68;1;31;1;0;30;0;0;0
014900013;300;244;244;6;73;226;1;73;4;2;67;0;0;0
014900014;100;62;62;6;30;69;1;30;1;2;27;0;0;0
014900015;100;105;105;8;51;48;1;51;3;0;48;0;0;0
014900016;100;116;116;7;26;73;1;26;2;0;24;0;0;0
014900017;100;101;101;7;43;56;1;43;3;0;40;0;0;0
015200001;500;725;725;3;255;341;1;158;5;2;151;97;10;87
015200002;500;723;723;5;270;346;1;153;12;5;136;117;3;114
015200003;500;807;807;1;290;301;1;198;15;4;179;92;6;86
015200004;500;658;658;2;175;338;4;158;3;1;154;17;0;17
015200005;200;139;139;5;54;145;1;54;1;3;50;0;0;0
015200006;300;386;386;1;127;228;1;71;2;0;69;56;0;56
015200007;500;618;618;2;75;440;7;53;6;1;46;22;0;22
015200008;300;316;316;5;120;246;1;53;5;1;47;67;2;65
015200009;100;40;40;8;32;67;1;32;5;2;25;0;0;0
015200010;100;55;48;7;27;72;1;27;0;3;24;0;0;0
015200011;500;629;629;2;215;351;1;148;10;5;133;67;7;60
015200012;400;445;445;0;135;296;1;103;7;0;96;32;1;31
015200013;700;868;868;6;371;400;2;298;5;0;293;73;1;72
015200014;600;735;735;2;317;357;1;242;1;3;238;75;1;74
015200015;600;699;699;3;303;352;8;240;8;5;227;63;2;61
015200016;100;65;63;3;30;69;1;30;2;0;28;0;0;0
015200017;100;15;24;5;15;84;1;15;0;0;15;0;0;0
015200018;100;109;112;6;48;51;1;48;6;2;40;0;0;0
015200019;300;330;330;0;101;244;1;55;4;1;50;46;0;46
015300001;600;704;704;3;346;290;1;309;21;4;284;37;1;36
015300002;470;469;469;1;279;208;1;261;7;1;253;18;2;16
015300003;500;600;600;3;330;224;1;275;7;10;258;55;7;48
015300004;800;814;815;0;482;344;1;455;20;6;429;27;0;27
015300005;600;637;637;4;400;266;1;333;20;11;302;67;4;63
015300006;600;671;671;0;442;203;2;395;8;7;380;47;3;44
015300007;600;683;683;2;373;262;1;337;7;4;326;36;0;36
015300008;500;567;568;5;326;191;2;307;5;4;298;19;2;17
015300009;400;447;447;6;287;124;1;275;5;1;269;12;1;11
015300010;400;431;431;5;322;77;1;322;1;3;318;0;0;0
015300011;700;786;786;4;541;216;2;482;2;0;480;59;1;58
015300012;300;372;372;4;256;46;1;253;17;1;235;3;0;3
015300013;300;347;346;4;239;61;1;238;11;1;226;1;0;1
015300014;900;966;966;3;733;165;2;733;2;11;720;0;0;0
015300015;200;116;116;0;115;85;0;115;0;0;115;0;0;0
015300016;200;127;127;0;125;73;2;125;0;0;125;0;0;0
020100001;500;798;798;0;220;345;1;154;6;2;146;66;0;66
020100002;400;618;618;2;106;336;1;63;2;0;61;43;0;43
020100003;500;888;890;0;178;382;4;114;4;1;109;64;1;63
020100004;200;369;369;6;120;130;1;69;2;1;66;51;2;49
020100005;200;450;450;6;129;127;1;72;1;1;70;57;1;56
020100006;300;635;637;0;187;212;1;87;5;2;80;100;2;98
020100007;200;402;402;2;132;131;1;68;3;4;61;64;1;63
020100008;200;496;497;0;139;112;1;87;1;3;83;52;3;49
020100009;400;786;787;0;241;274;1;125;1;4;120;116;10;106
020100010;200;495;495;0;157;102;1;97;1;2;94;60;1;59
020100011;200;411;411;0;160;115;1;84;3;1;80;76;4;72
020100012;300;584;587;1;154;219;1;80;1;4;75;74;1;73
020100013;300;626;627;5;203;205;1;94;0;2;92;109;2;107
020100014;200;480;480;2;132;111;1;88;2;1;85;44;3;41
020100015;200;388;388;2;104;139;1;60;1;0;59;44;2;42
020100016;300;696;697;7;165;185;1;114;4;3;107;51;3;48
020100017;300;644;644;8;119;208;1;91;1;3;87;28;0;28
020100018;300;705;706;5;194;184;1;115;3;4;108;79;2;77
020100019;200;492;492;0;112;137;1;62;2;1;59;50;1;49
020100020;400;801;802;4;117;304;1;95;8;1;86;22;1;21
020100021;300;798;798;0;114;203;1;96;16;0;80;18;0;18
020100022;300;574;574;6;98;224;1;75;4;1;70;23;2;21
020100023;300;621;619;1;190;198;2;100;2;4;94;90;4;86
020100024;400;732;734;0;202;291;5;104;4;1;99;98;1;97
020100025;400;705;703;5;92;312;1;87;12;0;75;5;0;5
020100026;300;654;654;0;51;247;2;51;8;0;43;0;0;0
020100027;300;574;575;1;159;200;1;99;5;2;92;60;5;55
020100028;300;717;717;0;185;200;6;94;5;1;88;91;1;90
020100029;400;858;859;6;83;316;1;83;22;0;61;0;0;0
020100030;400;806;807;10;57;342;1;57;8;0;49;0;0;0
020100031;200;139;139;5;81;118;1;81;5;2;74;0;0;0
020100032;200;244;244;4;102;97;1;102;6;2;94;0;0;0
020100033;300;492;492;6;194;105;1;194;4;0;190;0;0;0
020100034;300;685;689;8;87;212;1;87;9;1;77;0;0;0
020100035;300;306;306;4;136;163;1;136;3;2;131;0;0;0
020100036;300;614;614;5;102;200;1;99;9;0;90;3;1;2
020100037;200;168;168;5;78;121;1;78;8;0;70;0;0;0
020100038;400;775;775;4;302;120;2;278;16;11;251;24;1;23
020100039;300;400;400;6;229;70;1;229;3;2;224;0;0;0
020100040;300;525;526;4;224;112;3;185;4;2;179;39;2;37
020100041;400;739;739;6;237;229;1;170;12;0;158;67;2;65
020100042;300;390;390;6;192;138;1;161;8;1;152;31;2;29
020100043;400;538;538;7;193;212;1;187;13;2;172;6;0;6
020100044;400;526;526;5;250;172;1;227;15;2;210;23;0;23
020100045;100;119;119;5;62;37;1;62;4;5;53;0;0;0
020100046;300;385;385;2;150;180;1;119;11;0;108;31;0;31
020100047;100;8;12;4;12;87;1;12;2;0;10;0;0;0
020100048;400;642;643;3;189;233;2;165;14;1;150;24;2;22
020100049;400;574;574;6;144;255;1;144;9;1;134;0;0;0
020100050;300;430;430;4;149;185;3;112;6;4;102;37;1;36
020100051;100;16;16;0;11;88;1;11;0;0;11;0;0;0
020400001;600;595;583;6;192;538;1;61;1;1;59;131;5;126
020400002;600;565;567;9;230;498;1;101;1;2;98;129;3;126
020400003;600;580;581;16;253;513;2;85;2;3;80;168;8;160
020400004;500;494;494;9;160;415;2;83;2;2;79;77;4;73
020400005;600;582;592;6;222;500;5;95;4;7;84;127;4;123
020400006;500;563;564;4;212;426;1;73;0;3;70;139;5;134
020400007;600;575;575;6;191;505;1;94;4;2;88;97;3;94
020400008;500;530;530;10;198;411;1;88;1;3;84;110;5;105
020400009;600;620;620;6;263;481;1;118;1;5;112;145;8;137
020400010;600;616;616;5;213;502;1;97;2;1;94;116;5;111
020400011;600;635;636;6;219;510;1;89;1;6;82;130;3;127
020400012;600;573;574;6;211;507;1;92;0;4;88;119;3;116
020400013;600;595;596;5;198;444;2;154;2;5;147;44;0;44
020400014;600;569;569;7;192;534;1;65;1;3;61;127;7;120
020400015;600;650;650;6;215;533;1;66;1;3;62;149;6;143
020400016;600;588;589;5;197;511;3;86;1;7;78;111;8;103
020400017;600;570;571;8;206;530;2;68;1;0;67;138;8;130
020400018;500;548;550;7;192;426;2;72;0;0;72;120;5;115
020400019;600;601;601;4;200;523;1;76;0;2;74;124;7;117
020400020;400;437;438;3;159;280;1;119;3;4;112;40;2;38
020400021;600;603;603;7;240;499;1;100;3;0;97;140;6;134
020400022;500;495;495;7;202;410;1;89;0;2;87;113;2;111
020400023;500;467;467;9;192;405;2;93;1;0;92;99;2;97
020400024;500;511;513;7;198;422;1;77;2;2;73;121;5;116
020400025;400;423;430;7;215;304;1;95;1;2;92;120;0;120
020400026;500;500;502;5;183;420;1;79;2;2;75;104;4;100
020400027;400;391;395;4;163;336;1;61;0;2;59;102;1;101
020400028;500;516;518;7;211;411;0;89;0;5;84;122;6;116
020400029;500;552;553;4;215;417;1;82;4;2;76;133;2;131
020400030;500;537;537;10;208;367;2;131;2;5;124;77;3;74
020400031;600;587;587;6;233;515;1;84;4;3;77;149;4;145
020400032;600;591;591;5;236;517;1;82;0;1;81;154;6;148
020400033;400;372;373;2;141;334;1;65;5;1;59;76;5;71
020400034;500;494;494;7;176;403;0;97;4;1;92;79;2;77
020400035;400;441;441;2;155;335;1;64;0;1;63;91;1;90
020400036;500;459;459;20;208;413;2;85;1;5;79;123;4;119
020400037;500;539;539;6;217;410;3;87;3;3;81;130;6;124
020400038;500;548;548;6;215;414;1;85;1;1;83;130;7;123
020400039;500;503;518;5;209;399;2;99;1;3;95;110;2;108
020400040;400;367;367;5;131;343;0;57;0;0;57;74;3;71
020400041;500;464;467;5;191;414;3;83;2;3;78;108;4;104
020400042;600;563;562;9;199;523;1;76;0;0;76;123;3;120
020400043;500;504;504;6;198;422;1;77;0;3;74;121;4;117
020400044;500;514;515;5;209;400;2;98;2;3;93;111;2;109
020400045;500;463;464;3;180;415;2;83;1;3;79;97;2;95
020400046;500;517;518;5;204;406;1;93;2;1;90;111;3;108
020400047;500;552;552;7;182;433;1;67;0;1;66;115;4;111
020400048;600;590;591;4;214;504;1;95;0;4;91;119;6;113
020400049;500;549;549;3;210;418;2;80;2;3;75;130;6;124
020400050;600;591;591;6;256;480;1;119;8;4;107;137;0;137
020400051;600;616;617;6;224;492;3;105;1;3;101;119;0;119
020400052;600;586;587;5;217;518;1;81;0;1;80;136;7;129
020400053;600;617;618;8;246;509;1;90;1;1;88;156;3;153
020400054;500;548;549;7;196;421;1;78;2;5;71;118;5;113
020400055;600;661;661;5;228;520;1;79;0;2;77;149;4;145
020400056;600;605;605;5;237;473;1;126;2;3;121;111;3;108
020400057;600;573;571;7;212;495;2;103;2;3;98;109;7;102
020400058;500;555;555;2;198;405;2;93;4;1;88;105;2;103
020400059;500;552;552;16;226;412;1;87;3;3;81;139;8;131
020400060;500;568;568;5;210;414;1;85;2;2;81;125;6;119
020400061;600;639;639;8;265;499;1;100;1;2;97;165;6;159
020400062;600;620;622;8;226;524;1;75;4;2;69;151;9;142
020400063;600;582;582;8;225;492;1;107;0;3;104;118;5;113
020400064;500;494;493;7;185;427;1;72;1;2;69;113;6;107
020400065;500;530;530;11;192;413;1;86;1;1;84;106;3;103
020400066;600;597;597;5;214;446;1;153;2;8;143;61;5;56
020400067;500;471;472;3;168;418;1;81;0;6;75;87;4;83
020400068;400;383;384;1;137;352;1;47;1;1;45;90;4;86
020400069;400;442;441;7;164;342;2;56;1;1;54;108;3;105
020400070;500;469;478;3;165;436;3;61;2;1;58;104;2;102
020400071;500;542;542;3;187;434;1;65;2;2;61;122;1;121
020400072;400;379;379;4;129;342;1;57;0;1;56;72;0;72
020400073;400;371;366;5;163;304;1;95;5;1;89;68;8;60
020400074;400;370;370;9;87;345;1;54;5;0;49;33;1;32
020400075;300;333;333;4;80;268;1;31;0;0;31;49;2;47
020400076;700;703;702;13;71;640;1;59;5;0;54;12;1;11
020400077;600;635;638;4;83;535;6;59;6;3;50;24;1;23
020400078;600;654;656;6;53;547;1;52;12;0;40;1;0;1
020400079;600;626;626;8;67;536;1;63;7;1;55;4;0;4
020400080;600;632;632;4;65;544;1;55;4;0;51;10;1;9
020400081;600;589;589;7;85;532;1;67;3;0;64;18;0;18
020400082;600;597;598;3;72;544;1;55;9;0;46;17;0;17
020400083;600;626;624;8;65;553;8;39;8;0;31;26;1;25
020400084;600;626;626;8;168;507;1;92;0;1;91;76;6;70
020400085;500;507;507;10;151;435;2;63;0;1;62;88;5;83
020400086;500;474;474;8;133;432;1;67;1;1;65;66;4;62
020400087;200;155;155;5;50;149;1;50;3;3;44;0;0;0
020400088;500;558;557;7;148;420;1;79;0;2;77;69;4;65
020400089;500;563;564;3;98;437;1;62;3;1;58;36;4;32
020400090;600;623;627;3;46;561;1;38;0;4;34;8;2;6
020400091;500;517;517;6;118;462;1;37;1;2;34;81;3;78
020400092;500;522;522;8;177;405;1;94;1;3;90;83;4;79
020400093;600;600;601;5;138;529;1;70;0;3;67;68;0;68
020400094;500;555;554;8;123;447;1;52;3;1;48;71;1;70
020400095;600;573;573;4;158;515;1;84;4;2;78;74;2;72
020400096;500;530;530;6;122;446;1;53;2;3;48;69;2;67
020400097;600;593;593;3;159;506;1;93;1;8;84;66;5;61
020400098;700;699;700;6;190;598;1;101;0;4;97;89;4;85
020400099;500;508;509;0;152;433;1;66;3;5;58;86;8;78
020400100;500;535;536;2;151;426;3;71;3;0;68;80;2;78
020400101;600;589;589;4;137;532;2;66;1;0;65;71;1;70
020400102;600;584;584;6;148;507;1;92;3;4;85;56;3;53
020400103;500;507;506;11;150;432;1;67;2;1;64;83;4;79
020400104;500;470;470;5;126;447;1;52;1;1;50;74;1;73
020400105;500;464;464;6;118;431;4;65;3;7;55;53;1;52
020400106;600;593;594;6;129;536;1;63;1;2;60;66;4;62
020400107;500;559;560;4;166;424;1;75;2;2;71;91;7;84
020400108;600;631;631;5;156;528;1;71;2;2;67;85;2;83
020400109;600;584;584;7;123;522;1;77;0;8;69;46;1;45
020400110;500;473;474;5;153;422;1;77;3;5;69;76;1;75
020400111;500;488;489;6;146;430;2;68;2;2;64;78;0;78
020400112;500;545;545;8;159;378;1;121;3;3;115;38;1;37
020400113;500;489;489;5;134;436;1;63;0;1;62;71;0;71
020400114;500;470;474;7;154;417;1;82;2;3;77;72;2;70
020400115;600;598;602;7;174;520;1;79;6;4;69;95;0;95
020400116;500;538;545;4;146;436;1;63;1;1;61;83;6;77
020400117;500;497;497;0;165;400;1;99;3;0;96;66;6;60
020400118;500;512;512;5;160;407;1;92;4;3;85;68;2;66
020400119;600;567;567;6;177;517;1;82;4;3;75;95;4;91
020400120;500;546;547;4;156;349;1;150;0;10;140;6;0;6
020400121;500;463;463;0;159;423;1;76;1;1;74;83;6;77
020400122;600;568;573;8;165;518;1;81;3;4;74;84;7;77
020400123;600;603;603;7;162;538;1;61;0;2;59;101;4;97
020400124;500;516;516;6;133;423;5;72;3;1;68;61;2;59
020400125;500;520;520;9;185;412;1;87;0;1;86;98;6;92
020400126;500;548;550;5;143;432;2;66;1;2;63;77;3;74
020400127;500;561;561;5;165;428;1;71;2;3;66;94;0;94
020400128;500;498;498;9;153;424;1;75;3;1;71;78;2;76
020400129;600;584;584;5;148;517;2;81;5;2;74;67;4;63
020400130;500;557;557;5;196;394;1;105;3;2;100;91;5;86
020400131;600;602;604;1;173;512;1;87;4;3;80;86;0;86
020400132;600;599;599;1;169;506;1;93;2;2;89;76;3;73
020400133;700;665;666;5;203;610;1;89;0;6;83;114;8;106
020400134;600;600;600;1;158;536;2;62;4;1;57;96;6;90
020400135;600;633;634;9;215;502;1;97;3;5;89;118;4;114
020400136;600;624;624;4;147;529;1;70;3;1;66;77;1;76
020400137;600;560;560;7;118;534;2;64;1;0;63;54;0;54
020400138;600;587;588;5;132;491;2;107;2;4;101;25;0;25
020400139;700;665;665;7;128;634;4;62;0;2;60;66;2;64
020400140;700;676;676;1;137;635;1;64;1;3;60;73;1;72
020400141;600;653;653;5;171;514;1;85;2;5;78;86;2;84
020400142;600;588;589;3;139;541;1;58;0;0;58;81;5;76
020400143;600;623;623;4;142;528;1;71;1;2;68;71;5;66
020400144;600;607;608;6;161;513;1;86;0;2;84;75;2;73
020400145;600;622;622;4;146;527;1;72;1;1;70;74;3;71
020400146;700;763;765;2;224;596;1;103;2;3;98;121;7;114
020400147;600;635;635;4;150;535;1;64;2;5;57;86;1;85
020400148;600;618;619;7;74;544;2;54;9;0;45;20;1;19
020400149;600;649;650;4;111;532;1;67;10;0;57;44;0;44
020400150;600;597;598;9;101;550;1;49;7;1;41;52;1;51
020400151;600;573;573;4;194;527;1;72;1;0;71;122;4;118
020400152;600;573;575;8;193;496;1;103;4;1;98;90;3;87
020400153;500;510;510;5;171;419;1;80;0;6;74;91;3;88
020400154;500;519;522;5;153;408;1;91;3;1;87;62;3;59
020400155;700;656;672;7;233;612;3;85;2;3;80;148;3;145
020400156;600;566;566;5;165;518;3;79;4;5;70;86;6;80
020400157;600;552;552;7;176;516;1;83;0;4;79;93;5;88
020400158;600;619;618;5;208;517;1;82;4;1;77;126;7;119
020400159;600;534;538;7;170;496;1;103;3;3;97;67;3;64
020400160;600;651;651;3;214;489;1;110;1;2;107;104;4;100
020400161;600;584;585;7;175;542;1;57;0;0;57;118;8;110
020400162;600;555;555;5;188;506;3;91;0;4;87;97;1;96
020400163;600;562;563;6;202;508;1;91;0;2;89;111;8;103
020400164;500;486;487;8;194;421;2;77;4;0;73;117;5;112
020400165;500;523;523;7;200;402;2;96;2;5;89;104;7;97
020400166;600;582;589;15;211;503;1;96;3;0;93;115;6;109
020400167;600;588;589;7;206;505;2;93;1;7;85;113;4;109
020400168;500;503;504;6;157;442;1;57;0;1;56;100;12;88
020400169;500;483;483;7;164;427;1;72;2;0;70;92;2;90
020400170;500;499;499;5;161;414;1;85;0;3;82;76;6;70
020400171;500;533;534;5;161;436;2;62;1;2;59;99;8;91
020400172;500;538;538;7;169;423;1;76;1;5;70;93;2;91
020400173;600;580;582;7;195;500;1;99;0;2;97;96;3;93
020400174;500;466;467;5;137;430;1;69;1;3;65;68;0;68
020400175;500;456;457;5;164;418;5;77;5;2;70;87;4;83
020400176;500;556;555;7;178;427;1;72;2;2;68;106;2;104
020400177;600;607;607;3;196;511;1;88;5;2;81;108;6;102
020400178;600;588;588;4;162;534;1;65;1;7;57;97;7;90
020400179;600;577;578;7;145;545;1;54;1;1;52;91;1;90
020400180;600;576;576;5;178;521;2;77;0;3;74;101;6;95
020400181;600;573;580;7;167;495;2;103;2;2;99;64;2;62
020400182;500;493;493;7;141;443;1;56;1;1;54;85;5;80
020400183;500;478;479;20;165;423;2;75;3;2;70;90;2;88
020400184;500;515;516;7;157;432;1;67;1;0;66;90;3;87
020400185;500;533;534;8;160;433;1;66;3;1;62;94;5;89
020400186;600;615;616;14;222;519;1;80;3;3;74;142;5;137
020400187;600;576;577;8;192;518;1;81;4;5;72;111;5;106
020400188;500;530;529;5;142;424;2;74;0;1;73;68;0;68
020400189;600;578;579;10;162;524;4;72;3;2;67;90;4;86
020400190;600;584;585;7;166;522;1;77;3;2;72;89;10;79
020400191;500;556;556;6;155;428;1;71;0;0;71;84;5;79
020400192;600;579;580;5;194;445;1;154;7;6;141;40;2;38
020400193;500;526;526;4;140;435;1;64;2;2;60;76;2;74
020400194;500;515;517;4;197;415;1;84;4;2;78;113;2;111
020400195;600;575;575;5;183;520;1;79;2;2;75;104;7;97
020400196;500;520;520;3;166;437;1;62;0;1;61;104;5;99
020400197;500;475;475;5;168;410;1;89;4;2;83;79;1;78
020400198;500;535;537;3;162;425;1;74;3;5;66;88;8;80
020400199;600;592;594;6;190;506;1;93;4;3;86;97;5;92
020400200;600;573;573;4;195;493;1;106;6;6;94;89;6;83
020400201;400;455;455;3;178;314;1;85;1;1;83;93;5;88
020400202;600;643;648;6;185;505;1;94;4;2;88;91;1;90
020400203;700;694;699;7;249;563;2;135;7;5;123;114;5;109
020400204;600;626;628;8;224;481;1;118;9;6;103;106;1;105
020400205;200;223;224;2;97;102;1;97;1;3;93;0;0;0
020400206;500;560;560;8;202;388;1;111;4;2;105;91;3;88
020400207;500;515;516;7;147;439;2;59;0;2;57;88;5;83
020400208;500;535;536;8;174;414;1;85;3;0;82;89;3;86
020400209;500;450;450;5;149;440;1;59;2;2;55;90;3;87
020400210;500;537;538;6;194;418;1;81;3;3;75;113;5;108
020400211;600;600;601;6;210;531;1;68;1;4;63;142;5;137
020400212;500;512;513;9;130;442;2;56;2;1;53;74;3;71
020400213;593;601;601;6;216;515;2;76;2;3;71;140;3;137
020400214;500;535;534;534;166;438;1;61;1;3;57;105;4;101
020400215;500;505;505;2;168;420;1;79;2;2;75;89;3;86
020400216;500;547;547;7;196;407;1;92;3;1;88;104;6;98
020400217;500;537;537;8;188;425;1;74;6;4;64;114;2;112
020400218;500;545;545;7;207;390;2;108;1;4;103;99;5;94
020400219;500;531;531;8;185;412;6;82;5;2;75;103;1;102
020400220;600;644;644;10;163;500;1;99;1;2;96;64;2;62
020400221;500;497;498;8;177;379;1;120;6;6;108;57;1;56
020400222;600;597;597;5;193;493;1;106;4;4;98;87;2;85
020400223;500;534;537;6;176;425;1;74;3;5;66;102;9;93
020400224;600;617;616;7;206;458;1;141;4;5;132;65;3;62
020400225;600;585;586;5;224;492;1;107;5;3;99;117;10;107
020400226;500;542;542;7;188;415;1;84;3;3;78;104;4;100
020400227;600;606;606;7;217;496;1;103;4;2;97;114;7;107
020400228;600;601;601;4;253;508;2;90;1;2;87;163;14;149
020400229;700;761;762;3;330;550;3;147;6;10;131;183;12;171
020400230;600;566;567;4;239;462;1;137;3;6;128;102;3;99
020400231;600;598;598;7;184;531;1;68;0;2;66;116;3;113
020400232;600;580;581;9;230;487;1;112;4;6;102;118;0;118
020400233;600;627;627;5;227;524;1;75;3;2;70;152;14;138
020400234;600;583;583;10;195;511;1;88;1;0;87;107;3;104
020400235;500;552;552;9;205;407;1;92;7;1;84;113;6;107
020400236;600;579;579;5;191;510;1;89;2;3;84;102;3;99
020400237;500;482;482;6;170;414;1;85;4;1;80;85;3;82
020400238;600;611;611;8;231;480;1;119;1;3;115;112;2;110
020400239;600;569;569;1;206;505;1;94;4;0;90;112;4;108
020400240;500;512;512;6;152;347;3;54;2;1;51;98;7;91
020400241;500;523;523;7;140;414;1;85;1;0;84;55;3;52
020400242;500;492;492;8;142;423;2;75;2;1;72;67;4;63
020400243;500;537;537;9;179;432;1;67;0;2;65;112;7;105
020400244;500;478;478;3;167;394;2;104;1;1;102;63;2;61
020400245;600;590;592;9;186;515;1;84;3;0;81;102;2;100
020400246;600;175;602;8;182;512;1;87;4;2;81;96;1;94
020400247;600;660;663;6;195;520;1;79;3;5;71;116;3;113
020400248;500;537;538;7;184;441;1;58;1;2;55;126;5;121
020400249;600;582;583;4;191;501;1;98;3;3;92;93;2;91
020400250;500;520;520;3;175;425;1;74;0;1;73;101;4;97
020400251;500;536;536;7;181;419;1;80;5;0;75;101;2;99
020400252;200;176;176;7;61;138;1;61;2;2;57;0;0;0
020400253;700;753;753;5;255;592;2;106;1;6;99;149;2;147
020400254;800;805;806;5;262;637;2;161;0;7;154;101;5;96
020400255;700;714;714;4;222;607;3;90;2;3;85;132;6;126
020400256;900;919;919;7;302;775;1;124;5;3;116;178;4;174
020400257;800;789;791;3;252;716;1;83;1;3;79;169;9;160
020400258;600;606;608;4;151;522;1;77;6;1;70;74;4;70
020400259;500;553;553;5;105;440;1;59;1;1;57;46;3;43
020400260;700;713;714;3;13;686;1;13;2;0;11;0;0;0
020400261;700;667;668;5;17;690;1;9;0;0;9;8;1;7
020400262;500;546;546;6;25;487;1;12;2;0;10;13;0;13
020400263;600;571;572;2;103;544;1;55;2;2;51;48;0;48
020400264;600;616;616;3;73;563;1;36;1;3;32;37;0;37
020400265;500;543;541;3;104;440;1;59;3;1;55;45;4;41
020400266;500;551;552;5;191;407;4;89;3;3;83;102;5;97
020400267;600;664;666;11;250;497;1;102;4;2;96;148;3;145
020400268;500;554;555;8;199;426;1;73;3;4;66;126;5;121
020400269;600;612;613;7;210;510;2;88;0;2;86;122;2;120
020400270;600;613;613;5;260;488;1;111;4;2;105;149;4;145
020400271;600;642;643;8;274;335;1;264;2;7;255;10;0;10
020400272;600;609;610;3;235;496;1;103;6;4;93;132;9;123
020400273;600;610;609;6;210;506;6;88;5;2;81;122;4;118
020400274;600;577;577;6;94;505;1;94;2;5;87;130;3;127
020400275;600;597;597;6;186;507;1;92;0;2;90;94;3;91
020400276;600;650;650;8;238;504;1;95;1;1;93;143;6;137
020400277;500;527;527;7;215;401;1;98;1;9;88;117;4;113
020400278;600;584;586;9;198;496;1;103;0;0;103;95;0;95
020400279;600;610;619;5;178;506;2;92;1;4;87;86;4;82
020400280;500;490;490;10;156;427;1;72;1;0;71;84;6;78
020400281;600;632;633;13;261;476;1;123;1;0;122;138;3;135
020400282;700;672;672;5;244;612;1;87;0;9;78;157;8;149
020400283;700;706;706;6;261;584;1;115;4;4;107;146;5;141
020400284;600;585;585;8;200;516;1;84;1;0;83;117;1;116
020400285;600;659;659;8;226;514;1;85;3;3;79;141;5;136
020400286;600;594;594;5;234;513;1;86;0;5;81;148;8;140
020400287;700;699;699;7;268;598;3;99;3;1;95;169;5;164
020400288;500;532;533;8;204;417;2;81;2;3;76;123;5;118
020400289;600;643;643;6;246;494;1;105;2;5;98;141;2;139
020400290;500;537;537;4;198;397;1;102;3;5;94;96;4;92
020400291;500;561;562;6;189;316;2;182;5;5;172;7;0;7
020400292;500;549;549;9;185;441;1;58;3;1;54;127;5;122
020400293;600;625;626;10;248;419;1;180;1;6;173;68;4;64
020400294;600;627;627;5;234;475;1;124;3;3;118;110;3;107
020400295;600;579;579;5;226;495;1;104;0;1;103;122;6;116
020400296;500;553;554;6;200;416;1;83;2;4;77;117;6;111
020400297;600;651;652;7;232;504;1;95;1;0;94;137;7;130
020400298;500;540;540;7;193;419;2;79;0;0;79;114;0;114
020400299;600;590;590;5;193;500;4;96;3;1;92;97;0;97
020400300;600;591;590;7;198;510;1;89;1;2;86;109;4;105
020400301;500;509;511;7;172;419;1;80;0;4;76;92;3;89
020400302;500;545;545;3;202;417;1;82;0;3;79;120;3;117
020400303;600;589;589;6;247;517;1;82;1;3;78;165;10;155
020400304;600;646;647;6;212;501;1;98;3;6;89;114;3;111
020400305;500;565;566;6;200;414;1;85;1;5;79;115;4;111
020400306;600;584;584;8;239;506;2;92;1;1;90;147;3;144
020400307;500;555;555;8;204;431;2;67;1;5;61;137;5;132
020400308;500;516;516;8;203;426;4;70;1;0;69;133;5;128
020400309;600;660;660;0;149;523;1;76;5;1;70;73;0;73
020400310;600;642;642;1;123;491;2;107;2;7;98;16;4;12
020400311;600;635;635;0;183;516;1;83;6;0;77;100;10;90
020400312;600;599;594;2;132;539;2;59;2;1;56;73;0;73
020400313;600;602;602;1;123;530;1;69;1;1;67;54;0;54
020400314;600;599;600;0;68;563;2;35;0;0;35;33;2;31
020400315;600;564;564;0;103;536;8;56;4;0;52;47;0;47
020400316;200;103;104;5;72;127;1;72;6;0;66;0;0;0
020400317;300;236;236;2;105;186;9;105;9;5;91;0;0;0
020400318;700;730;730;4;176;587;1;112;6;0;106;64;2;62
020400319;800;844;844;4;146;708;1;91;3;8;80;55;4;51
020400320;200;142;144;6;88;110;2;88;5;0;83;0;0;0
020400321;500;413;413;6;131;398;1;101;2;0;99;30;0;30
020400322;500;408;408;3;140;402;1;97;2;1;94;43;3;40
020400323;500;367;369;3;121;421;0;79;3;1;75;42;1;41
020400324;900;922;922;7;219;768;1;131;9;4;118;88;2;86
020400325;100;70;70;6;28;71;1;28;0;1;27;0;0;0
020400326;700;682;683;3;100;639;1;60;3;1;56;40;1;39
020400327;600;551;551;3;99;533;1;66;1;4;61;33;0;33
020400328;500;393;393;6;154;412;1;87;7;1;79;67;6;61
020400329;100;26;6;9;31;67;2;31;1;1;29;0;0;0
020400330;200;63;63;43;79;119;2;79;1;3;75;0;0;0
020400331;100;25;25;10;14;86;0;14;0;0;14;0;0;0
020400332;300;15;15;37;47;252;1;47;1;1;45;0;0;0
020400333;200;12;12;40;40;159;1;40;2;0;38;0;0;0
020400334;200;26;26;39;43;156;1;43;1;1;41;0;0;0
020400335;200;43;43;14;41;158;1;41;0;0;41;0;0;0
020400336;200;95;95;36;131;68;1;131;15;8;108;0;0;0
020400337;200;41;41;19;56;143;1;56;0;2;54;0;0;0
020400340;400;10;10;63;64;335;1;64;1;2;61;0;0;0
020400341;100;25;25;5;29;70;1;29;0;0;29;0;0;0
020400342;100;30;30;3;33;67;0;33;0;0;33;0;0;0
020400343;100;29;29;0;28;72;0;28;0;0;28;0;0;0
020400344;100;25;25;0;25;74;1;25;0;2;23;0;0;0
020600001;300;410;410;7;116;226;1;73;0;2;71;43;0;43
020600002;400;569;569;4;138;300;1;99;6;6;87;39;2;37
020600003;300;414;414;0;105;238;1;61;1;2;58;44;0;44
020600004;300;503;503;6;169;199;1;100;3;3;94;69;2;67
020600005;400;684;684;7;203;273;1;126;4;4;118;77;2;75
020600006;500;844;844;7;130;417;2;81;4;1;76;49;2;47
020600007;400;732;732;8;117;355;1;44;2;0;42;73;0;73
020600008;300;496;496;3;136;216;2;82;3;3;76;54;6;48
020600009;100;16;16;8;21;78;1;21;0;0;21;0;0;0
020600010;100;15;15;7;22;77;1;22;2;0;20;0;0;0
020600011;100;57;57;5;40;59;1;40;7;0;33;0;0;0
020600012;100;33;33;6;27;72;1;27;2;0;25;0;0;0
020600014;100;52;52;6;44;55;1;44;2;0;42;0;0;0
020600015;100;71;71;4;52;47;1;52;4;4;44;0;0;0
020600016;100;16;16;5;17;82;1;17;2;0;15;0;0;0
020600017;500;648;648;4;147;412;3;85;6;3;76;62;2;60
020600018;500;721;721;3;115;415;2;83;13;1;69;32;1;31
020600019;100;12;12;6;17;82;1;17;0;0;17;0;0;0
020600020;100;26;26;6;18;81;1;18;2;0;16;0;0;0
020600021;300;318;318;6;140;159;1;140;9;3;128;0;0;0
020600022;300;232;231;6;133;157;10;133;9;6;118;0;0;0
020600023;200;176;176;3;80;119;1;80;8;0;72;0;0;0
020600024;200;187;187;4;90;109;1;90;9;5;76;0;0;0
020600025;100;34;34;8;26;73;1;26;2;0;24;0;0;0
020600028;100;34;34;6;33;66;1;33;1;0;32;0;0;0
020600029;100;49;49;5;27;72;1;27;0;1;26;0;0;0
020600030;300;281;281;5;82;217;1;82;14;3;65;0;0;0
020600031;100;42;42;6;28;71;1;28;1;2;25;0;0;0
020600032;100;22;22;8;24;75;1;24;0;0;24;0;0;0
020600033;100;37;37;8;22;77;1;22;2;2;18;0;0;0
020600034;200;130;130;6;90;109;1;90;5;1;84;0;0;0
020600035;100;70;70;8;32;67;1;32;3;0;29;0;0;0
020600037;100;9;18;7;9;90;1;9;0;0;9;0;0;0
020600038;100;57;57;8;33;66;1;33;1;0;32;0;0;0
020600039;300;302;302;4;145;154;1;145;5;2;138;0;0;0
020600040;500;1081;1081;8;120;409;2;89;12;3;74;31;2;29
020600041;400;539;539;3;133;309;1;90;7;4;79;43;3;40
020600042;400;704;704;3;204;264;1;135;4;2;129;69;2;67
020600043;300;216;216;7;69;230;1;69;6;2;61;0;0;0
020800001;500;715;713;5;189;395;1;104;7;3;94;85;6;79
020800002;500;794;792;11;90;424;1;75;7;1;67;15;1;14
020800003;500;901;903;5;52;467;1;32;2;1;29;20;2;18
020800004;500;722;722;4;144;399;1;100;10;1;89;44;1;43
020800005;500;774;775;1;229;367;1;132;7;2;123;97;4;93
020800006;500;535;535;3;138;417;2;81;2;0;79;57;2;55
020800007;500;723;726;4;94;427;1;72;8;0;64;22;0;22
020800008;100;120;120;7;33;66;1;33;4;0;29;0;0;0
020800009;100;163;163;5;74;25;1;74;4;3;67;0;0;0
020800010;500;662;663;8;79;436;1;63;4;7;52;16;0;16
020800011;100;162;162;2;80;19;1;80;0;0;80;0;0;0
020800012;200;265;265;2;127;72;1;127;5;5;117;0;0;0
020800013;200;287;287;1;138;59;3;138;9;2;127;0;0;0
020800014;300;310;310;5;61;258;1;41;2;2;37;20;0;20
020800015;300;383;383;3;54;259;1;40;0;1;39;14;0;14
020800016;300;335;338;4;41;269;1;30;1;0;29;11;0;11
020800017;200;257;258;4;117;82;1;117;3;3;111;0;0;0
020800018;500;426;426;6;80;429;1;70;7;1;62;10;0;10
020800019;500;651;651;5;136;367;1;132;15;3;114;4;0;4
020800020;500;521;521;3;144;379;1;120;3;3;114;24;0;24
020900001;500;556;558;4;167;405;1;94;6;0;88;73;4;69
020900002;500;521;530;0;148;408;1;91;2;2;87;57;4;53
020900003;500;464;464;0;140;418;1;81;1;7;73;59;5;54
020900004;500;581;581;1;195;369;5;126;5;3;118;69;4;65
020900005;500;627;627;0;141;420;1;79;2;2;75;62;4;58
020900006;500;737;738;0;32;479;1;20;2;0;18;12;0;12
020900007;500;660;662;0;199;368;1;131;3;3;125;68;3;65
020900008;500;464;465;0;147;432;1;67;0;0;67;80;0;80
020900009;500;605;606;0;170;399;1;100;2;1;97;70;3;67
020900010;500;415;415;4;145;417;2;81;1;3;77;64;4;60
020900011;500;436;436;0;164;402;1;97;1;3;93;67;5;62
020900012;500;583;586;0;155;394;1;105;2;5;98;50;3;47
020900013;600;740;741;1;200;485;1;114;3;4;107;86;0;86
020900014;500;575;577;1;181;383;6;111;6;8;97;70;1;69
020900015;500;531;531;0;121;434;1;65;2;2;61;56;3;53
020900016;500;386;387;0;97;446;2;52;3;4;45;45;3;42
020900017;500;393;393;4;85;453;1;46;1;2;43;39;1;38
020900018;700;815;817;0;31;681;1;18;1;2;15;13;0;13
020900019;700;783;787;2;82;650;1;49;2;0;47;33;1;32
020900020;700;801;804;0;16;685;1;14;4;0;10;2;0;2
020900021;500;540;540;2;93;425;4;71;3;1;67;22;1;21
020900022;600;646;646;4;84;547;1;52;5;3;44;32;0;32
020900023;200;166;167;0;41;158;1;41;1;4;36;0;0;0
020900024;600;720;720;0;115;517;1;82;8;1;73;33;3;30
020900025;600;782;782;0;25;577;1;22;7;0;15;3;0;3
020900026;500;491;491;0;119;418;1;81;9;4;68;38;2;36
020900027;300;334;335;2;97;256;1;43;0;2;41;54;2;52
020900028;300;334;334;6;63;253;1;46;2;0;44;17;0;17
020900029;300;399;401;6;20;284;1;15;0;1;14;5;1;4
020900030;300;399;399;7;55;244;1;55;2;2;51;0;0;0
020900031;100;24;75;4;24;75;1;24;2;0;22;0;0;0
020900032;100;89;89;7;38;61;1;38;6;1;31;0;0;0
020900033;100;49;49;6;20;79;1;20;1;0;19;0;0;0
020900034;100;77;77;8;16;83;1;16;0;1;15;0;0;0
020900035;100;104;104;6;49;50;1;49;4;3;42;0;0;0
020900036;100;62;62;6;38;61;1;38;2;1;35;0;0;0
020900037;100;36;36;7;21;78;1;21;1;1;19;0;0;0
020900038;300;345;345;7;59;247;1;52;2;0;50;7;0;7
020900039;100;55;54;6;38;61;1;38;6;0;32;0;0;0
020900040;200;134;135;2;59;140;1;59;0;5;54;0;0;0
020900041;100;42;42;6;22;77;1;22;1;0;21;0;0;0
020900042;300;291;291;5;132;154;14;132;11;1;120;0;0;0
020900043;300;263;263;6;99;200;1;99;9;0;90;0;0;0
020900044;100;46;46;8;27;72;1;27;2;0;25;0;0;0
020900045;200;167;167;6;34;164;2;34;1;0;33;0;0;0
020900046;600;677;812;2;315;306;2;292;11;12;269;23;2;21
020900047;300;236;236;4;49;250;1;49;4;0;45;0;0;0
020900048;100;13;13;8;12;87;1;12;0;0;12;0;0;0
020900049;100;61;61;6;35;63;2;35;1;1;33;0;0;0
020900050;200;97;97;5;39;160;1;39;3;2;34;0;0;0
020900051;200;173;174;7;48;151;1;48;7;2;39;0;0;0
020900052;100;106;107;8;34;65;1;34;0;2;32;0;0;0
020900053;100;73;73;5;46;53;1;46;4;0;42;0;0;0
020900054;100;88;89;4;30;69;1;30;3;1;26;0;0;0
020900055;200;153;153;7;41;158;1;41;5;3;33;0;0;0
020900056;500;425;426;5;66;448;1;51;6;1;44;15;1;14
020900057;100;21;21;6;15;84;1;15;0;1;14;0;0;0
020900058;100;74;74;7;40;59;1;40;0;2;38;0;0;0
020900059;100;21;21;0;21;78;1;21;1;0;20;0;0;0
021200001;300;351;353;2;74;254;2;44;0;1;43;30;2;28
021200002;500;511;522;4;130;392;1;107;4;5;98;23;0;23
021200003;400;500;500;2;113;322;1;77;2;3;72;36;1;35
021200004;350;383;384;0;88;282;2;66;6;1;59;22;3;19
021200005;50;26;26;8;24;25;1;24;0;0;24;0;0;0
021200007;200;177;177;4;105;94;1;105;8;0;97;0;0;0
021200008;50;18;18;8;21;28;1;21;0;2;19;0;0;0
021200009;50;33;33;8;35;14;1;35;0;0;35;0;0;0
021200011;100;39;39;3;26;73;1;26;1;1;24;0;0;0
021200012;100;41;41;7;40;59;1;40;0;1;39;0;0;0
021200013;300;294;294;4;134;165;1;134;12;3;119;0;0;0
021200016;100;39;39;7;33;66;1;33;3;0;30;0;0;0
021300001;500;467;467;4;181;378;1;121;3;3;115;60;2;58
021300002;700;668;669;8;261;550;1;149;4;3;142;112;8;104
021300003;600;639;639;1;221;450;1;149;8;5;136;72;6;66
021300004;700;722;722;5;282;541;1;158;10;0;148;124;2;122
021300005;400;364;364;3;157;302;1;97;8;3;86;60;3;57
021300006;700;773;773;4;235;515;2;183;6;3;174;52;2;50
021300007;800;965;964;4;316;563;1;236;19;6;211;80;4;76
021300008;300;259;259;7;68;231;1;68;9;0;59;0;0;0
021300009;50;18;18;7;20;29;1;20;2;0;18;0;0;0
021300010;500;495;499;3;212;363;2;135;10;2;123;77;5;72
021300011;100;75;75;7;51;48;1;51;1;2;48;0;0;0
021300012;50;36;36;7;33;16;1;33;2;0;31;0;0;0
021300013;500;461;462;1;176;384;1;115;17;0;98;61;2;59
021300014;600;545;544;3;188;476;1;123;8;2;113;65;2;63
021300015;50;41;41;7;42;7;1;42;1;1;40;0;0;0
021300016;300;300;302;5;171;128;1;171;10;0;161;0;0;0
021300017;200;181;181;3;69;130;1;69;3;6;60;0;0;0
021300018;200;148;148;5;57;141;2;57;2;2;53;0;0;0
021300019;200;224;224;4;122;77;1;122;11;3;108;0;0;0
021300020;50;36;35;6;23;26;1;23;2;0;21;0;0;0
021500001;500;478;477;4;221;424;1;75;0;1;74;146;10;136
021500002;500;471;471;7;214;409;2;89;4;2;83;125;7;118
021500003;400;423;423;6;145;329;2;69;5;5;59;76;2;74
021500004;600;685;685;8;261;434;1;165;35;1;129;96;0;96
021500005;800;797;798;4;276;673;1;126;2;2;122;150;2;148
021500006;700;714;714;8;248;556;1;143;4;4;135;105;3;102
021500007;600;617;616;6;182;516;1;83;1;1;81;99;2;97
021500008;600;674;677;1;193;472;1;127;3;2;122;66;3;63
021500009;700;754;754;4;266;575;1;124;5;3;116;142;7;135
021500010;600;688;688;5;235;474;1;125;6;1;118;110;8;102
021500011;700;719;720;3;242;566;8;126;7;3;116;116;4;112
021500012;400;476;476;5;116;345;1;54;1;0;53;62;2;60
021500013;900;907;907;9;234;761;4;135;5;3;127;99;2;97
021500014;200;149;150;2;75;124;1;75;3;0;72;0;0;0
021500015;800;843;843;2;267;668;2;130;3;2;125;137;7;130
021500016;600;695;695;3;197;511;1;88;2;3;83;109;2;107
021500017;1000;929;951;3;260;864;1;135;5;2;128;125;4;121
021500018;400;489;489;1;78;321;1;78;1;4;73;0;0;0
021500019;300;321;321;4;89;228;1;71;2;2;67;18;0;18
021500020;500;507;513;4;113;435;1;64;1;1;62;49;3;46
021500021;400;405;405;2;132;316;1;83;0;4;79;49;1;48
021500022;600;561;561;3;216;479;2;119;4;4;111;97;2;95
021500023;500;522;522;2;222;361;1;138;6;0;132;84;5;79
021500024;600;674;674;0;233;479;1;120;9;2;109;113;5;108
021500025;100;34;34;5;29;70;1;29;0;0;29;0;0;0
021500026;100;39;39;7;29;70;1;29;0;1;28;0;0;0
021500027;400;413;415;1;73;345;1;54;1;1;52;19;1;18
021500028;600;670;670;5;97;509;1;90;11;1;78;7;0;7
021500029;100;58;58;7;36;62;2;36;1;5;30;0;0;0
021500030;600;686;690;4;233;493;1;106;0;8;98;127;6;121
021500031;600;658;658;1;219;489;1;110;1;2;107;109;6;103
021500032;400;434;434;122;126;310;1;89;3;2;84;37;0;37
021500033;500;521;531;7;125;408;2;90;1;2;87;35;0;35
021500034;1000;1081;1083;2;324;898;1;101;1;3;97;223;9;214
021500035;1000;1047;1046;4;228;866;1;133;3;2;128;95;2;93
021500036;500;592;593;3;213;393;1;106;3;2;101;107;2;105
021500037;200;115;115;8;75;124;1;75;1;1;73;0;0;0
021700001;100;65;65;6;39;60;1;39;1;0;38;0;0;0
021700002;500;493;493;5;153;413;1;86;4;2;80;67;1;66
021700003;400;418;418;5;129;315;2;83;8;0;75;46;2;44
021700004;400;459;459;4;127;277;1;122;13;3;106;5;0;5
021700005;400;407;407;3;141;298;1;101;5;1;95;40;0;40
021700006;500;507;507;4;93;427;1;72;4;0;68;21;0;21
021700007;400;426;428;4;66;350;1;49;3;1;45;17;0;17
021700008;400;410;410;5;196;222;1;177;7;3;167;19;1;18
021700009;500;535;535;5;196;304;1;195;7;3;185;1;0;1
021700010;500;548;549;4;94;419;1;80;5;0;75;14;0;14
021700011;500;517;518;3;113;395;1;104;5;2;97;9;2;7
021700012;400;416;416;3;112;301;1;98;10;1;87;14;0;14
021700013;300;220;210;6;97;202;1;97;3;2;92;0;0;0
021700014;600;653;654;4;107;522;1;77;3;1;73;30;0;30
021700015;400;470;470;4;80;342;1;57;5;1;51;23;0;23
021700016;500;548;548;6;153;412;1;87;0;1;86;66;7;59
021700017;500;586;586;1;145;403;1;96;1;1;94;49;2;47
021700018;500;581;581;5;219;376;1;123;2;3;118;96;0;96
021700019;400;367;367;5;142;329;1;70;2;4;64;72;2;70
021700020;500;500;501;6;179;410;5;85;6;3;76;94;2;92
021700021;400;410;411;4;134;288;2;110;2;5;103;24;0;24
021700022;400;472;476;0;177;324;1;75;0;2;73;102;3;99
021700023;500;510;510;7;191;414;1;85;3;5;77;106;4;102
021700024;700;850;850;2;291;552;1;147;4;3;140;144;7;137
021700025;700;853;854;1;274;556;3;141;2;3;136;133;5;128
021700026;500;550;550;4;174;422;1;77;2;2;73;97;7;90
021700027;200;193;193;4;86;113;1;86;2;4;80;0;0;0
021700028;400;464;464;3;148;331;1;68;0;1;67;80;5;75
021700029;600;734;734;6;224;482;1;117;6;1;110;107;3;104
021700030;400;421;422;4;131;328;2;70;2;6;62;61;0;61
021700031;500;525;523;9;145;399;1;100;1;6;93;45;0;45
021700032;600;773;773;5;101;501;2;97;7;2;88;4;0;4
021700033;400;387;387;4;142;332;1;67;1;1;65;75;2;73
021700034;200;182;182;5;105;94;1;105;3;7;95;0;0;0
021700035;300;268;270;5;69;229;2;69;2;2;65;0;0;0
021700036;400;392;392;4;152;319;1;80;2;1;77;72;0;72
021700037;500;609;610;3;210;363;2;135;6;3;126;75;2;73
021700038;500;585;585;2;155;417;1;82;4;2;76;73;3;70
021700039;500;533;534;11;189;396;1;103;1;2;100;86;6;80
021700040;700;953;953;6;121;594;1;105;16;0;89;16;0;16
021700041;200;108;108;3;39;160;1;39;0;0;39;0;0;0
021700042;100;37;35;6;21;78;1;21;1;0;20;0;0;0
021700043;500;514;514;4;151;380;1;119;11;2;106;32;1;31
021700044;700;698;727;2;251;477;1;222;6;6;210;29;0;29
021700045;400;465;465;3;116;301;1;98;5;4;89;18;0;18
021700046;600;689;689;5;122;499;1;100;8;1;91;22;1;21
021700047;300;207;207;5;84;215;1;84;2;1;81;0;0;0
021700049;300;130;130;38;106;193;1;106;3;4;99;0;0;0
021700050;300;33;33;54;85;214;1;85;1;7;77;0;0;0
021700051;500;522;522;5;134;395;1;104;5;1;98;30;5;25
021700052;100;11;11;4;15;85;0;15;0;0;15;0;0;0
021700053;100;11;11;16;18;80;2;18;2;1;15;0;0;0
021800001;900;923;925;2;226;673;1;226;24;1;201;0;0;0
021800002;600;622;622;9;271;366;1;233;13;6;214;38;2;36
021800003;700;712;712;2;280;456;1;243;11;4;228;37;0;37
021800004;700;687;687;1;248;450;2;248;5;10;233;0;0;0
021800005;300;270;270;7;140;158;2;140;0;2;138;0;0;0
021800006;900;869;877;6;521;378;1;521;3;0;518;0;0;0
021800007;700;714;714;1;455;251;4;445;4;2;439;10;0;10
021800008;600;629;629;6;352;255;5;340;12;6;322;12;0;12
021800009;400;363;363;1;152;255;1;144;0;1;143;8;1;7
021800010;300;321;325;3;144;155;1;144;0;1;143;0;0;0
021800011;700;686;687;4;374;325;1;374;14;1;359;0;0;0
021800012;400;407;410;1;282;122;1;277;0;0;277;5;0;5
021800013;1100;1043;1044;8;586;549;1;550;9;7;534;36;1;35
021800015;200;179;179;6;133;66;1;133;1;8;124;0;0;0
021800016;400;432;432;4;247;156;2;242;11;4;227;5;0;5
021800017;500;397;466;5;208;294;1;205;2;5;198;3;1;2
021800018;800;775;776;7;202;635;2;163;11;2;150;39;1;38
021800019;800;794;794;4;198;632;1;167;6;4;157;31;0;31
021800020;500;490;492;3;65;450;1;49;3;1;45;16;0;16
021800021;500;505;505;4;288;236;9;255;10;2;243;33;1;32
021800022;700;675;676;0;231;468;1;231;11;4;216;0;0;0
021800023;800;791;791;5;293;516;2;282;12;5;265;11;1;10
021800024;400;363;363;5;204;259;1;140;2;2;136;64;0;64
021800025;500;481;481;7;236;344;1;155;4;1;150;81;0;81
021800026;400;393;393;5;218;326;2;72;2;1;69;146;2;144
021800027;500;553;553;3;176;347;1;152;1;4;147;24;1;23
021800028;700;635;635;4;146;586;1;113;9;2;102;33;1;32
021800029;1000;968;970;7;456;544;1;455;1;2;452;1;0;1
021800030;700;695;695;3;354;354;1;345;0;5;340;9;0;9
021800031;400;380;380;3;222;207;1;192;6;1;185;30;1;29
021800032;300;226;226;4;161;138;1;161;0;0;161;0;0;0
021800033;600;559;560;8;226;395;1;204;9;4;191;22;1;21
021800034;800;807;807;7;320;480;9;311;10;4;297;9;0;9
021800035;500;452;452;6;200;301;1;198;9;4;185;2;2;0
021800036;400;372;372;5;196;257;1;142;0;1;141;54;0;54
021800037;550;599;599;4;228;389;4;157;1;0;156;69;1;68
021800038;300;340;340;0;205;94;1;205;4;4;197;0;0;0
021800039;1000;974;974;1;576;461;2;537;8;13;516;39;3;36
021800041;500;528;528;4;213;290;14;196;14;0;182;17;0;17
021800042;300;325;325;1;242;87;1;212;1;1;210;30;1;29
021800043;600;618;618;3;264;335;1;264;2;2;260;0;0;0
021800044;400;354;354;5;244;162;6;232;6;4;222;12;0;12
021800045;500;474;474;4;282;239;2;259;1;1;257;23;0;23
021800046;800;829;830;9;391;420;2;378;20;7;351;13;0;13
021800047;700;673;673;7;279;425;1;274;6;7;261;5;0;5
021800048;700;664;665;4;276;445;1;254;3;1;250;22;0;22
021800049;400;354;354;4;132;289;1;110;4;1;105;22;0;22
021800051;1200;1155;1157;4;346;896;1;303;16;4;283;43;1;42
021800052;500;452;452;3;227;499;1;0;0;0;0;227;1;226
021800053;100;34;34;3;37;63;0;37;0;0;37;0;0;0
022100001;500;511;511;4;246;365;1;134;9;4;121;112;8;104
022100002;400;440;440;9;208;298;1;101;4;3;94;107;4;103
022100003;800;810;810;4;300;632;7;161;6;5;150;139;2;137
022100004;500;526;527;3;172;396;2;102;4;4;94;70;2;68
022100005;900;912;912;3;339;707;2;191;2;5;184;148;5;143
022100006;600;687;688;3;274;460;1;139;4;3;132;135;4;131
022100008;250;212;211;2;96;153;1;96;5;0;91;0;0;0
022100009;500;502;502;6;169;411;1;88;3;7;78;81;10;71
022100010;150;99;99;2;78;66;6;78;5;0;73;0;0;0
022100011;250;204;205;4;58;191;1;58;6;1;51;0;0;0
022100012;400;431;431;2;110;306;2;92;5;3;84;18;1;17
022100013;400;423;423;4;73;338;2;60;7;1;52;13;1;12
022100015;150;132;132;3;81;68;1;81;7;3;71;0;0;0
022100016;600;642;642;7;163;498;1;101;7;2;92;62;1;61
022100017;150;85;85;6;49;100;1;49;3;2;44;0;0;0
022100018;550;592;593;3;237;348;1;201;8;4;189;36;0;36
022100019;700;727;727;4;151;578;1;121;15;3;103;30;0;30
022100020;700;771;771;4;221;522;1;177;22;2;153;44;0;44
022100021;300;338;338;4;119;229;1;70;7;1;62;49;3;46
022100022;900;921;921;5;317;720;2;178;9;8;161;139;7;132
022100023;800;869;869;3;326;623;4;173;7;6;160;153;10;143
022300001;600;664;664;7;155;485;2;113;9;0;104;42;0;42
022300002;600;578;578;9;171;499;1;100;7;2;91;71;2;69
022300003;600;627;627;3;171;484;1;115;4;3;108;56;3;53
022300004;700;913;913;4;253;450;2;248;30;1;217;5;1;4
022300005;100;61;61;8;43;56;1;43;0;0;43;0;0;0
022300006;100;56;56;4;35;64;1;35;0;1;34;0;0;0
022300007;100;47;47;2;28;71;1;28;2;0;26;0;0;0
022300008;300;287;287;7;135;163;2;135;4;4;127;0;0;0
022300009;100;90;91;5;49;50;1;49;1;1;47;0;0;0
022300010;100;57;57;57;29;70;1;29;1;0;28;0;0;0
022300011;300;308;308;5;107;192;1;107;13;1;93;0;0;0
022300012;600;637;637;5;267;339;1;260;10;1;249;7;0;7
022300013;100;25;25;8;28;71;1;28;0;1;27;0;0;0
022300014;100;34;34;5;24;75;1;24;0;0;24;0;0;0
022300015;100;62;62;6;28;71;1;28;1;1;26;0;0;0
022300016;200;193;193;4;34;165;1;34;1;0;33;0;0;0
022300017;300;292;292;6;145;175;2;123;7;3;113;22;0;22
022300018;300;312;312;5;80;219;1;80;4;0;76;0;0;0
022300019;600;604;605;6;221;406;1;193;11;3;179;28;0;28
022300020;600;532;600;6;232;376;5;219;6;1;212;13;1;12
022300021;500;508;509;5;191;320;1;179;7;9;163;12;0;12
022300022;300;259;259;4;122;170;8;122;7;2;113;0;0;0
022300023;500;460;460;4;198;327;2;171;10;5;156;27;1;26
022300024;200;140;140;6;67;132;1;67;0;3;64;0;0;0
022300025;600;606;608;4;201;407;1;192;24;1;167;9;0;9
022300026;200;153;153;6;75;124;1;75;7;1;67;0;0;0
022300027;700;805;805;5;242;472;2;226;10;3;213;16;0;16
022300028;100;42;42;8;27;72;1;27;1;0;26;0;0;0
022300029;300;267;267;6;120;179;1;120;7;2;111;0;0;0
022300030;500;492;492;5;223;328;1;171;8;1;162;52;0;52
022300031;100;35;35;0;29;70;1;29;2;1;26;0;0;0
022700001;700;774;775;3;261;561;1;138;5;10;123;123;5;118
022700002;900;979;980;7;320;725;1;174;6;2;166;146;8;138
022700003;900;991;991;1;297;708;1;191;6;5;180;106;4;102
022700004;700;306;707;6;312;465;1;234;24;1;209;78;2;76
022700005;150;130;130;3;67;81;2;67;3;5;59;0;0;0
022700006;400;425;426;4;173;285;1;114;0;7;107;59;3;56
022700007;50;40;40;12;27;22;1;27;3;2;22;0;0;0
022700008;800;824;826;3;323;618;1;181;7;3;171;142;6;136
022700009;400;409;410;4;182;278;1;121;5;6;110;61;3;58
030100001;500;508;509;3;216;343;1;156;2;4;150;60;0;60
030100002;500;485;461;5;208;340;1;159;12;3;144;49;1;48
030100003;550;616;604;5;305;358;1;191;3;8;180;114;2;112
030100004;200;151;134;1;88;111;1;88;4;1;83;0;0;0
030100005;350;349;350;4;150;232;3;115;6;1;108;35;0;35
030100006;600;719;719;2;401;200;1;399;21;2;376;2;0;2
030100007;300;306;298;6;205;94;1;205;5;13;187;0;0;0
030100008;200;207;195;3;53;146;1;53;4;0;49;0;0;0
030100009;200;184;116;4;117;82;1;117;5;2;110;0;0;0
030100010;100;59;56;6;54;45;1;54;2;1;51;0;0;0
030100011;700;811;783;3;342;474;3;223;9;4;210;119;5;114
030100012;200;140;72;4;88;111;1;88;2;3;83;0;0;0
030100013;300;239;186;5;147;152;1;147;10;4;133;0;0;0
030100014;700;875;874;0;255;468;2;230;21;8;201;25;1;24
030100015;500;442;427;5;226;290;1;209;18;6;185;17;0;17
030100016;500;502;453;4;241;281;1;218;20;2;196;23;2;21
030100017;100;76;74;2;28;71;1;28;2;2;24;0;0;0
030200001;600;754;754;6;296;446;1;153;4;1;148;143;4;139
030200002;600;784;788;3;265;491;1;108;3;3;102;157;4;153
030200003;600;757;758;5;277;467;3;130;5;6;119;147;4;143
030200004;600;586;587;2;154;532;1;67;3;6;58;87;4;83
030200005;600;727;728;2;181;510;1;89;6;0;83;92;5;87
030200006;700;795;799;4;284;547;1;152;5;6;141;132;4;128
030200007;600;761;761;2;252;473;1;126;1;4;121;126;7;119
030200008;600;670;673;0;215;504;1;95;3;1;91;120;5;115
030200009;600;729;729;4;243;460;2;138;9;2;127;105;0;105
030200010;600;749;738;5;315;289;4;307;17;0;290;8;0;8
030200011;700;879;661;5;365;342;1;357;34;10;313;8;1;7
030200012;200;192;192;4;109;88;3;109;2;6;101;0;0;0
030200013;200;144;144;4;104;95;1;104;0;1;103;0;0;0
030200014;600;594;594;3;162;477;1;122;13;2;107;40;0;40
030200015;600;666;670;5;153;458;2;140;9;1;130;13;1;12
030200016;600;643;643;9;188;438;13;149;12;1;136;39;2;37
030200017;600;718;718;6;180;445;1;154;8;0;146;26;1;25
030200018;600;692;694;3;160;456;1;143;27;2;114;17;0;17
030200019;600;665;628;6;250;419;1;180;17;4;159;70;6;64
030200020;200;121;121;5;71;128;1;71;1;1;69;0;0;0
030200021;700;804;805;4;300;510;1;189;5;8;176;111;1;110
030200022;300;305;306;3;161;138;1;161;3;3;155;0;0;0
030200023;200;234;235;4;145;54;1;145;2;5;138;0;0;0
030200024;200;252;255;5;128;71;1;128;0;5;123;0;0;0
030200025;100;82;82;2;63;36;1;63;3;0;60;0;0;0
030200026;200;176;176;5;108;91;1;108;3;2;103;0;0;0
030200027;400;309;311;5;143;256;1;143;3;1;139;0;0;0
030200028;400;358;358;3;144;300;1;99;11;2;86;45;1;44
030200029;200;125;125;2;80;119;1;80;0;1;79;0;0;0
030200030;200;110;110;2;68;131;1;68;2;0;66;0;0;0
030200031;200;124;124;4;72;127;1;72;2;7;63;0;0;0
030200032;100;30;31;4;23;76;1;23;0;0;23;0;0;0
030200033;400;294;218;1;79;319;2;79;8;0;71;0;0;0
030200034;500;514;403;4;142;357;1;142;14;2;126;0;0;0
030200035;400;360;284;4;93;306;1;93;9;1;83;0;0;0
030200036;300;296;296;1;193;106;1;193;7;3;183;0;0;0
030200037;100;93;93;6;57;42;1;57;5;1;51;0;0;0
030200038;100;13;13;4;16;83;1;16;1;1;14;0;0;0
030400001;900;875;877;2;253;677;1;222;79;0;143;31;4;27
030400002;800;808;808;5;222;669;1;130;19;5;106;92;5;87
030400003;800;801;801;5;208;670;2;128;8;1;119;80;0;80
030400004;800;747;747;4;174;694;1;105;0;3;102;69;4;65
030400005;600;557;557;4;178;488;1;111;4;4;103;67;4;63
030400006;500;509;509;6;142;428;1;71;1;1;69;71;1;70
030400007;500;526;527;6;169;411;1;88;5;2;81;81;6;75
030400008;600;544;545;3;130;546;1;53;1;2;50;77;1;76
030400009;500;425;425;3;82;463;1;36;0;2;34;46;5;41
030400010;500;472;474;3;123;427;1;72;3;1;68;51;3;48
030400011;400;370;370;2;100;339;1;60;2;0;58;40;1;39
030400012;700;682;667;1;251;564;1;135;13;4;118;116;7;109
030400013;600;563;563;4;207;465;1;134;5;2;127;73;1;72
030400014;800;930;930;4;310;581;2;217;14;6;197;93;3;90
030500001;800;858;859;1;282;645;1;154;8;7;139;128;1;127
030500002;700;768;768;1;290;506;1;193;11;7;175;97;4;93
030500003;100;81;81;1;47;52;1;47;1;2;44;0;0;0
030500004;200;203;203;2;74;125;1;74;5;1;68;0;0;0
030500005;300;233;233;3;129;170;1;129;19;3;107;0;0;0
030500006;400;409;409;1;88;331;1;68;10;2;56;20;0;20
030600378;600;632;632;6;225;462;1;137;7;2;128;88;3;85
030600379;500;483;483;3;156;400;1;99;4;5;90;57;4;53
030600380;600;204;204;4;208;471;5;124;4;2;118;84;5;79
030600381;700;718;718;4;240;563;1;136;4;5;127;104;7;97
030600382;500;318;318;6;167;388;1;111;4;2;105;56;1;55
030600383;500;423;423;7;148;403;1;96;4;1;91;52;1;51
030600384;500;832;832;8;101;398;1;101;22;0;79;0;0;0
030600385;500;784;784;8;119;379;2;119;12;1;106;0;0;0
030600386;1000;973;973;6;380;823;1;176;5;5;166;204;16;188
030600387;1000;1097;1097;6;330;782;3;215;7;8;200;115;4;111
030600412;500;27;27;8;35;465;0;35;0;0;35;0;0;0
030600413;100;20;20;9;28;72;0;28;2;0;26;0;0;0
030600414;100;16;16;0;15;85;0;15;1;0;14;0;0;0
030601001;500;649;649;16;245;402;1;97;6;0;91;148;0;148
030601002;500;788;790;16;327;370;2;128;4;3;121;199;10;189
030601003;1000;903;905;11;407;814;2;184;4;6;174;223;4;219
030601004;500;777;779;13;327;346;1;153;1;2;150;174;4;170
030601005;500;704;704;12;286;367;1;132;3;2;127;154;19;135
030601006;500;592;592;8;236;380;4;116;0;5;111;120;6;114
030601007;500;679;682;9;271;392;1;107;5;2;100;164;8;156
030601008;500;605;605;10;213;398;2;100;2;2;96;113;2;111
030601009;500;550;550;9;235;400;1;99;2;2;95;136;4;132
030601010;500;596;599;6;261;386;2;112;3;3;106;149;2;147
030601011;500;701;703;9;298;346;1;153;4;3;146;145;2;143
030601012;500;807;808;9;313;250;1;249;5;8;236;64;1;63
030601013;500;745;746;8;334;339;1;160;3;4;153;174;3;171
030601014;500;699;703;9;271;377;1;122;2;4;116;149;3;146
030601015;500;778;780;10;303;368;3;129;2;7;120;174;4;170
030601016;1000;925;925;7;313;814;1;185;4;6;175;128;5;123
030601017;1000;953;953;20;350;840;2;158;3;4;151;192;4;188
030601018;1000;1066;1067;6;415;824;1;175;2;0;173;240;5;235
030601019;1000;811;814;10;292;855;1;144;6;2;136;148;6;142
030601020;1000;956;957;4;345;838;2;160;4;2;154;185;5;180
030601021;1000;978;978;8;333;842;2;156;11;1;144;177;1;176
030601022;500;750;754;10;288;313;1;186;0;3;183;102;2;100
030601023;1000;935;950;12;334;842;2;156;7;6;142;178;9;169
030601024;1000;932;933;8;334;837;1;162;5;3;154;172;7;165
030601025;500;731;733;11;270;379;1;120;5;2;113;150;10;140
030601026;1000;884;884;9;353;832;1;167;5;4;158;186;3;183
030601027;500;714;716;8;268;374;1;125;7;0;118;143;8;135
030601028;1000;826;848;7;309;847;2;151;7;2;142;158;7;151
030601029;500;704;708;9;285;376;2;122;1;4;117;163;6;157
030601030;1000;850;851;8;349;851;2;147;5;8;134;202;4;198
030601031;500;587;588;10;234;392;1;107;2;4;101;127;5;122
030601032;1000;895;897;7;378;828;1;171;2;4;165;207;8;199
030601033;1000;942;942;8;281;866;1;133;15;0;118;148;5;143
030601034;500;736;736;8;306;379;1;120;3;1;116;186;6;180
030601035;500;701;705;8;295;353;1;146;4;3;139;149;4;145
030601036;500;554;554;13;257;387;3;101;0;1;98;147;10;137
030601037;500;697;697;6;288;383;1;116;3;2;111;172;6;166
030601038;1000;771;815;11;327;853;1;146;5;2;139;181;1;180
030601039;1000;873;873;9;384;813;5;182;4;4;174;202;4;198
030601040;500;538;538;16;249;395;1;104;3;4;97;145;8;137
030601041;500;602;603;5;263;384;1;115;0;5;110;148;4;144
030601042;500;707;709;7;277;398;2;100;4;0;96;176;12;164
030601043;500;761;761;13;317;336;1;163;2;6;155;154;7;147
030601044;500;634;636;10;272;361;1;138;2;2;134;134;5;129
030601045;500;711;716;8;313;378;2;120;3;3;114;193;11;182
030601046;1000;883;884;11;365;801;2;197;8;4;185;168;8;160
030601047;1000;876;877;9;375;799;2;199;6;4;189;176;7;169
030601048;1000;901;902;5;343;830;1;169;2;4;163;174;9;165
030601049;500;788;790;10;306;334;1;165;4;4;157;141;9;132
030601050;1000;895;913;8;356;828;2;170;4;4;162;186;10;176
030601051;1000;882;882;6;311;861;1;138;2;0;136;173;2;171
030601052;1000;829;829;6;308;836;1;163;0;5;158;145;5;140
030601053;500;767;768;2;303;383;1;116;2;2;112;187;4;183
030601054;1000;863;866;6;298;875;1;124;2;3;119;174;6;168
030601055;1000;884;887;9;349;846;3;151;5;5;141;198;12;186
030601056;1000;1033;1033;5;408;833;2;165;2;5;158;243;2;241
030601057;1000;968;969;6;380;821;1;178;6;8;164;202;8;194
030601058;1000;871;872;7;323;841;1;158;15;6;137;165;5;160
030601059;1000;972;973;12;386;807;7;186;1;6;179;200;5;195
030601060;1000;1009;1009;11;410;623;8;369;7;10;352;41;0;41
030601061;1000;818;821;12;328;859;1;140;3;4;133;188;8;180
030601062;1000;857;878;10;368;835;1;164;7;3;154;204;9;195
030601063;1000;922;925;9;330;855;3;142;3;4;135;188;5;183
030601064;1000;1052;1052;6;355;833;3;164;6;3;155;191;11;180
030601065;1000;1105;1130;6;399;788;5;207;9;7;191;192;5;187
030601066;1000;859;860;9;319;859;3;138;3;1;134;181;12;169
030601067;1000;880;882;8;110;890;0;110;6;3;101;153;5;153
030601068;1000;925;925;12;317;810;1;189;3;2;184;128;4;124
030601069;1000;998;1001;9;313;859;4;137;3;1;133;176;2;174
030601070;1000;951;953;8;334;834;3;163;9;3;151;171;9;162
030601071;500;772;775;8;227;389;1;110;4;2;104;117;6;111
030601072;500;712;715;10;182;386;8;106;7;2;97;76;0;76
030601073;500;561;563;5;88;432;1;67;6;0;61;21;2;19
030601074;500;390;391;8;80;448;1;51;2;0;49;29;2;27
030601075;1000;824;825;9;140;871;3;126;31;1;94;14;0;14
030601076;1000;876;880;5;110;895;1;104;27;0;77;6;0;6
030601077;1000;850;850;8;176;880;1;119;12;1;106;57;1;56
030601078;1000;979;983;4;204;888;1;111;4;2;105;93;3;90
030601079;1000;901;905;7;281;856;3;141;4;4;133;140;5;135
030601080;1000;923;932;6;319;843;1;156;5;6;145;163;7;156
030601081;1000;935;935;5;277;870;1;129;9;3;117;148;4;144
030601082;1000;910;912;7;287;864;2;134;1;2;131;153;6;147
030601083;500;689;689;8;228;376;1;123;2;2;119;105;2;103
030601084;1000;899;900;6;392;823;1;176;4;6;166;216;11;205
030601085;1000;862;862;14;337;833;1;166;5;5;156;171;8;163
030601086;500;589;590;7;227;394;1;105;4;2;99;122;2;113
030602087;800;859;859;10;340;688;1;111;0;0;111;229;9;220
030602088;700;777;778;9;274;581;2;117;6;2;109;157;5;152
030602089;600;760;760;9;234;502;1;97;0;3;94;137;6;131
030602090;700;735;736;9;292;580;3;117;2;2;113;175;3;169
030602091;900;943;944;7;319;771;1;128;4;2;122;191;3;188
030602092;900;981;987;13;362;756;2;142;8;6;128;220;12;208
030602093;900;946;947;9;389;742;1;157;8;3;146;232;15;217
030602094;900;974;974;11;365;704;7;189;7;2;180;176;2;174
030602095;900;880;883;0;310;765;2;133;2;4;127;177;8;169
030602096;1000;1007;1010;7;365;845;3;152;4;6;142;213;12;201
030602097;900;922;922;7;384;585;5;310;4;9;297;74;6;68
030602098;800;816;837;13;314;666;2;132;5;3;124;182;7;175
030602099;700;744;745;8;269;584;2;114;4;3;107;155;3;152
030602100;700;689;689;15;260;591;2;107;6;5;96;153;9;144
030602101;700;797;797;10;316;582;1;117;6;4;107;199;9;190
030602102;600;593;594;25;233;494;4;102;0;0;102;131;9;122
030602103;800;829;829;15;336;639;3;158;2;2;154;178;2;176
030602104;900;866;866;11;320;764;1;135;2;4;129;185;3;182
030602105;400;387;390;25;157;326;1;73;2;2;69;84;3;81
030602106;400;379;379;25;163;344;0;56;0;2;54;107;3;104
030602107;700;737;742;8;230;582;1;117;3;1;113;113;2;111
030602108;900;906;907;8;358;728;8;164;8;7;149;194;3;191
030602109;900;929;929;10;372;747;2;151;4;5;142;221;12;209
030602110;700;712;712;9;268;535;1;164;4;4;156;104;3;101
030602111;800;815;816;11;286;679;1;120;2;2;116;166;6;160
030602112;800;871;891;9;302;675;4;121;1;1;119;181;4;177
030602113;700;689;689;6;249;602;1;97;4;3;90;152;8;144
030602114;600;616;616;7;219;520;1;79;3;2;74;140;7;133
030602115;900;885;889;7;341;761;1;138;2;1;135;203;10;193
030602116;700;718;719;11;279;571;3;126;2;6;118;153;8;145
030602117;800;821;823;3;306;495;1;304;7;17;280;2;0;2
030602118;700;768;772;12;326;543;1;156;6;3;147;170;5;165
030602119;700;769;771;12;317;585;1;114;2;3;109;203;11;192
030602120;900;989;991;11;343;746;1;153;4;4;145;190;4;186
030602121;700;747;749;12;274;584;1;115;3;1;111;159;11;148
030602122;800;856;858;6;309;671;1;128;1;3;124;181;7;174
030602123;900;936;937;9;399;717;1;182;4;4;174;217;10;207
030602124;800;827;830;9;339;626;1;173;1;2;170;166;4;162
030602125;800;803;804;7;318;658;1;141;2;2;137;177;7;170
030602126;900;866;866;7;298;771;1;128;2;3;123;170;7;163
030602127;700;712;712;7;203;613;1;86;0;2;84;117;4;113
030602128;700;710;711;10;226;607;1;92;6;3;83;134;6;128
030602129;900;882;882;9;354;762;3;135;4;2;129;219;8;211
030602130;900;892;893;270;396;727;2;171;1;3;167;225;9;216
030602131;900;907;909;11;406;717;0;183;8;2;173;223;12;211
030602132;1000;998;998;9;450;603;3;394;3;17;374;56;2;54
030602133;700;669;669;22;296;549;4;147;4;3;140;149;8;141
030602134;700;761;761;11;320;566;1;133;3;2;128;187;9;178
030602135;800;788;788;11;367;627;2;171;4;5;162;196;10;186
030602136;700;682;683;10;291;552;1;147;2;3;142;144;6;138
030602137;800;886;886;11;367;635;1;164;5;5;154;203;4;199
030602138;1000;1048;1051;17;463;798;6;196;3;4;189;267;7;260
030602139;800;872;872;18;355;628;2;170;5;5;160;185;3;182
030602140;900;918;919;12;378;527;1;372;2;11;359;6;0;6
030602141;900;947;950;7;396;738;3;159;2;4;153;237;2;235
030602142;1000;1004;1007;6;392;639;8;353;7;19;327;39;0;39
030602143;700;708;709;8;288;586;2;112;4;5;103;176;5;171
030602144;700;732;734;11;267;602;1;97;2;2;93;170;9;161
030602145;700;686;688;5;229;606;1;93;2;0;91;136;5;131
030602146;700;739;742;7;327;508;8;184;7;6;171;143;3;140
030602147;800;827;829;6;339;473;0;327;9;12;306;12;0;12
030602148;600;671;671;11;269;469;1;130;4;3;123;139;4;135
030602149;600;639;641;10;264;464;1;135;2;5;128;129;3;126
030602150;700;788;788;16;302;573;6;121;4;5;112;181;9;172
030602151;800;827;828;11;339;648;1;151;6;2;143;188;10;178
030602152;900;903;904;11;340;564;1;335;2;12;321;5;0;5
030602153;600;573;573;22;237;494;1;105;0;5;100;132;5;127
030602154;900;986;986;7;365;768;1;131;2;3;126;234;15;219
030602155;600;619;619;7;230;414;1;185;3;7;175;45;1;44
030602156;600;575;577;9;261;475;1;124;4;2;118;137;3;134
030602157;600;620;642;6;244;481;6;113;4;4;105;131;7;124
030602158;600;609;612;9;253;494;1;105;2;1;102;148;2;146
030602159;600;583;607;11;243;490;3;107;2;1;104;136;8;128
030602160;600;628;629;7;249;467;1;132;2;0;130;117;6;111
030602161;600;648;648;8;276;485;1;114;5;5;104;162;5;157
030602162;600;668;668;7;260;482;2;116;6;2;108;144;10;134
030602163;600;632;632;9;254;486;6;108;6;3;99;146;7;139
030602164;600;640;642;8;255;484;1;115;1;4;110;140;8;132
030602165;800;870;870;10;393;616;3;181;3;2;176;212;9;203
030602166;600;598;602;7;255;467;2;131;4;6;121;124;10;114
030602167;500;539;541;10;223;401;1;98;3;2;93;125;6;119
030602168;600;636;639;10;259;494;1;105;3;3;99;154;5;149
030602169;900;908;908;9;374;622;2;276;4;7;265;98;7;91
030602170;700;755;759;7;292;579;2;119;4;3;112;173;12;161
030602171;1100;467;1268;8;464;909;3;188;8;7;173;276;8;268
030602172;1300;1381;1417;7;547;802;6;492;6;17;469;55;2;53
030602173;500;553;553;5;206;420;1;79;2;0;77;127;2;125
030602174;700;698;713;4;249;594;2;104;2;1;101;145;4;141
030602175;1100;1242;1245;9;400;917;1;182;8;4;170;218;8;210
030602176;1000;974;975;7;337;825;1;174;3;7;164;163;7;156
030602177;1000;980;981;4;322;826;1;173;5;7;161;149;6;143
030602178;1000;1087;1088;3;336;849;1;150;2;5;143;186;12;174
030602179;800;892;895;7;259;668;1;131;6;4;121;128;6;122
030602180;1000;1028;1028;3;350;783;1;216;9;6;201;134;0;134
030602181;1000;1100;1100;4;394;810;2;188;4;2;182;206;9;197
030602182;700;752;752;9;312;569;2;129;1;3;125;183;4;179
030602183;900;901;904;15;321;782;2;116;1;1;114;205;9;196
030602184;1000;1121;1145;4;394;678;2;320;1;8;311;74;2;72
030602185;800;804;823;4;279;609;1;190;5;6;179;89;1;88
030602186;700;771;772;6;318;564;1;135;1;7;127;183;10;173
030602187;600;691;691;9;270;414;2;184;5;5;174;86;2;84
030602188;800;842;844;7;290;675;1;124;6;4;114;166;3;163
030602189;1000;413;1140;9;422;854;0;146;3;3;140;276;17;259
030602190;900;1057;1058;5;390;508;2;390;6;7;377;0;0;0
030602191;700;740;756;3;278;466;1;233;3;3;227;45;1;44
030602388;500;556;556;7;222;420;1;79;1;2;76;143;4;139
030602389;600;256;616;5;256;536;1;63;2;0;61;193;9;184
030602390;500;473;475;6;190;418;1;81;1;0;80;109;4;105
030602391;500;466;468;6;191;427;2;71;1;3;67;120;6;114
030602392;500;542;552;7;188;423;1;76;4;1;71;112;4;108
030602394;1000;1090;1091;12;446;832;4;164;5;6;153;282;15;267
030602399;200;92;92;12;71;128;1;71;11;1;59;0;0;0
030602400;200;39;39;13;33;165;2;33;0;1;32;0;0;0
030602401;500;71;71;103;153;346;1;153;5;10;138;0;0;0
030602402;300;17;17;35;46;253;1;46;1;4;41;0;0;0
030602403;400;24;24;108;109;290;1;109;0;7;102;0;0;0
030602405;100;17;17;12;20;79;1;20;0;0;20;0;0;0
030603192;700;751;774;19;270;564;3;133;5;0;128;137;2;135
030603193;700;728;738;5;256;627;1;72;0;0;72;184;8;176
030603194;500;519;519;9;181;429;2;69;0;1;68;112;7;105
030603195;800;867;867;11;302;661;1;138;1;2;135;164;6;158
030603196;800;766;768;9;192;705;1;94;2;1;91;98;7;91
030603197;800;801;803;4;231;706;1;93;4;2;87;138;6;132
030603198;900;953;956;5;318;753;1;146;5;5;136;172;3;169
030603199;900;980;980;5;342;733;1;166;1;6;159;176;9;167
030603200;700;773;773;9;268;555;1;144;5;5;134;124;2;122
030603201;800;791;791;9;285;672;1;127;3;3;121;158;3;155
030603202;800;848;848;2;263;672;1;127;3;1;123;136;5;131
030603203;800;839;840;7;256;655;1;144;7;2;135;112;5;107
030603204;800;822;822;7;303;661;1;138;2;6;130;165;5;160
030603205;900;848;850;7;272;663;1;236;3;12;221;36;1;35
030603206;700;706;706;4;200;604;1;95;3;4;88;105;5;100
030603207;800;760;760;8;236;682;1;117;4;2;111;119;4;115
030603208;900;850;850;5;258;772;1;127;2;0;125;131;4;127
030603209;900;911;913;7;342;747;1;152;4;2;146;190;9;181
030603210;800;751;751;5;226;690;1;109;3;1;105;117;4;113
030603211;700;694;696;8;210;591;1;108;3;3;102;102;3;99
030603212;800;800;800;7;251;677;1;122;2;3;117;129;2;127
030603213;700;655;655;10;241;569;1;130;2;6;122;111;4;107
030603214;500;484;486;19;186;398;3;99;9;1;89;87;3;84
030603215;900;921;924;4;364;717;1;182;3;4;175;182;10;172
030603216;700;718;719;5;270;603;1;96;2;2;92;174;8;166
030603217;500;499;500;5;176;420;1;79;3;0;76;97;2;95
030603218;900;974;976;8;374;700;1;199;9;8;182;175;7;168
030603219;500;470;472;9;177;422;2;76;2;4;70;101;4;97
030603220;600;637;637;2;194;508;1;91;2;1;88;103;6;97
030603221;700;730;730;7;242;586;2;112;2;0;110;130;7;123
030603222;400;350;353;6;115;349;1;50;3;2;45;65;2;63
030603223;400;410;425;6;167;319;2;79;3;5;71;88;5;83
030603224;400;474;474;2;145;347;1;52;1;2;49;93;11;82
030603225;400;375;375;6;132;331;1;68;2;1;65;64;5;59
030603226;800;782;782;8;259;672;2;126;5;2;119;133;5;128
030603227;800;941;942;8;343;646;1;153;4;7;142;190;8;182
030603228;600;644;646;6;180;510;1;89;1;5;83;91;3;88
030603229;400;408;408;5;127;340;2;58;4;0;54;69;3;66
030603230;600;623;623;8;213;486;1;113;1;6;106;100;4;96
030603231;600;639;639;8;211;494;2;104;1;5;98;107;6;101
030603232;600;583;585;8;189;515;3;82;3;3;76;107;5;102
030603233;600;646;646;9;235;488;1;111;2;2;107;124;1;123
030603234;600;628;628;7;177;422;1;177;4;5;168;0;0;0
030603235;600;575;575;9;182;502;1;97;1;5;91;85;2;83
030603236;500;524;524;11;168;418;3;79;6;3;70;89;8;81
030603237;900;931;931;6;314;745;6;149;5;4;140;165;6;159
030603238;600;648;648;8;263;502;1;97;1;2;94;166;9;157
030603239;900;1077;1080;5;385;570;2;328;6;15;307;57;2;55
030603240;700;709;710;9;244;598;1;101;4;4;93;143;13;130
030603241;800;776;780;9;342;636;2;162;4;7;151;180;7;173
030603242;600;642;642;7;251;436;2;162;7;7;148;89;9;80
030603243;700;743;743;6;277;569;1;130;10;0;120;147;7;140
030603244;700;725;739;5;269;570;1;129;6;3;120;140;7;133
030603245;800;781;784;9;258;676;2;122;6;2;114;136;8;128
030603246;500;481;485;5;179;444;1;55;2;8;45;124;7;117
030603247;400;426;427;5;170;333;1;66;1;1;64;104;7;97
030603248;600;586;596;8;241;487;1;112;1;2;109;129;3;126
030603249;400;409;411;7;149;327;1;72;2;3;67;77;2;75
030603250;700;702;703;5;244;590;3;107;4;2;101;137;5;132
030603251;800;779;781;6;278;664;1;135;2;2;131;143;5;138
030603252;400;449;449;5;157;321;1;78;1;2;75;79;2;77
030603253;600;576;577;7;218;487;1;112;2;0;110;106;2;104
030603254;400;422;422;5;160;323;2;75;1;2;72;85;6;79
030603255;500;500;500;9;163;434;1;65;4;2;59;98;3;95
030603256;500;477;481;8;173;411;2;87;2;3;82;86;4;82
030603257;600;579;579;8;212;513;2;85;3;2;80;127;9;118
030603258;800;799;799;4;276;685;1;114;4;0;110;162;8;154
030603259;500;518;518;6;199;406;4;90;2;1;87;109;6;103
030603260;600;635;638;7;254;486;1;113;5;3;105;141;10;131
030603261;800;782;782;7;274;667;1;132;0;0;132;142;4;138
030603262;800;809;811;8;283;666;2;132;5;4;123;151;3;148
030603263;700;653;657;7;218;583;1;116;4;6;106;102;6;96
030603264;700;712;713;8;241;593;1;106;3;2;101;135;3;132
030603265;300;341;347;10;351;241;1;58;0;1;57;58;1;57
030603266;900;999;1001;9;343;755;2;143;6;9;128;200;6;194
030603267;900;881;881;8;297;774;2;124;3;1;120;173;5;168
030603268;600;640;643;6;232;474;1;125;6;2;117;107;2;105
030603269;700;655;657;7;188;579;1;120;6;4;110;68;1;67
030603270;600;630;629;9;161;489;1;110;5;0;105;51;2;49
030603271;800;759;759;9;258;629;1;170;4;4;162;88;3;85
030603272;600;624;625;6;137;528;1;71;6;1;64;66;0;66
030603273;900;889;890;8;83;839;1;60;4;1;55;23;1;22
030603274;800;800;802;6;224;656;1;143;9;1;133;81;1;80
030603275;900;998;1001;7;134;790;1;109;9;0;100;25;0;25
030603276;800;800;800;7;108;722;11;67;10;1;56;41;0;41
030603277;700;654;655;5;248;559;1;140;5;3;132;108;7;101
030603278;700;648;661;7;195;602;2;96;7;1;88;99;5;94
030603279;800;829;831;8;208;691;1;108;2;2;104;100;1;99
030603280;800;781;782;10;104;724;1;75;9;0;66;29;1;28
030603281;900;917;917;7;374;720;2;178;2;4;172;196;7;189
030603282;600;608;609;8;223;472;1;127;2;3;122;96;2;94
030603283;500;532;532;9;229;270;1;229;7;3;219;0;0;0
030603284;600;605;605;8;235;482;4;114;0;3;111;121;8;113
030603285;600;608;608;10;229;499;1;100;5;5;90;129;3;126
030603286;900;900;901;7;346;777;2;121;3;2;116;225;5;220
030603287;500;456;464;7;175;425;1;74;7;2;65;101;4;97
030603288;500;546;546;9;191;427;2;71;2;2;67;120;6;114
030603289;400;359;362;5;119;356;1;43;0;1;42;76;2;74
030603290;800;785;785;10;309;668;1;131;9;3;119;178;6;172
030603393;800;812;812;1;263;678;1;121;0;5;116;142;4;138
030603395;500;565;565;8;216;427;2;71;2;6;63;145;5;140
030603396;500;518;518;4;160;414;2;84;2;4;78;76;1;75
030603397;500;517;519;8;156;421;1;78;2;2;74;78;1;77
030603398;500;573;574;9;218;391;3;106;3;2;101;112;4;108
030603409;100;48;48;18;60;37;3;60;3;3;54;0;0;0
030603410;100;56;56;12;63;36;1;63;3;5;55;0;0;0
030604291;500;475;478;8;166;410;1;89;1;2;86;77;5;72
030604292;500;494;495;6;159;395;1;104;1;0;103;55;1;54
030604293;500;472;474;5;160;409;2;89;4;3;82;71;3;68
030604294;500;590;592;6;212;398;2;100;5;1;94;112;3;109
030604295;500;526;526;6;179;414;1;85;2;4;79;94;5;89
030604296;500;551;557;5;165;412;1;87;0;4;83;78;1;77
030604297;700;748;748;4;205;582;1;117;7;3;107;88;4;84
030604298;601;598;601;4;63;552;1;48;4;0;44;15;2;13
030604299;700;766;766;6;185;598;1;101;8;2;91;84;1;83
030604300;900;912;913;9;103;812;3;85;12;1;72;18;0;18
030604301;600;615;616;6;197;489;1;110;3;3;104;87;2;85
030604302;600;573;573;7;148;529;1;70;0;1;69;78;3;75
030604303;400;358;358;6;117;282;1;117;1;0;116;0;0;0
030604304;500;536;536;9;172;327;1;172;4;5;163;0;0;0
030604305;400;378;379;6;117;334;1;65;1;0;64;52;1;51
030604306;400;381;382;6;116;340;2;58;2;0;56;58;3;55
030604307;600;681;681;10;184;509;2;89;5;1;83;95;5;90
030604308;600;613;613;6;53;552;1;47;9;0;38;6;0;6
030604309;700;706;708;6;233;579;1;120;2;2;116;113;2;111
030604310;700;749;749;4;220;580;1;119;7;2;110;101;8;93
030604311;800;807;807;8;298;624;1;175;6;2;167;123;6;117
030604312;800;897;899;8;243;665;1;134;1;7;126;109;2;107
030604313;800;763;763;11;252;661;1;138;10;3;125;114;1;113
030604314;700;712;712;5;230;502;7;191;6;4;181;39;0;39
030604315;800;824;824;8;280;652;1;147;4;4;139;133;11;122
030604316;700;716;716;3;244;579;2;119;5;2;112;125;3;122
030604317;700;746;746;4;254;588;1;111;3;5;103;143;4;139
030604318;600;642;642;8;202;507;2;91;3;1;87;111;8;103
030604319;600;652;652;6;214;489;1;110;3;0;107;104;3;101
030604320;600;643;644;7;193;508;1;91;4;0;87;102;4;98
030604321;700;690;691;3;226;600;2;98;7;4;87;128;5;123
030604322;700;670;672;4;229;592;1;107;0;4;103;122;3;119
030604323;600;617;618;7;199;502;1;97;2;4;91;102;4;98
030604324;800;830;830;3;236;684;1;115;5;2;108;121;4;117
030604325;700;692;692;3;168;614;5;81;4;1;76;87;4;83
030604326;800;805;809;7;289;679;1;120;4;2;114;169;10;159
030604327;600;599;599;6;210;486;1;113;1;3;109;97;5;92
030604328;400;374;375;11;140;326;3;71;2;2;67;69;4;65
030604329;400;407;407;2;173;304;1;95;4;2;89;78;0;78
030604330;400;401;402;4;123;337;1;62;3;0;59;61;0;61
030604331;500;450;450;6;120;379;1;120;4;7;109;0;0;0
030604332;500;554;554;6;179;415;1;84;2;2;80;95;3;92
030604333;800;701;701;5;207;678;1;121;3;6;112;86;6;80
030604334;600;537;537;7;144;516;1;83;6;1;76;61;1;60
030604335;500;449;449;4;129;434;1;65;0;2;63;64;4;60
030604336;700;637;637;5;203;590;4;106;3;2;101;97;8;89
030604337;500;487;487;3;166;411;1;88;1;4;83;78;1;77
030604338;700;698;703;6;195;592;1;107;2;3;102;88;3;85
030604339;500;436;437;4;153;417;3;80;3;5;72;73;1;72
030604340;600;566;566;6;183;502;4;94;3;2;89;89;3;86
030604341;800;808;825;5;265;674;1;125;5;0;120;140;12;128
030604342;500;482;484;6;129;434;1;65;7;0;58;64;4;60
030604343;600;590;590;7;155;508;4;88;7;4;77;67;2;65
030604344;400;434;436;6;98;338;1;61;2;0;59;37;1;36
030604345;800;720;720;7;163;709;1;90;2;1;87;73;1;72
030604346;500;528;528;9;135;415;1;84;6;5;73;51;1;50
030604347;800;744;745;6;202;700;1;99;4;1;94;103;4;99
030604348;400;437;438;6;115;330;1;69;2;0;67;46;2;44
030604349;500;473;474;5;137;432;1;67;3;1;63;70;3;67
030604350;700;648;648;9;196;604;1;95;4;1;90;101;6;95
030604351;500;503;506;6;153;406;1;93;2;2;89;60;2;58
030605352;1000;1036;1036;7;414;789;1;210;6;12;192;204;15;189
030605353;800;828;829;4;214;687;1;112;7;1;104;102;3;99
030605354;1000;937;937;6;351;791;1;208;8;1;199;143;10;133
030605355;800;843;845;7;289;641;2;157;5;4;148;132;5;127
030605356;800;857;857;7;308;593;2;205;8;5;192;103;2;101
030605357;800;861;864;8;306;559;2;239;5;4;230;67;0;67
030605358;700;672;672;6;190;599;1;100;7;3;90;90;3;87
030605359;600;635;636;7;118;535;1;64;3;0;61;54;2;52
030605360;700;727;727;8;188;582;1;117;7;0;110;71;0;71
030605361;1000;1037;1037;6;123;886;1;113;18;0;95;10;2;8
030605362;800;878;878;5;137;695;1;104;9;1;94;33;1;32
030605363;800;868;869;7;299;625;1;174;6;5;163;125;3;122
030605364;800;826;828;6;287;579;1;220;8;4;208;67;1;66
030605365;900;910;920;8;292;747;1;152;4;3;145;140;2;138
030605366;800;828;828;6;307;624;2;174;8;4;162;133;5;128
030605367;800;858;860;4;264;660;1;139;6;2;131;125;2;123
030605368;800;814;816;5;280;667;1;132;3;5;124;148;3;145
030605369;700;766;767;6;276;509;3;188;6;3;179;88;3;85
030605370;700;728;728;9;283;552;3;145;2;3;140;138;6;132
030605371;800;764;764;7;213;682;1;117;5;1;111;96;5;91
030605372;800;804;805;7;79;730;1;69;11;1;57;10;0;10
030605373;800;800;800;0;204;665;2;133;12;1;120;71;1;70
030605374;900;916;916;916;315;741;4;155;6;8;141;160;10;150
030605375;1100;1101;1101;6;357;883;1;216;6;1;209;141;2;139
030605376;1000;1007;1009;5;378;810;1;189;1;3;185;189;5;184
030605377;1200;1306;1307;5;469;961;5;234;5;4;225;235;5;230
030605411;100;19;19;33;44;55;1;44;1;0;43;0;0;0
030800001;600;642;642;5;244;387;2;211;12;10;189;33;2;31
030800002;100;104;104;5;75;24;1;75;2;2;71;0;0;0
030800003;300;242;242;1;122;176;2;122;7;11;104;0;0;0
030800004;300;371;371;4;131;198;2;100;8;2;90;31;1;30
030800005;600;689;690;2;213;414;2;184;8;3;173;29;2;27
030800006;600;642;642;3;176;459;1;140;6;3;131;36;1;35
030800007;200;171;171;3;66;133;1;66;4;2;60;0;0;0
030800008;300;296;296;3;112;187;1;112;10;1;101;0;0;0
030800009;400;378;380;3;92;317;3;80;6;3;71;12;0;12
030800010;200;130;130;3;75;124;1;75;4;0;71;0;0;0
030800011;100;33;33;4;20;78;2;20;0;0;20;0;0;0
030800012;400;381;381;4;136;301;3;96;3;5;88;40;1;39
030800013;400;407;407;3;154;283;1;116;6;2;108;38;6;32
030900001;500;518;522;7;206;374;1;125;4;0;121;81;5;76
030900002;600;574;574;4;192;487;1;112;7;3;102;80;3;77
030900003;500;584;589;1;223;342;1;157;14;5;138;66;3;63
030900004;800;843;845;1;277;575;1;224;21;6;197;53;4;49
030900005;200;182;182;3;97;102;1;97;11;0;86;0;0;0
030900006;150;129;129;5;84;65;1;84;0;2;82;0;0;0
030900007;300;302;302;5;119;180;1;119;5;2;112;0;0;0
030900008;300;327;328;5;106;215;1;84;8;3;73;22;0;22
030900009;100;70;71;5;31;67;2;31;3;1;27;0;0;0
030900010;200;189;190;3;104;95;1;104;4;2;98;0;0;0
030900011;260;260;260;2;148;111;1;148;15;2;131;0;0;0
030900012;500;590;591;6;281;230;1;269;57;3;209;12;0;12
030900013;300;303;303;5;147;152;1;147;24;3;120;0;0;0
030900014;100;68;69;4;48;51;1;48;3;0;45;0;0;0
030900015;200;220;220;4;85;114;1;85;5;3;77;0;0;0
030900016;200;192;192;4;81;117;2;81;2;0;79;0;0;0
030900017;400;392;393;1;136;280;1;119;10;3;106;17;2;15
030900018;100;83;83;5;34;65;1;34;0;0;34;0;0;0
030900019;50;17;30;7;24;25;1;24;2;0;22;0;0;0
030900020;600;603;603;2;226;406;3;191;23;1;167;35;1;34
030900021;200;189;189;6;126;73;1;126;32;0;94;0;0;0
030900022;100;145;145;1;84;15;1;84;1;0;83;0;0;0
030900023;300;341;342;5;114;185;1;114;11;0;103;0;0;0
030900024;300;308;308;5;141;158;1;141;5;3;133;0;0;0
030900025;270;267;267;1;125;144;1;125;14;0;111;0;0;0
030900026;30;13;13;0;13;17;0;13;1;0;12;0;0;0
031300001;600;644;645;5;247;425;1;174;9;3;162;73;3;70
031300002;600;647;648;1;290;415;1;184;4;5;175;106;7;99
031300003;800;835;837;1;308;558;1;241;18;0;223;67;3;64
031300004;900;911;913;2;289;658;1;241;29;0;212;48;5;43
031300005;900;978;983;6;294;610;2;288;21;1;266;6;0;6
031300006;1000;1049;1054;1;255;771;1;228;26;0;202;27;1;26
031300007;800;827;834;2;248;619;1;180;10;5;165;68;2;66
031300008;500;562;565;8;212;319;1;180;13;2;165;32;2;30
031300009;700;697;700;3;218;483;1;216;20;0;196;2;1;1
031300010;600;686;593;5;142;475;1;124;15;0;109;18;0;18
031300011;400;539;539;3;145;288;1;111;7;0;104;34;0;34
031300012;500;566;567;3;108;408;1;91;10;1;80;17;0;17
031300013;600;580;586;3;193;449;3;148;17;2;129;45;0;45
031300014;700;687;691;1;283;448;4;248;7;2;239;35;1;34
031300015;700;720;723;0;288;412;1;287;26;0;261;1;0;1
031300016;200;169;171;3;75;124;1;75;6;0;69;0;0;0
031300017;100;60;60;7;47;52;1;47;4;0;43;0;0;0
031300018;200;192;192;1;86;113;1;86;2;0;84;0;0;0
031300019;100;44;44;5;31;68;1;31;1;1;29;0;0;0
031300020;400;445;445;3;143;282;2;116;6;0;110;27;0;27
031300021;200;148;148;3;92;107;1;92;6;0;86;0;0;0
031300022;500;574;575;3;173;326;1;173;11;0;162;0;0;0
031300023;600;623;625;0;164;468;1;131;5;3;123;33;3;30
031300024;800;830;830;3;190;640;1;159;34;1;124;31;0;31
031300025;700;754;754;2;238;504;1;195;21;4;170;43;4;39
031300026;200;150;151;2;73;126;1;73;2;1;70;0;0;0
031300027;500;594;594;1;219;341;1;158;16;2;140;61;1;60
031300028;300;295;295;3;150;149;1;150;8;3;139;0;0;0
031300029;100;44;44;5;35;64;1;35;3;0;32;0;0;0
031300030;100;25;25;0;25;74;1;25;3;0;22;0;0;0
031300031;100;21;21;0;20;80;0;20;0;0;20;0;0;0
031400001;700;786;788;7;285;437;1;262;53;3;206;23;0;23
031400002;1000;1051;1058;2;266;758;1;241;25;2;214;25;0;25
031400003;900;958;961;2;282;658;1;241;16;5;220;41;1;40
031400004;600;541;541;0;131;499;1;100;7;4;89;31;3;28
031400005;800;812;812;2;250;587;1;212;20;2;190;38;0;38
031400006;700;709;711;1;212;561;1;138;5;4;129;74;3;71
031400007;700;716;716;6;286;503;1;196;12;9;175;90;2;88
031400008;700;761;762;5;312;454;1;245;18;0;227;67;4;63
031400009;700;666;666;8;295;498;1;201;7;0;194;94;5;89
031400010;500;371;371;0;165;353;1;146;9;3;134;19;0;19
031400011;200;242;240;2;195;4;1;195;5;3;187;0;0;0
031600001;500;495;495;6;164;348;1;151;6;0;145;13;0;13
031600002;400;417;417;7;169;251;1;148;4;1;143;21;2;19
031600003;600;606;609;9;230;369;1;230;19;0;211;0;0;0
031600004;700;747;751;7;275;469;1;230;13;1;216;45;5;40
031600005;500;558;563;3;244;255;1;244;6;4;234;0;0;0
031600006;600;547;547;4;235;369;1;230;12;1;217;5;0;5
031600007;500;504;509;4;194;313;1;186;1;2;183;8;0;8
031600008;400;421;423;2;181;244;2;154;4;0;150;27;2;25
031600009;200;173;176;5;89;110;1;89;5;1;83;0;0;0
031600010;200;161;161;2;67;132;1;67;0;1;66;0;0;0
031600011;300;303;304;6;110;189;1;110;13;1;96;0;0;0
031600012;200;175;176;6;89;110;1;89;8;0;81;0;0;0
031600013;100;47;47;8;36;63;1;36;2;0;34;0;0;0
031600014;100;87;88;5;48;51;1;48;1;2;45;0;0;0
031600015;500;448;452;4;177;334;1;165;3;4;158;12;1;11
031600016;700;653;653;3;262;455;1;244;11;6;227;18;0;18
031600017;100;52;52;8;41;58;1;41;1;0;40;0;0;0
031600018;500;390;468;4;141;358;3;139;4;1;134;2;0;2
031600019;500;515;516;5;127;372;1;127;3;1;123;0;0;0
031600020;800;751;754;6;212;605;1;194;12;2;180;18;0;18
031600021;800;818;820;5;224;585;1;214;10;3;201;10;0;10
031600022;800;702;736;7;315;517;1;282;15;3;264;33;1;32
031600023;600;590;584;2;222;386;1;213;13;1;199;9;0;9
031600024;300;310;312;2;116;204;1;95;8;1;86;21;0;21
031600025;500;561;562;3;153;358;1;141;3;1;137;12;0;12
031600026;600;648;651;2;209;414;1;185;11;2;172;24;0;24
031600027;400;423;423;3;118;284;1;115;15;0;100;3;0;3
031600028;50;22;22;0;22;27;1;22;2;0;20;0;0;0
031600029;50;24;24;2;26;23;1;26;1;0;25;0;0;0
032400001;600;633;633;6;141;507;1;92;2;8;82;49;1;48
032400002;500;494;494;7;116;427;1;72;3;1;68;44;1;43
032400003;550;565;567;5;175;446;2;102;6;0;96;73;0;73
032400004;650;617;668;4;151;556;1;93;3;3;87;58;3;55
032400005;500;529;529;6;136;430;1;69;0;1;68;67;0;67
032400006;800;805;806;5;248;642;1;157;3;3;151;91;4;87
032400007;700;713;716;6;211;574;1;125;5;3;117;86;2;84
032400008;500;508;517;6;142;407;1;92;1;2;89;50;5;45
032400009;550;525;525;6;144;456;1;93;6;3;84;51;1;50
032400010;730;734;734;7;202;615;1;114;9;2;103;88;0;88
032400011;700;712;713;7;214;546;1;153;5;1;147;61;0;61
032400012;1000;1014;1016;0;143;872;1;127;15;0;112;16;0;16
032400013;700;701;709;6;187;587;2;111;4;3;104;76;4;72
032400014;700;705;706;6;243;535;3;162;4;3;155;81;4;77
032400015;600;607;612;7;156;495;1;104;2;1;101;52;3;49
032400016;600;601;601;0;188;475;1;124;5;3;116;64;2;62
032400017;900;891;894;8;108;808;1;91;4;2;85;17;3;14
032400018;350;343;343;5;119;252;1;97;12;6;79;22;0;22
032400019;650;685;685;7;174;491;1;158;29;1;128;16;0;16
032400020;130;125;125;8;43;86;1;43;1;0;42;0;0;0
032400021;190;174;175;6;81;108;1;81;2;4;75;0;0;0
032400022;60;44;44;6;29;30;1;29;0;0;29;0;0;0
032400023;130;118;118;6;54;75;1;54;0;2;52;0;0;0
032400024;90;83;83;5;47;43;0;47;1;0;46;0;0;0
032400025;100;93;93;6;62;37;1;62;2;0;60;0;0;0
032400026;240;232;232;5;110;128;2;110;8;2;100;0;0;0
032400027;50;35;35;0;20;29;1;20;0;0;20;0;0;0
032400028;700;718;720;5;278;433;2;265;28;0;237;13;0;13
032400029;400;365;372;4;135;270;1;129;5;1;123;6;0;6
032400030;500;520;521;2;174;325;1;174;20;1;153;0;0;0
032400031;230;209;210;5;86;144;0;86;1;0;85;0;0;0
032400032;650;687;692;4;210;450;1;199;24;1;174;11;0;11
032400033;400;386;390;3;111;303;1;96;10;2;84;15;1;14
032400034;40;20;21;4;19;20;1;19;0;0;19;0;0;0
032400035;350;322;325;4;118;226;6;118;4;2;112;0;0;0
032400036;300;285;285;4;58;241;1;58;4;2;52;0;0;0
032400037;690;680;680;5;194;494;2;194;27;1;166;0;0;0
032400038;400;370;370;5;135;295;2;103;8;0;95;32;1;31
032400039;150;141;141;5;76;73;1;76;3;1;72;0;0;0
032400040;220;220;220;3;67;152;1;67;4;2;61;0;0;0
032400041;230;224;227;5;73;156;1;73;4;7;62;0;0;0
032400042;250;237;240;3;131;118;1;131;7;2;122;0;0;0
032400043;60;34;34;6;21;38;1;21;0;0;21;0;0;0
032400044;60;26;26;0;25;34;1;25;0;0;25;0;0;0
032400045;60;30;30;3;31;28;1;31;2;0;29;0;0;0
032400046;40;14;14;5;12;27;1;12;3;0;9;0;0;0
032600001;700;849;849;3;357;424;2;274;7;7;260;83;4;79
032600002;700;724;724;2;239;523;1;176;11;5;160;63;3;60
032600003;700;888;889;0;291;442;2;256;19;6;231;35;0;35
032600004;800;899;901;1;338;485;1;314;24;6;284;24;0;24
032600005;700;717;719;1;263;479;1;220;14;3;203;43;5;38
032600006;500;594;599;4;180;335;1;164;8;3;153;16;0;16
032600007;500;513;513;4;242;295;1;204;8;2;194;38;1;37
032600008;300;227;227;3;80;219;1;80;3;2;75;0;0;0
032600009;200;139;140;3;102;97;1;102;5;8;89;0;0;0
032600010;200;126;125;6;82;117;1;82;2;0;80;0;0;0
032600011;400;310;310;6;207;192;1;207;7;5;195;0;0;0
032600012;300;183;183;6;133;166;1;133;5;4;124;0;0;0
032600013;400;365;365;3;195;204;1;195;2;8;185;0;0;0
032600014;100;13;13;2;15;84;1;15;0;1;14;0;0;0
040400001;500;603;603;10;182;407;1;92;4;3;85;90;8;82
040400002;800;916;920;9;285;540;18;242;16;3;223;43;4;39
040400003;700;797;795;12;315;416;1;283;24;6;253;32;0;32
040400004;500;545;546;7;226;348;2;150;13;2;135;76;2;74
040400005;200;68;68;34;41;158;1;41;0;2;39;0;0;0
040400006;300;374;376;8;131;238;3;59;0;0;59;72;1;71
040400007;400;475;475;9;162;325;1;74;2;1;71;88;4;84
040400008;500;500;501;14;180;419;2;79;0;2;77;101;5;96
040400009;500;562;558;5;154;432;1;67;2;1;64;87;1;86
040400010;700;745;747;8;203;604;2;94;1;2;91;109;5;104
040400012;700;740;752;7;223;595;2;103;4;0;99;120;9;111
040400013;600;600;639;9;250;476;1;123;1;2;120;127;5;122
040400014;400;459;459;10;186;327;1;72;2;2;68;114;2;112
040400015;400;453;455;19;198;309;2;89;1;2;86;109;3;106
040400016;400;446;448;14;156;327;1;72;3;1;68;84;7;77
040400017;300;398;399;6;142;221;2;77;0;4;73;65;3;62
040400018;300;406;406;4;160;211;2;87;4;1;82;73;2;71
040400019;500;513;513;8;184;429;1;70;1;2;67;114;6;108
040400020;600;631;632;6;254;490;1;109;0;0;109;145;4;141
040400021;500;613;613;6;243;402;2;96;0;6;90;147;6;141
040400022;500;501;503;6;201;414;1;85;0;3;82;116;3;113
040400023;400;409;409;5;142;332;1;67;1;2;64;75;1;74
040400024;600;657;658;7;221;485;2;113;4;3;106;108;2;106
040400025;800;899;901;5;329;671;1;128;2;1;125;201;7;194
040400026;300;392;392;7;131;233;1;66;2;0;64;65;1;64
040400027;400;456;456;7;166;321;1;78;1;2;75;88;4;84
040400028;400;405;405;9;150;332;1;67;1;2;64;83;2;81
040400029;400;420;421;5;169;347;1;52;1;0;51;117;4;113
040400030;600;650;652;9;226;499;1;100;0;6;94;126;3;123
040400031;500;558;558;5;174;428;1;71;0;3;68;103;5;98
040400032;600;688;690;5;245;480;1;119;5;3;111;126;4;122
040400033;600;700;701;8;248;482;4;114;3;2;109;134;2;132
040400034;700;726;728;6;248;596;1;103;2;2;99;145;7;138
040400035;700;841;841;8;307;540;2;158;1;7;150;149;8;141
040400036;600;696;698;6;216;520;1;79;1;3;75;137;4;133
040400037;500;577;578;7;178;427;1;72;2;1;69;106;3;103
040400038;500;597;597;8;181;405;1;94;2;5;87;87;3;84
040400039;500;606;606;10;235;398;1;101;1;3;97;134;4;130
040400040;600;704;706;7;259;460;3;137;3;6;128;122;3;119
040400041;600;652;653;9;216;500;1;99;0;1;98;117;3;114
040400042;600;691;694;8;262;475;1;124;3;7;114;138;10;128
040400043;600;663;664;5;222;484;1;115;4;7;104;107;10;97
040400044;700;758;759;8;277;571;2;127;1;1;125;150;5;145
040400045;400;445;445;6;146;329;1;70;1;0;69;76;3;73
040400046;400;494;494;7;157;319;1;80;2;6;72;77;4;73
040400047;500;568;569;7;179;421;1;78;0;0;78;101;4;97
040400048;600;645;648;9;193;507;1;92;2;0;90;101;3;98
040400049;700;725;725;8;228;587;1;112;0;3;109;116;6;110
040400050;600;612;612;10;254;497;1;102;1;1;100;152;6;146
040400051;700;790;788;9;273;551;1;148;3;3;142;125;1;124
040400052;700;830;831;9;277;569;1;130;3;4;123;147;7;140
040400053;500;572;577;8;219;404;1;95;1;0;94;124;10;114
040400054;700;746;747;9;216;586;1;113;4;1;108;103;6;97
040400055;500;565;566;9;220;397;1;102;0;0;102;118;6;112
040400056;500;608;608;8;200;401;1;98;1;3;94;102;3;99
040400057;500;575;575;15;188;406;1;93;1;3;89;95;7;88
040400058;700;827;827;7;323;526;1;173;8;6;159;150;7;143
040400059;800;949;952;11;317;634;1;165;2;6;157;152;3;149
040400060;700;747;747;11;244;560;1;139;4;4;131;105;4;101
040400061;700;813;812;9;260;569;2;129;5;1;123;131;3;128
040400062;800;981;981;7;310;565;2;233;4;6;223;77;2;75
040400063;800;835;836;9;238;691;1;108;0;3;105;130;10;120
040400064;800;888;889;6;277;638;1;161;8;5;148;116;2;114
040400065;600;627;627;7;187;454;2;144;6;3;135;43;2;41
040400066;500;533;533;7;163;405;1;94;3;2;89;69;2;67
040400067;700;862;862;5;209;582;2;116;2;2;112;93;2;91
040400068;400;462;462;5;133;338;1;61;2;0;59;72;2;70
040400069;400;461;461;4;127;329;1;70;1;3;66;57;5;52
040400070;600;680;682;4;191;486;1;113;4;5;104;78;3;75
040400071;700;862;862;7;283;553;1;146;3;1;142;137;7;130
040400072;600;690;690;5;259;465;1;134;1;3;130;125;2;123
040400073;700;738;738;9;209;607;1;92;2;2;88;117;2;115
040400074;600;668;668;3;192;512;2;86;3;4;79;106;4;102
040400075;400;479;480;4;148;324;1;75;2;1;72;73;4;69
040400076;600;718;719;7;206;488;2;110;4;2;104;96;2;94
040400077;500;566;567;4;193;440;1;59;1;0;58;134;4;130
040400078;600;693;691;9;187;495;1;104;1;3;100;83;3;80
040400079;500;601;605;9;149;410;1;89;4;3;82;60;0;60
040400080;300;402;402;2;77;263;1;36;1;4;31;41;2;39
040400081;700;731;733;3;188;582;1;117;7;5;105;71;4;67
040400082;100;43;44;4;34;64;2;34;4;0;30;0;0;0
040400083;600;618;618;5;179;520;3;77;1;4;72;102;0;102
040400084;700;821;821;7;307;508;1;191;7;9;175;116;2;114
040400085;800;918;911;11;325;682;1;117;4;5;108;208;15;193
040400086;300;387;387;8;140;244;1;55;1;0;54;85;6;79
040400087;300;360;367;7;139;247;1;52;1;1;50;87;5;82
040400088;400;495;495;7;172;332;1;67;1;2;64;105;1;104
040400089;600;639;639;7;234;443;1;156;2;8;146;78;1;77
040400090;500;549;551;7;150;432;1;67;1;1;65;83;3;80
040400091;400;468;466;7;138;325;5;70;4;1;65;68;3;65
040400092;400;494;496;6;113;340;1;59;0;1;58;54;2;52
040400095;600;654;654;9;169;508;1;91;2;1;88;78;2;76
040400096;600;587;587;3;197;402;1;197;22;0;175;0;0;0
040400097;200;92;137;5;97;101;2;97;8;2;87;0;0;0
040400098;300;239;239;4;78;221;1;78;3;2;73;0;0;0
040400099;300;261;262;2;122;177;1;122;10;5;107;0;0;0
040400100;300;239;238;6;107;192;1;107;2;6;99;0;0;0
040400101;300;260;260;2;78;221;1;78;4;0;74;0;0;0
040400102;500;480;480;5;181;369;1;130;4;3;123;51;0;51
040400103;300;306;306;0;98;201;1;98;6;4;88;0;0;0
040400104;500;458;462;3;118;402;1;97;3;1;93;21;1;20
040400105;300;267;268;9;158;141;1;158;1;7;150;0;0;0
040400106;400;444;443;1;107;323;1;76;1;2;73;31;1;30
040400107;400;387;388;4;145;311;1;88;4;4;80;57;4;53
040400108;400;395;391;4;122;311;1;88;0;1;87;34;1;33
040400109;300;235;235;4;108;191;1;108;0;3;105;0;0;0
040400110;200;182;182;3;104;95;1;104;5;0;99;0;0;0
040400111;700;706;699;8;240;555;1;144;4;2;138;96;7;89
040400112;400;410;410;2;159;289;2;109;1;0;108;50;3;47
040400113;100;37;37;7;29;70;1;29;0;3;26;0;0;0
040400114;100;87;87;7;60;39;1;60;1;2;57;0;0;0
040400115;100;57;58;5;43;56;1;43;1;3;39;0;0;0
040400116;400;341;361;2;121;277;2;121;2;4;115;0;0;0
040400117;300;329;330;4;145;177;1;122;1;7;114;23;2;21
040400118;100;77;77;8;47;52;1;47;0;0;47;0;0;0
040400119;100;30;40;7;37;62;1;37;0;3;34;0;0;0
040400120;600;658;660;7;237;454;1;145;5;2;138;92;9;83
040400121;600;607;607;4;162;499;1;100;3;3;94;62;8;54
040400122;600;652;654;2;212;469;2;129;3;2;124;83;2;81
040400123;500;570;572;5;171;415;1;84;1;0;83;87;4;83
040400124;600;594;594;7;180;496;1;103;3;2;98;77;5;72
040400125;300;254;254;4;124;175;1;124;5;2;117;0;0;0
040400126;400;405;405;4;177;282;1;117;5;1;111;60;0;60
040400127;200;155;155;6;77;122;1;77;0;1;76;0;0;0
040400128;500;583;585;4;212;370;1;129;2;4;123;83;5;78
040400129;300;250;250;5;77;222;1;77;4;6;67;0;0;0
040400130;700;705;705;4;223;543;1;156;5;1;150;67;3;64
040400131;600;579;580;3;179;463;1;136;6;3;127;43;2;41
040400132;600;658;659;2;219;404;1;195;14;3;178;24;3;21
040400133;100;104;104;8;83;16;1;83;3;2;78;0;0;0
040400134;200;153;154;3;105;94;1;105;1;3;101;0;0;0
040400135;100;62;62;7;50;49;1;50;0;0;50;0;0;0
040400137;100;49;49;7;51;48;1;51;1;8;42;0;0;0
040400138;100;61;61;5;54;45;1;54;0;1;53;0;0;0
040400139;100;45;45;7;41;58;1;41;0;0;41;0;0;0
040400140;100;46;46;5;39;59;2;39;2;0;37;0;0;0
040400141;200;159;159;7;97;102;1;97;3;3;91;0;0;0
040400142;100;17;27;4;21;78;1;21;0;0;21;0;0;0
040400144;200;30;30;53;60;138;2;60;1;5;54;0;0;0
040400149;100;14;14;18;29;70;1;29;0;2;27;0;0;0
040400152;100;17;17;4;21;78;1;21;0;0;21;0;0;0
040400153;100;30;30;6;34;66;0;34;0;0;34;0;0;0
040600002;700;749;751;5;278;522;2;176;2;6;168;102;8;94
040600004;400;461;463;7;133;352;1;47;0;2;45;86;2;84
040600005;500;632;632;11;235;389;1;110;1;2;107;125;3;122
040600006;500;595;595;6;158;419;1;80;1;3;76;78;3;75
040600007;500;523;524;4;197;391;2;107;0;0;107;90;1;89
040600008;500;609;611;7;218;399;1;100;2;2;96;118;7;111
040600009;500;617;617;6;190;413;1;86;0;1;85;104;2;102
040600010;500;670;670;0;219;386;1;113;4;4;105;106;2;104
040600011;500;682;683;4;211;395;1;104;1;3;100;107;5;102
040600012;500;589;597;5;194;393;1;106;0;5;101;88;3;85
040600013;700;732;733;5;213;571;1;128;5;6;117;85;2;83
040600014;500;573;573;5;162;412;1;87;1;3;83;75;3;72
040600015;700;710;718;8;163;604;1;95;2;2;91;68;5;63
040600016;500;640;640;3;182;416;1;83;4;3;76;99;1;98
040600018;600;602;603;6;175;520;1;79;2;4;73;96;6;90
040600019;500;538;539;8;195;371;1;128;3;1;124;67;1;66
040600020;500;560;561;5;181;376;1;123;7;6;110;58;1;57
040600021;500;562;563;8;152;425;1;74;5;2;67;78;8;70
040600022;500;608;609;4;189;395;2;103;2;1;100;86;1;85
040600024;300;342;343;4;105;242;1;57;4;1;52;48;1;47
040600025;500;564;565;6;170;424;1;75;2;0;73;95;1;94
040600026;700;783;785;7;261;558;1;141;2;2;137;120;4;116
040600028;700;743;745;7;212;514;1;185;5;10;170;27;2;25
040600029;500;625;625;7;206;393;1;106;4;2;100;100;2;98
040600030;500;511;512;7;138;433;1;66;2;1;63;72;4;68
040600031;700;754;754;7;231;601;1;98;1;3;94;133;8;125
040600032;700;723;724;4;222;587;1;112;2;4;106;110;4;106
040600033;500;624;624;4;215;379;1;120;3;3;114;95;3;92
040600035;500;575;578;8;179;410;1;89;4;2;83;90;2;88
040600036;500;671;671;4;179;404;1;95;2;4;89;84;3;81
040600037;500;598;598;10;209;366;1;133;5;3;125;76;2;74
040600038;700;714;716;8;194;578;2;120;0;5;115;74;2;72
040600039;500;666;666;3;185;394;1;105;3;1;101;80;3;77
040600041;500;608;609;7;126;441;1;58;1;1;56;68;2;66
040600042;700;773;774;5;191;596;1;103;2;1;100;88;6;82
040600043;500;641;642;4;189;419;1;80;3;0;77;109;2;107
040600045;500;640;640;4;179;410;1;89;0;3;86;90;3;87
040600046;700;732;734;7;204;597;1;102;4;2;96;102;9;93
040600047;100;14;14;16;21;78;1;21;1;0;20;0;0;0
040600050;700;794;794;6;140;627;1;72;2;0;70;68;2;66
040600051;600;701;702;5;173;500;1;99;5;1;93;71;3;68
040600052;500;575;576;5;123;432;1;67;3;2;62;56;2;54
040600053;600;699;700;8;191;456;1;143;19;7;117;48;2;46
040600054;600;660;662;10;161;473;1;126;12;3;111;35;1;34
040600058;400;436;436;1;147;311;1;88;3;4;81;59;1;58
040600059;500;631;632;9;211;365;1;134;5;3;126;77;7;70
040600060;500;635;636;2;216;361;1;138;5;4;129;78;3;75
040600061;800;827;828;5;287;576;1;223;7;15;201;64;5;59
040600063;700;786;786;2;241;505;1;194;7;7;180;47;1;46
040600065;700;750;750;3;261;526;2;172;7;0;165;89;3;86
040600066;500;660;660;3;146;380;1;119;14;0;105;27;0;27
040600067;500;566;566;1;144;404;1;95;6;2;87;49;6;43
040600068;500;509;510;0;143;413;1;86;1;1;84;57;1;56
040600069;500;636;639;1;182;389;1;110;3;3;104;72;4;68
040600070;500;626;626;2;160;389;2;109;3;3;103;51;0;51
040600071;800;841;842;8;174;632;1;167;17;7;143;7;1;6
040600072;200;286;287;4;103;96;1;103;6;1;96;0;0;0
040600073;500;543;544;4;102;397;1;102;10;0;92;0;0;0
040600074;700;727;723;5;106;613;1;86;9;1;76;20;1;19
040600075;500;606;607;5;133;402;1;97;7;3;87;36;0;36
040600076;500;580;581;6;126;400;1;99;10;0;89;27;0;27
040600077;200;212;212;4;85;114;1;85;3;3;79;0;0;0
040600078;100;86;86;5;40;59;1;40;1;0;39;0;0;0
040600079;400;421;421;5;105;305;1;94;5;1;88;11;0;11
040600081;100;59;63;7;32;67;1;32;1;0;31;0;0;0
040600082;300;273;273;5;107;192;1;107;15;0;92;0;0;0
040600083;100;24;24;0;24;75;1;24;2;1;21;0;0;0
041300001;400;780;781;4;238;196;1;203;6;2;195;35;1;34
041300002;400;788;790;5;289;215;1;184;6;7;171;105;5;100
041300003;400;851;851;0;292;202;2;196;8;5;183;96;7;89
041300004;400;700;701;4;230;252;1;147;7;2;138;83;4;79
041300005;400;623;624;0;162;275;1;124;8;4;112;38;5;33
041300006;400;854;854;4;210;253;1;146;5;4;137;64;0;64
041300007;100;35;35;7;25;74;1;25;3;0;22;0;0;0
041300008;100;31;31;7;17;82;1;17;1;0;16;0;0;0
041300010;300;247;247;6;142;157;1;142;15;1;126;0;0;0
041300011;100;48;48;7;41;58;1;41;1;1;39;0;0;0
041300012;100;48;48;7;15;84;1;15;1;0;14;0;0;0
041300013;100;86;86;7;66;33;1;66;6;0;60;0;0;0
041300015;100;47;47;7;30;69;1;30;0;1;29;0;0;0
041300016;100;91;91;6;48;51;1;48;7;1;40;0;0;0
041300017;200;172;172;2;70;129;1;70;8;0;62;0;0;0
041300018;400;920;920;5;290;135;1;264;26;4;234;26;0;26
041300019;100;49;49;7;33;66;1;33;1;0;32;0;0;0
041300020;400;993;993;8;161;256;1;143;14;0;129;18;0;18
041300021;100;78;78;6;43;56;1;43;0;0;43;0;0;0
041300022;100;31;32;8;26;73;1;26;1;0;25;0;0;0
041300023;200;116;116;5;64;135;1;64;5;0;59;0;0;0
041300024;100;91;91;7;60;39;1;60;3;1;56;0;0;0
041300025;100;60;60;7;48;51;1;48;0;1;47;0;0;0
041300026;100;48;48;7;39;60;1;39;2;0;37;0;0;0
041300027;100;57;57;8;37;62;1;37;2;0;35;0;0;0
041300028;100;36;36;6;31;67;2;31;1;0;30;0;0;0
041300029;100;52;52;7;35;64;1;35;1;0;34;0;0;0
041400001;500;749;752;0;166;370;2;128;11;5;112;38;1;37
041400002;600;828;830;0;199;433;2;165;19;2;144;34;0;34
041400003;400;576;577;2;171;257;2;141;13;0;128;30;1;29
041400004;300;380;380;2;214;91;1;208;15;2;191;6;0;6
041400005;400;401;401;5;220;205;1;194;7;2;185;26;0;26
041400006;100;62;62;4;47;52;1;47;1;0;46;0;0;0
041400007;100;57;56;8;33;66;1;33;2;1;30;0;0;0
041400008;100;45;45;7;20;79;1;20;1;0;19;0;0;0
041400009;200;113;113;5;51;148;1;51;2;4;45;0;0;0
041400010;100;84;84;4;50;49;1;50;5;1;44;0;0;0
041400011;200;109;109;5;52;147;1;52;4;3;45;0;0;0
041400012;100;39;38;6;20;79;1;20;1;0;19;0;0;0
041400013;100;43;43;5;36;63;1;36;2;0;34;0;0;0
042000001;600;544;544;3;181;486;3;111;2;2;107;70;4;66
042000002;700;697;698;1;206;569;1;130;4;1;125;76;1;75
042000003;700;642;642;3;209;580;1;119;3;2;114;90;4;86
042000005;700;698;700;0;198;589;1;110;3;3;104;88;0;88
042000006;600;718;719;1;222;477;1;122;2;1;119;100;1;99
042000007;900;916;917;0;282;712;1;187;4;10;173;95;2;93
042000009;600;681;681;8;175;496;1;103;4;4;95;72;2;70
042000010;800;788;788;2;245;642;8;150;7;2;141;95;4;91
042000011;600;575;576;1;207;467;1;132;6;2;124;75;5;70
042000012;600;635;635;5;200;482;1;117;4;5;108;83;4;79
042000014;600;550;550;2;189;473;1;126;0;3;123;63;2;61
042000015;400;399;399;3;162;279;1;120;3;1;116;42;1;41
042000016;700;662;663;2;239;523;1;176;6;2;168;63;1;62
042000018;900;851;853;1;261;678;1;221;22;4;195;40;0;40
042000019;700;703;704;1;234;480;3;217;10;4;203;17;1;16
042000020;600;608;608;3;209;440;1;159;6;1;152;50;1;49
042200001;500;562;564;5;158;385;1;114;1;5;108;44;2;42
042200002;500;602;598;4;196;374;1;125;5;3;117;71;2;69
042200003;400;414;416;3;109;338;1;61;1;1;59;48;1;47
042200004;500;536;537;4;181;414;1;85;1;2;82;96;3;93
042200005;400;416;417;5;138;318;1;81;4;1;76;57;2;55
042200006;600;651;652;5;203;493;1;106;6;0;100;97;2;95
042200007;700;738;738;5;201;577;1;122;4;6;112;79;2;77
042200008;400;444;448;7;141;323;1;76;0;3;73;65;0;65
042200009;600;638;639;9;115;535;1;64;8;1;55;51;2;49
042200010;600;623;627;5;68;554;1;45;6;1;38;23;1;22
042200011;700;873;873;5;143;585;2;113;3;2;108;30;1;29
042200012;500;541;546;8;182;365;1;134;2;4;128;48;1;47
042200013;500;542;545;2;163;392;1;107;4;2;101;56;2;54
042200014;500;578;578;5;150;413;1;86;3;1;82;64;0;64
042200015;100;17;17;28;38;60;2;38;1;4;33;0;0;0
042200016;500;582;583;3;199;369;1;130;4;3;123;69;3;66
042200017;500;558;560;3;168;378;1;121;5;4;112;47;1;46
042200021;600;660;660;5;192;428;2;170;25;4;141;22;7;15
042200022;600;603;603;3;177;461;1;138;9;9;120;39;2;37
042200023;600;722;724;0;218;428;1;171;5;5;161;47;1;46
042200024;600;660;661;3;128;485;1;114;7;5;102;14;1;13
042200025;700;815;816;0;110;619;1;80;9;1;70;30;2;28
042200026;200;197;197;2;94;105;1;94;5;4;85;0;0;0
042200027;600;692;695;2;267;332;1;267;5;3;259;0;0;0
042200028;400;428;428;4;148;253;1;146;7;1;138;2;0;2
042200029;300;298;300;2;113;186;1;113;9;1;103;0;0;0
042200030;400;425;426;3;94;308;1;99;2;1;88;8;0;8
042200031;300;250;252;5;89;210;1;89;6;2;81;0;0;0
042200032;300;287;287;6;99;200;1;99;9;1;89;0;0;0
042200033;600;677;688;4;191;475;1;124;2;8;114;67;1;66
042200034;100;27;27;6;10;89;1;10;3;1;6;0;0;0
042200035;300;315;317;4;120;179;1;120;5;4;111;0;0;0
042200036;500;510;512;3;264;284;1;215;11;3;201;50;1;48
042200037;200;113;113;6;67;132;1;67;4;2;61;0;0;0
042200038;300;388;398;2;108;206;1;93;3;1;89;15;3;12
042200039;600;669;669;1;234;365;1;234;11;1;222;0;0;0
042200040;100;97;97;3;64;34;2;64;2;2;60;0;0;0
042200041;300;311;312;6;116;182;2;116;8;3;105;0;0;0
042200042;200;113;113;4;67;132;1;67;5;1;61;0;0;0
042200043;200;223;223;0;73;126;1;73;1;3;69;0;0;0
042200044;500;575;575;5;167;337;1;162;14;1;147;5;0;5
042200045;100;28;28;0;27;73;0;27;2;0;25;0;0;0
042600001;600;818;822;1;198;480;1;119;7;1;111;79;0;79
042600002;600;698;702;2;213;446;1;153;7;0;146;60;5;55
042600003;600;741;744;0;160;485;1;114;7;2;105;46;2;44
042600004;700;873;877;1;242;502;1;197;13;6;178;45;1;44
042600005;600;751;752;4;198;423;1;176;8;5;163;22;1;21
042600006;500;647;648;6;156;365;2;133;3;1;129;23;0;23
042600007;600;689;690;0;219;384;1;215;8;3;204;4;0;4
042600008;300;404;409;6;132;187;1;112;11;0;101;20;0;20
042600009;200;183;188;3;90;108;2;90;7;1;82;0;0;0
042600010;300;362;368;3;159;164;1;135;9;0;126;24;2;22
042600011;100;90;90;6;36;63;1;36;0;0;36;0;0;0
042600012;400;446;448;3;109;297;1;102;4;3;95;7;1;6
042600013;300;288;290;3;109;190;1;109;7;2;100;0;0;0
042600014;300;375;380;5;165;156;2;142;5;1;136;23;0;23
042600015;200;140;141;6;101;97;2;101;5;0;96;0;0;0
042600016;400;475;478;2;121;301;4;95;3;2;90;26;0;26
042600017;500;605;611;7;116;385;1;114;6;5;103;2;0;2
042600018;500;605;605;3;206;304;1;195;10;0;185;11;1;10
042600019;600;713;713;1;309;295;1;304;21;2;281;5;0;5
042600020;400;450;450;5;161;257;1;142;6;3;133;19;1;18
042600021;500;565;572;1;146;395;1;104;2;5;97;42;1;41
042600022;100;35;35;0;31;68;1;31;3;0;28;0;0;0
042600023;100;63;63;3;46;53;1;46;2;2;42;0;0;0
042800001;400;654;656;4;126;294;3;103;3;3;97;23;2;21
042800002;300;429;433;0;135;231;1;68;2;0;66;67;5;62
042800003;300;450;451;4;96;240;1;59;6;0;53;37;2;35
042800005;400;621;622;5;219;260;1;139;7;5;127;80;5;75
042800006;300;418;419;6;151;218;2;80;2;0;78;71;3;68
042800007;400;661;661;2;215;300;1;99;1;3;95;116;5;111
042800009;400;672;677;6;143;279;1;120;7;1;112;23;0;23
042800010;400;539;542;4;153;303;1;96;2;0;94;57;0;57
042800011;400;526;529;4;154;304;1;95;5;2;88;59;4;55
042800012;400;510;512;6;209;288;1;111;1;2;108;98;5;93
042800013;300;469;471;5;179;216;2;82;0;2;80;97;2;95
042800014;300;378;380;6;111;242;1;57;1;2;54;54;2;52
042800016;400;516;519;7;168;329;1;70;2;2;66;98;3;95
042800017;500;750;753;5;280;357;1;142;2;4;136;138;8;130
042800018;400;621;625;5;172;305;1;94;4;0;90;78;5;73
042800019;300;488;489;7;154;216;1;83;0;0;83;71;1;70
042800020;400;660;662;4;174;308;1;91;3;6;82;83;6;77
042800021;500;735;738;5;268;353;6;141;5;8;128;127;5;122
042800022;400;584;586;5;200;294;1;105;3;4;98;95;2;93
042800023;400;598;599;6;160;309;2;89;1;2;86;71;4;67
042800024;400;626;628;4;175;299;2;99;1;6;92;76;3;73
042800025;300;479;479;9;136;201;1;98;1;1;96;38;0;38
042800026;400;566;566;6;168;320;1;79;2;1;76;89;7;82
042800029;100;12;12;12;19;80;1;19;2;0;17;0;0;0
042800030;200;97;72;17;79;120;1;79;17;1;61;0;0;0
042800031;500;721;724;5;200;385;1;114;0;3;111;86;6;80
042800032;400;599;601;7;184;301;1;98;6;3;89;86;1;85
042800033;400;507;507;7;149;316;1;83;3;2;78;66;4;62
042800034;600;1056;1059;10;271;404;1;195;8;2;185;76;5;71
042800035;500;701;702;6;183;391;4;105;4;5;96;78;8;70
042800041;300;394;394;2;113;203;1;96;4;3;89;17;0;17
042800044;200;128;128;3;82;117;1;82;4;1;77;0;0;0
042800047;600;870;870;3;224;422;1;177;6;4;167;47;2;45
042800050;500;744;745;4;192;332;2;166;5;7;154;26;0;26
042800053;300;276;278;1;106;193;1;106;4;3;99;0;0;0
042800056;200;88;88;5;59;140;1;59;3;0;56;0;0;0
042800058;300;418;419;3;168;154;1;145;6;2;137;23;0;23
042800062;600;942;944;2;195;449;1;150;10;0;140;45;2;43
042800065;500;758;760;2;225;322;1;177;7;5;165;48;2;46
042800069;400;504;504;2;144;288;1;111;4;4;103;33;1;32
042800070;400;563;563;3;129;280;1;119;8;0;111;10;0;10
042800071;200;23;23;13;34;165;1;34;3;1;30;0;0;0
042800073;400;626;627;2;192;243;1;156;4;4;148;36;1;35
042800074;400;542;542;3;147;284;1;115;1;6;108;32;4;28
042800078;300;209;209;5;45;254;1;45;4;2;39;0;0;0
042800080;300;477;477;4;143;168;1;131;3;5;123;12;0;12
042800083;500;858;864;3;386;215;1;284;9;5;270;102;4;98
042800086;300;212;212;5;83;216;1;83;16;1;66;0;0;0
042800087;500;718;720;6;222;348;1;151;6;4;141;71;3;68
042800088;300;532;534;7;186;180;1;119;5;2;112;67;3;64
042800089;300;523;524;9;157;211;2;87;2;1;84;70;0;70
042800090;400;749;750;7;174;289;1;110;5;3;102;64;3;61
043100001;600;746;746;1;225;479;2;119;5;4;110;106;11;95
043100002;600;753;753;0;247;435;1;164;4;7;153;83;5;78
043100003;600;865;865;0;221;445;1;154;5;3;146;67;6;61
043100004;600;1011;1012;0;156;492;1;107;15;3;89;49;4;45
043100005;600;883;883;2;190;491;1;108;9;6;93;82;7;75
043100006;400;609;609;4;184;217;1;182;7;2;173;2;0;2
043100007;300;353;353;3;86;216;1;83;6;0;77;3;1;2
043100008;100;77;77;4;41;58;1;41;4;1;36;0;0;0
043100009;300;329;330;1;92;221;1;78;2;2;74;14;1;13
043100010;400;556;557;3;46;367;1;32;2;0;30;14;1;13
043100011;200;215;215;4;99;100;1;99;4;1;94;0;0;0
043100012;200;201;201;7;107;91;2;107;8;5;94;0;0;0
043100013;500;591;590;2;173;338;1;161;19;4;138;12;0;12
043100014;500;658;658;2;229;270;1;229;23;6;200;0;0;0
043100015;500;606;607;8;206;304;1;195;11;2;182;11;0;11
043100016;500;599;599;6;164;359;2;139;13;2;124;25;0;25
043100018;100;24;24;6;19;80;1;19;2;0;17;0;0;0
043100019;200;234;234;3;97;102;1;97;12;1;84;0;0;0
043100020;200;131;131;3;53;146;1;53;4;1;48;0;0;0
043100021;100;44;44;6;26;73;1;26;3;0;23;0;0;0
043100022;200;140;141;5;68;131;1;68;1;5;62;0;0;0
043100023;100;64;64;7;34;65;1;34;1;1;32;0;0;0
043100026;400;511;511;3;128;283;1;116;11;4;101;12;2;10
043100030;500;576;576;3;170;352;1;147;14;0;133;23;0;23
043200001;300;466;471;0;105;218;1;81;4;0;77;24;0;24
043200002;400;557;567;7;172;265;2;133;3;1;129;39;2;37
043200003;300;487;493;0;144;197;1;102;5;1;96;42;4;38
043200004;100;56;56;8;26;73;1;26;2;1;23;0;0;0
043200005;100;40;40;10;22;77;1;22;1;0;21;0;0;0
043200006;100;134;134;7;50;49;1;50;5;0;45;0;0;0
043200007;100;79;83;5;54;45;1;54;1;1;52;0;0;0
043200008;100;75;75;7;39;60;1;39;0;1;38;0;0;0
043200009;100;19;19;0;19;80;1;19;1;1;17;0;0;0
043200010;100;14;14;17;21;78;1;21;2;3;16;0;0;0
050100001;500;496;496;0;167;383;1;116;3;4;109;51;1;50
050100002;400;397;397;0;152;295;1;104;3;2;99;48;2;46
050100003;500;424;424;1;141;387;1;112;4;4;104;29;2;27
050100004;400;328;328;0;101;335;1;64;2;3;59;37;2;35
050100005;500;491;491;0;160;404;2;94;2;1;91;66;1;65
050100006;700;647;650;2;233;506;1;193;3;6;184;40;2;38
050100007;700;668;669;0;205;534;1;165;9;9;147;40;2;38
050100008;800;931;931;3;515;285;1;514;47;3;464;1;0;1
050100009;100;75;76;7;37;62;1;37;2;1;34;0;0;0
050100010;100;83;83;7;58;41;1;58;1;0;57;0;0;0
050100011;200;178;178;4;98;101;1;98;7;1;90;0;0;0
050100012;100;47;47;8;26;73;1;26;0;1;25;0;0;0
050100013;100;54;55;7;25;74;1;25;0;1;24;0;0;0
050100014;100;92;92;5;52;47;1;52;3;4;45;0;0;0
050100015;100;28;28;7;17;82;1;17;1;0;16;0;0;0
050100016;100;33;33;6;23;76;1;23;0;1;22;0;0;0
050100017;100;94;94;5;45;54;1;45;0;1;44;0;0;0
050100018;100;35;35;7;26;72;2;26;0;0;26;0;0;0
050300001;300;315;316;3;180;119;1;180;12;2;166;0;0;0
050300002;100;81;82;7;50;49;1;50;0;0;50;0;0;0
050300003;100;55;55;4;29;70;1;29;0;0;29;0;0;0
050300004;100;18;18;7;13;86;1;13;0;1;12;0;0;0
050300005;200;230;231;3;110;89;1;110;3;2;105;0;0;0
050600001;500;496;522;5;255;280;2;218;15;17;186;37;4;33
050600002;500;443;448;4;190;347;2;151;7;7;137;39;4;35
050600003;500;437;444;0;226;297;1;202;8;11;183;24;3;21
050600004;500;444;451;2;200;304;1;195;13;5;177;5;0;5
050600005;300;288;296;2;162;137;1;162;7;3;152;0;0;0
050600006;100;78;78;6;56;43;1;56;2;1;53;0;0;0
050600007;500;450;472;4;185;349;1;150;13;3;134;35;1;34
050600008;200;230;230;3;145;54;1;145;7;6;132;0;0;0
050600009;300;130;279;4;134;165;1;134;9;4;121;0;0;0
050600010;200;165;165;6;105;92;3;105;6;2;97;0;0;0
050600011;300;255;285;4;148;149;3;148;5;5;138;0;0;0
050600012;200;138;162;4;81;118;1;81;1;3;77;0;0;0
050600013;100;37;37;0;35;64;1;35;0;0;35;0;0;0
050600014;100;19;19;0;19;81;0;19;1;0;18;0;0;0
050600015;100;24;24;0;23;76;1;23;2;0;21;0;0;0
050600016;100;24;24;0;24;75;1;24;1;0;23;0;0;0
050900001;400;334;334;7;76;324;1;75;5;2;68;1;0;1
050900002;400;536;537;7;163;296;1;103;3;4;96;60;0;60
050900003;400;468;466;5;123;336;1;63;2;2;59;60;3;57
050900004;400;475;478;4;116;330;1;69;7;2;60;47;2;45
050900005;400;508;508;12;122;312;2;86;1;2;83;36;2;34
050900006;500;604;604;4;159;397;1;102;2;5;95;57;2;55
050900007;500;587;588;7;143;421;1;78;2;2;74;65;3;62
050900008;500;567;568;5;166;395;2;103;1;3;99;63;3;60
050900009;400;449;464;5;124;327;1;72;4;0;68;52;1;51
050900010;600;675;675;4;198;476;4;120;9;4;107;78;7;71
050900011;400;381;381;3;102;343;1;56;1;5;50;46;2;44
050900012;500;609;610;8;207;374;1;125;6;5;114;82;6;76
050900013;500;604;605;7;166;406;1;93;3;5;85;73;4;69
050900014;500;598;599;4;136;413;2;85;1;2;82;51;6;45
050900015;400;498;502;7;116;337;1;62;3;1;58;54;0;54
050900016;400;547;547;6;116;318;1;81;3;2;76;35;4;31
050900017;400;539;539;8;130;334;1;65;2;1;62;65;1;64
050900018;400;448;448;12;127;320;1;79;11;5;63;48;2;46
050900019;400;435;435;7;105;352;2;46;1;3;42;59;2;57
050900020;400;515;515;6;112;341;1;58;3;1;54;52;3;49
050900021;400;478;479;3;140;334;1;65;2;3;60;75;6;69
050900022;500;573;574;6;174;411;1;88;6;4;78;86;0;86
050900023;500;643;644;9;141;421;1;78;2;1;75;63;2;61
050900024;400;528;528;9;145;332;1;67;2;1;64;78;4;74
050900025;400;546;548;9;176;314;1;85;0;5;80;91;3;88
050900026;400;529;536;7;173;320;1;79;2;2;75;94;3;91
050900027;500;654;654;8;211;383;4;113;2;4;107;98;5;93
050900028;500;626;626;5;163;431;1;68;3;1;64;95;2;93
050900029;500;636;638;3;170;397;1;103;2;5;96;67;1;66
050900030;500;492;493;9;113;420;2;78;3;3;72;35;2;33
050900031;500;571;575;6;162;404;1;95;2;2;91;67;0;67
050900032;500;559;563;6;127;423;1;76;2;4;70;51;2;49
050900033;500;537;545;8;147;368;1;131;5;8;118;16;0;16
050900034;500;479;481;9;135;423;1;76;6;2;68;59;3;56
050900035;500;492;492;4;122;411;1;88;1;1;86;34;0;34
050900036;500;575;575;7;140;409;1;89;3;5;82;52;7;45
050900037;500;490;492;7;126;434;1;65;0;1;64;61;1;60
050900038;500;635;635;10;147;408;1;91;6;2;83;56;3;53
050900039;500;594;594;6;142;424;8;68;0;1;67;74;3;71
050900040;500;671;672;7;133;420;1;79;1;2;76;54;4;50
050900041;500;689;702;5;197;399;1;100;10;2;88;97;1;96
050900042;400;540;541;8;126;316;2;82;2;1;79;44;1;43
050900043;500;626;626;6;161;401;1;98;5;1;92;63;2;61
050900044;400;399;401;8;131;334;1;65;2;2;61;66;3;63
050900045;300;240;240;7;78;221;1;78;2;1;75;0;0;0
050900046;400;497;497;3;160;319;2;79;1;5;73;81;4;77
050900047;500;590;590;4;171;410;1;89;3;4;82;82;2;80
050900048;400;435;435;6;178;287;1;112;2;5;105;64;3;61
050900049;400;505;505;6;185;277;1;122;2;3;117;63;1;62
050900050;500;652;652;6;117;446;1;53;2;1;50;64;4;60
050900051;500;586;586;7;111;441;1;58;1;3;54;53;2;51
050900052;500;681;682;6;124;428;1;71;1;1;69;53;0;53
050900053;500;617;618;7;142;419;1;80;2;1;77;62;6;56
050900054;500;566;566;7;108;435;1;64;4;2;58;44;1;43
050900055;400;491;492;9;113;340;2;58;2;1;55;55;4;51
050900056;500;574;574;7;117;426;1;73;1;2;70;44;4;40
050900057;500;626;629;6;144;412;1;87;2;1;84;57;3;54
050900058;500;587;587;8;142;426;1;73;3;0;70;69;2;67
050900059;500;566;568;9;143;412;1;87;2;4;81;56;1;55
050900060;400;488;490;4;128;324;1;75;2;2;71;53;3;50
050900061;500;626;628;5;120;432;1;67;2;0;65;53;1;52
050900062;500;599;600;4;148;415;1;84;6;8;70;64;2;62
050900063;500;580;580;9;132;437;1;62;1;1;60;70;4;66
050900064;500;600;600;6;147;413;1;86;15;3;68;61;4;57
050900065;500;819;819;6;220;378;1;121;4;8;109;99;10;89
050900066;500;607;608;9;196;384;1;115;2;8;105;81;2;79
050900067;500;658;659;9;181;407;1;92;4;2;86;89;6;83
050900068;500;594;595;10;185;405;1;94;4;2;88;91;3;88
050900069;500;710;710;7;136;378;1;121;6;2;113;15;1;14
050900070;500;742;742;6;138;361;1;138;15;1;122;0;0;0
050900071;500;878;879;0;136;367;3;130;18;3;109;6;0;6
050900072;500;509;509;6;91;445;1;54;6;1;47;37;0;37
050900073;500;604;604;8;101;401;1;98;16;1;81;3;1;2
050900074;500;580;580;7;118;393;2;105;8;7;90;13;0;13
050900075;500;731;731;9;134;393;2;105;5;0;100;29;1;28
050900076;500;643;661;4;174;347;1;152;16;0;136;22;0;22
050900077;400;292;293;3;84;346;2;52;2;2;48;32;5;27
050900078;400;390;390;6;96;346;1;53;0;0;53;43;2;41
050900079;500;775;780;6;177;391;1;108;4;2;102;69;3;66
050900080;400;405;405;6;83;317;1;82;6;1;75;1;1;0
050900081;100;105;105;4;50;49;1;50;1;1;48;0;0;0
050900082;100;60;60;6;34;65;1;34;1;0;33;0;0;0
050900083;200;148;148;5;75;124;1;75;1;4;70;0;0;0
050900084;100;36;36;3;23;76;1;23;1;0;22;0;0;0
050900085;100;57;58;6;48;51;1;48;3;0;45;0;0;0
050900086;100;87;87;6;58;41;1;58;3;2;53;0;0;0
050900087;400;418;452;6;142;289;2;109;5;5;99;33;2;31
050900088;500;512;551;6;175;351;1;148;7;3;138;27;1;26
050900089;100;42;42;7;27;72;1;27;0;2;25;0;0;0
050900090;100;103;103;7;63;36;1;63;1;1;61;0;0;0
050900091;200;184;184;2;62;137;1;62;2;1;59;0;0;0
050900092;400;554;556;1;196;249;1;150;0;2;148;46;0;46
050900093;400;389;389;1;130;297;1;102;4;5;93;28;1;27
050900094;400;388;388;2;130;300;1;99;4;5;90;31;3;28
050900095;500;513;513;6;137;377;1;122;0;2;120;15;0;15
050900096;400;444;445;0;123;308;1;91;4;3;84;32;2;30
050900097;300;237;237;4;91;208;1;91;4;5;82;0;0;0
050900098;300;257;257;4;95;204;1;95;2;2;91;0;0;0
050900099;400;427;443;2;172;271;1;128;7;5;116;44;1;43
050900100;400;355;356;2;180;238;1;161;9;1;151;19;0;19
050900101;300;295;298;2;134;163;3;134;8;5;121;0;0;0
050900102;300;293;294;2;162;136;2;162;9;3;150;0;0;0
050900103;400;376;377;11;167;262;2;136;4;0;132;31;0;31
050900104;100;69;70;6;42;57;1;42;2;0;40;0;0;0
050900105;300;276;276;6;150;149;1;150;4;5;141;0;0;0
050900106;500;557;566;2;162;382;2;116;9;7;100;46;4;42
050900107;300;273;277;6;95;204;1;95;5;8;82;0;0;0
050900108;500;603;612;5;134;376;1;123;6;1;116;11;0;11
050900109;500;570;580;6;134;387;1;112;6;4;102;22;0;22
050900110;300;263;263;1;131;168;1;131;4;3;124;0;0;0
050900111;100;58;58;2;43;56;1;43;0;1;42;0;0;0
050900112;200;125;125;2;56;143;1;56;1;5;50;0;0;0
050900113;100;33;33;5;25;74;1;25;0;0;25;0;0;0
050900114;100;39;39;6;28;71;1;28;1;0;27;0;0;0
050900115;100;61;61;4;39;60;1;39;0;2;37;0;0;0
050900116;100;39;39;5;33;66;1;33;0;1;32;0;0;0
050900117;200;120;120;5;58;141;1;58;1;0;57;0;0;0
050900118;500;540;540;3;129;384;1;115;3;3;109;14;0;14
050900119;200;177;177;4;85;114;1;85;4;1;80;0;0;0
050900120;300;304;304;7;125;173;2;125;5;5;115;0;0;0
050900121;100;31;31;15;22;77;1;22;1;1;20;0;0;0
050900122;100;28;28;7;34;65;1;34;1;0;33;0;0;0
050900123;100;33;33;3;32;67;1;32;0;0;32;0;0;0
050900124;100;32;32;2;34;65;1;34;0;2;32;0;0;0
050900125;100;26;26;1;27;72;1;27;2;3;22;0;0;0
050900126;100;17;17;8;25;74;1;25;2;1;22;0;0;0
050900127;100;17;17;4;9;90;1;9;1;0;8;0;0;0
051500001;200;125;125;4;72;127;1;72;3;6;63;0;0;0
051500002;400;500;500;3;248;186;1;213;14;4;195;35;2;33
051500003;400;415;415;0;178;251;1;148;6;5;137;30;0;30
051500004;100;103;106;1;65;34;1;65;3;0;62;0;0;0
051500005;100;41;41;6;27;71;2;27;1;0;26;0;0;0
051500006;100;32;32;7;28;71;1;28;0;0;28;0;0;0
051500007;100;35;35;6;32;67;1;32;0;0;32;0;0;0
051500008;100;32;32;4;21;78;1;21;0;0;21;0;0;0
051500009;100;31;31;5;26;73;1;26;0;0;26;0;0;0
051600001;400;412;414;5;180;261;1;138;4;3;131;42;1;41
051600002;500;525;530;5;240;323;1;176;7;6;163;64;3;61
051600003;100;30;30;6;27;72;1;27;0;0;27;0;0;0
051600004;200;161;158;3;76;123;1;76;4;0;72;0;0;0
051600005;100;28;29;8;26;73;1;26;3;0;23;0;0;0
051600006;100;39;39;5;30;69;1;30;0;1;29;0;0;0
051600007;100;22;22;2;15;84;1;15;0;0;15;0;0;0
051600008;100;52;52;4;34;65;1;34;0;1;33;0;0;0
051600009;100;41;43;7;38;61;1;38;1;1;36;0;0;0
051600010;100;27;27;4;26;73;1;26;0;1;25;0;0;0
051600011;100;20;20;1;19;80;1;19;2;0;17;0;0;0
051600012;200;129;129;2;77;121;2;77;8;0;69;0;0;0
051600013;100;114;116;0;68;31;1;68;3;1;64;0;0;0
051600014;200;153;153;2;80;119;1;80;3;3;74;0;0;0
051600015;300;304;310;2;146;165;6;129;5;1;123;17;0;17
051600016;300;220;225;2;105;194;1;105;2;1;102;0;0;0
051600017;100;35;37;5;32;67;1;32;1;0;31;0;0;0
051600018;100;44;45;6;29;70;1;29;1;0;28;0;0;0
051600019;100;39;39;5;30;68;2;30;0;3;27;0;0;0
051600020;200;110;111;5;63;136;1;63;2;3;58;0;0;0
051600021;700;774;779;1;329;411;1;288;26;11;251;41;0;41
051600022;700;646;647;1;235;466;1;233;12;2;219;2;0;2
051600023;700;698;706;4;241;485;2;213;15;6;192;28;2;26
051600024;100;75;75;6;62;37;1;62;0;0;62;0;0;0
051600025;100;19;19;5;22;77;1;22;0;0;22;0;0;0
051600026;100;11;11;7;18;81;1;18;0;0;18;0;0;0
051600027;100;36;36;1;36;64;0;36;1;1;34;0;0;0
052200001;600;642;642;2;245;409;2;189;15;5;169;56;5;51
052200002;600;553;556;0;208;423;1;176;8;6;162;32;1;31
052200003;600;633;634;3;236;404;1;195;17;3;175;41;3;38
052200004;600;604;604;4;277;359;1;240;10;7;223;37;5;32
052200005;100;60;60;6;38;61;1;38;0;1;37;0;0;0
052200006;100;36;36;6;29;70;1;29;1;0;28;0;0;0
052200007;100;47;47;0;28;70;2;28;1;0;27;0;0;0
052200008;100;26;27;7;18;81;1;18;0;0;18;0;0;0
052200009;200;208;218;3;128;71;1;128;4;2;122;0;0;0
052200010;300;254;254;5;96;203;1;96;6;7;83;0;0;0
052200011;200;158;159;1;82;117;1;82;3;2;77;0;0;0
052200012;100;44;44;5;36;63;1;36;2;0;34;0;0;0
052200013;100;16;16;0;15;84;1;15;1;0;14;0;0;0
052500001;300;285;287;2;143;155;2;143;7;2;134;0;0;0
052500002;100;40;40;7;26;73;1;26;0;0;26;0;0;0
052500003;100;33;33;7;27;72;1;27;0;0;27;0;0;0
052500004;100;69;69;5;47;52;1;47;0;2;45;0;0;0
052500005;200;141;148;6;66;133;1;66;5;5;56;0;0;0
052500006;400;311;311;2;141;258;1;141;6;6;129;0;0;0
052500007;100;88;87;3;58;41;1;58;3;0;55;0;0;0
052500008;100;15;15;6;21;79;0;21;1;0;20;0;0;0
053000001;300;304;304;4;140;156;4;140;3;4;133;0;0;0
053000002;400;413;414;2;182;271;2;127;4;3;120;55;1;54
053000003;300;267;270;2;124;174;2;124;5;5;114;0;0;0
053000004;200;197;202;2;97;102;1;97;3;2;92;0;0;0
053000005;400;427;427;4;177;242;3;155;7;1;147;22;2;20
053000006;200;217;223;3;122;77;1;122;10;8;104;0;0;0
053000007;200;151;151;5;94;105;1;94;3;0;91;0;0;0
053000008;100;29;29;2;31;68;1;31;3;0;28;0;0;0
053300001;600;584;610;6;303;347;1;252;14;9;229;51;2;49
053300002;200;107;107;2;76;122;2;76;3;3;70;0;0;0
053300003;200;112;113;6;67;132;1;67;4;3;60;0;0;0
053300004;200;145;146;1;46;153;1;46;0;0;46;0;0;0
053300005;200;109;109;5;70;129;1;70;1;3;66;0;0;0
053300006;500;499;510;0;179;323;1;176;17;2;157;3;0;3
053300007;500;531;531;3;206;304;1;195;11;0;184;11;0;11
053300008;200;121;121;5;69;130;1;69;11;2;56;0;0;0
053300009;600;574;580;3;215;410;1;189;18;1;170;26;0;26
053300010;200;78;79;0;45;154;1;45;1;0;44;0;0;0
053300011;100;15;15;3;14;85;1;14;1;0;13;0;0;0
053300012;100;27;27;3;30;69;1;30;1;0;29;0;0;0
053300013;100;26;26;1;25;74;1;25;2;0;23;0;0;0
053700001;200;188;188;1;85;114;1;85;3;6;76;0;0;0
053700002;200;139;139;2;70;129;1;70;4;2;64;0;0;0
053700003;100;66;66;4;49;49;2;49;3;0;46;0;0;0
053700004;100;109;109;3;57;42;1;57;3;2;52;0;0;0
053700005;100;26;26;4;22;77;1;22;0;0;22;0;0;0
053700006;100;106;106;4;59;40;1;59;8;0;51;0;0;0
053700007;200;202;202;1;102;97;1;102;10;4;88;0;0;0
053700008;300;274;274;3;139;160;1;139;10;4;125;0;0;0
053700009;200;131;131;4;76;123;1;76;3;0;73;0;0;0
053700010;100;89;86;86;49;50;1;49;3;1;45;0;0;0
060500001;400;477;489;2;229;192;2;206;14;5;187;23;1;22
060500002;500;538;538;3;236;278;1;221;5;2;214;15;1;14
060500003;600;689;699;2;287;342;1;257;21;1;235;30;2;28
060500004;300;298;302;3;170;129;1;170;13;5;152;0;0;0
060500005;400;391;391;3;182;223;4;173;3;0;170;9;1;8
060500006;700;683;698;10;347;359;1;340;19;5;316;7;0;7
060500007;300;376;393;3;203;96;1;203;19;1;183;0;0;0
060500008;200;266;271;3;160;39;1;160;8;1;151;0;0;0
060500009;300;335;343;4;224;75;1;224;10;4;210;0;0;0
060500010;200;179;180;6;113;86;1;113;0;0;113;0;0;0
060500011;50;41;41;5;46;4;0;46;2;0;44;0;0;0
060500012;50;45;45;6;49;1;0;49;2;0;47;0;0;0
060800001;500;541;548;4;233;357;3;140;2;4;134;93;7;86
060800002;500;569;578;2;277;323;1;176;9;7;160;101;4;97
060800003;400;484;486;4;167;287;1;112;2;1;109;55;3;52
060800004;500;518;521;1;197;376;1;123;2;8;113;74;4;70
060800005;500;491;500;2;193;368;1;131;5;3;123;62;5;57
060800006;400;474;486;3;224;266;1;133;3;7;123;91;6;85
060800007;500;544;548;4;209;355;2;143;5;3;135;66;1;65
060800008;600;657;672;4;217;429;1;170;4;9;157;47;3;44
060800009;500;496;498;0;185;359;1;140;3;6;132;45;2;43
060800010;400;476;476;0;222;258;1;141;3;6;132;81;3;78
060800011;500;478;483;2;183;384;1;115;3;7;105;68;5;63
060800012;400;486;488;1;216;212;1;187;8;6;173;29;3;26
060800013;600;586;598;0;196;468;1;131;2;6;123;65;2;63
060800014;700;688;702;7;226;504;1;195;8;1;186;31;1;30
060800015;800;964;963;1;300;511;1;288;8;2;278;12;1;11
060800016;700;736;743;3;241;483;1;216;7;0;209;25;0;25
060800017;600;591;601;1;234;452;2;146;10;9;127;88;5;83
060800018;400;346;348;1;118;317;2;81;6;0;75;37;1;36
060800019;500;512;512;2;207;446;1;53;1;2;50;154;0;154
060800020;200;144;144;7;98;101;1;98;1;0;97;0;0;0
060800021;500;540;557;1;270;297;1;202;9;11;182;68;1;67
060800022;600;575;592;3;271;348;2;250;10;1;239;21;0;21
060800023;300;316;316;3;202;96;2;202;1;3;198;0;0;0
060800024;400;365;365;4;164;245;1;154;7;1;146;10;0;10
060800025;300;254;265;2;136;163;1;136;1;3;132;0;0;0
060800026;600;563;595;2;280;358;1;241;1;7;241;39;1;38
060800027;500;443;471;2;306;192;2;306;0;1;305;0;0;0
060800028;200;120;120;2;67;132;1;67;1;3;63;0;0;0
060800029;300;197;198;3;154;142;4;154;1;0;153;0;0;0
060800030;700;779;779;3;291;433;3;264;9;4;251;27;1;26
060800031;600;634;634;5;250;355;1;244;18;4;222;6;0;6
060800032;400;414;420;2;198;218;1;181;8;5;168;17;0;17
060800033;300;272;272;4;253;46;1;253;0;0;253;0;0;0
060800034;600;586;586;3;314;322;10;268;4;5;259;46;3;43
060800035;600;594;613;1;303;364;1;235;5;11;219;68;1;67
060800036;600;621;639;7;289;359;2;239;13;9;217;50;7;43
060800037;500;485;498;0;255;255;1;244;16;2;226;11;0;11
060800038;500;587;604;0;284;228;1;271;22;9;240;13;1;12
060800039;400;408;409;2;192;244;1;155;13;1;141;37;0;37
060800040;100;58;58;0;58;41;1;58;2;3;53;0;0;0
060800041;100;51;51;0;50;50;0;50;1;2;47;0;0;0
060800042;100;36;36;0;36;62;2;36;1;0;35;0;0;0
060800043;100;38;38;0;38;61;1;38;0;0;38;0;0;0
060800044;100;26;26;0;26;73;1;26;0;0;26;0;0;0
060800045;100;48;48;1;47;53;0;47;3;0;44;0;0;0
060800046;100;26;26;1;27;73;0;27;3;1;23;0;0;0
060800047;100;5;5;31;36;63;1;36;0;0;36;0;0;0
060800048;100;49;49;2;51;48;1;51;0;1;50;0;0;0
061000001;400;811;811;8;195;307;1;92;6;2;84;103;4;99
061000002;500;932;937;6;256;384;3;113;4;2;107;143;3;140
061000003;300;541;541;5;131;231;1;68;5;1;62;63;3;60
061000004;300;585;586;4;117;238;1;61;2;4;55;56;0;56
061000005;300;569;570;3;136;242;2;56;1;1;54;80;3;77
061000006;300;665;666;7;161;225;1;74;3;3;68;87;4;83
061000007;300;536;539;8;163;215;1;84;2;1;81;79;1;78
061000008;300;502;504;7;163;218;1;81;4;2;75;82;1;81
061000009;400;801;802;6;213;308;1;91;5;2;84;122;4;118
061000010;200;442;443;5;84;149;1;50;2;0;48;34;3;31
061000011;200;446;448;6;144;144;2;54;1;4;49;90;2;88
061000012;300;565;566;8;162;230;1;69;2;3;64;93;5;88
061000013;400;804;804;8;291;273;1;126;1;2;123;165;0;165
061000014;300;650;650;3;226;173;3;124;5;5;114;102;5;97
061000015;300;525;525;7;160;214;1;85;1;4;80;75;4;71
061000016;300;535;535;3;181;191;1;108;2;4;102;73;4;69
061000017;400;901;902;5;360;186;4;210;2;7;201;150;6;144
061000018;300;587;589;5;167;220;1;79;2;3;74;88;1;87
061000019;300;593;594;9;210;196;1;103;3;1;99;107;6;101
061000020;300;627;627;7;195;188;1;111;1;1;109;84;2;82
061000021;500;1011;1011;6;363;305;1;194;5;5;184;169;3;166
061000022;400;926;930;6;325;229;1;170;3;6;161;155;7;148
061000023;400;791;792;7;271;231;3;166;2;5;159;105;7;98
061000024;500;1063;1069;7;354;300;1;199;0;3;196;155;3;152
061000025;300;575;578;5;177;226;1;73;1;2;70;104;3;101
061000026;400;807;807;9;251;272;2;126;1;5;120;125;3;122
061000027;300;685;685;6;275;155;2;143;2;3;138;132;4;128
061000028;300;705;708;7;268;136;2;162;2;9;151;106;4;102
061000029;300;585;587;6;218;203;1;96;1;1;94;122;5;117
061000030;300;679;681;3;220;175;1;124;1;5;118;96;4;92
061000031;300;596;597;9;199;200;1;99;0;1;98;100;5;95
061000032;400;987;989;9;331;234;1;165;4;7;154;166;4;162
061000033;300;577;579;6;202;202;1;97;0;1;96;105;1;104
061000034;400;832;835;8;295;258;1;141;1;4;136;154;5;149
061000035;300;616;617;6;203;158;1;141;5;3;133;62;1;61
061000036;400;779;779;5;262;275;1;124;1;5;118;138;8;130
061000037;200;440;441;2;152;127;2;71;0;2;69;81;5;76
061000038;200;513;513;6;154;109;1;90;1;0;89;64;3;61
061000039;400;901;906;6;276;256;0;144;3;4;137;132;7;125
061000040;300;580;583;4;203;210;1;89;3;2;84;114;5;109
061000041;300;607;610;7;208;205;1;94;4;3;87;114;3;111
061000042;400;803;803;5;271;262;1;137;2;3;132;134;2;132
061000043;200;480;480;3;141;128;1;71;1;1;69;70;1;69
061000044;400;752;756;3;186;285;1;114;5;1;108;72;2;70
061000045;200;460;464;7;128;130;1;69;2;2;65;59;2;57
061000046;400;750;750;5;210;284;2;114;1;10;103;96;10;86
061000047;300;473;473;5;153;199;1;100;1;2;97;53;1;52
061000048;200;403;403;9;107;143;1;56;2;3;51;51;0;51
061000049;300;709;711;7;170;195;1;104;7;0;97;66;2;64
061000050;200;478;478;8;117;126;1;73;4;3;66;44;3;41
061000051;300;537;537;7;160;220;3;77;0;4;73;83;8;75
061000052;200;513;516;9;130;133;1;66;1;3;62;64;3;61
061000053;200;417;417;10;96;139;1;60;1;1;58;36;2;34
061000054;400;766;766;10;175;311;1;88;1;3;84;87;5;82
061000055;300;665;667;1;168;211;1;88;2;0;86;80;1;79
061000056;300;609;609;1;145;210;2;88;1;2;85;57;0;57
061000057;300;628;631;3;169;221;2;77;5;2;70;92;5;87
061000058;300;628;634;2;124;233;1;66;4;0;62;58;2;56
061000059;300;639;639;5;170;219;1;80;2;6;72;90;5;85
061000060;300;700;700;4;154;222;5;73;5;2;66;81;2;79
061000061;300;613;613;6;157;202;2;96;2;4;90;61;3;58
061000062;300;615;617;0;114;234;1;65;27;1;37;49;3;46
061000063;300;584;588;4;130;228;0;72;8;1;63;58;2;56
061000064;400;741;743;2;167;285;1;114;1;2;111;53;3;50
061000065;400;892;893;5;200;293;1;106;5;3;98;94;0;94
061000066;300;686;686;4;172;219;2;79;1;3;75;93;5;88
061000067;300;554;554;1;117;234;1;65;2;2;61;52;1;51
061000068;300;705;701;4;185;193;1;106;2;3;101;79;2;77
061000069;400;972;970;2;240;274;1;125;4;2;119;115;3;112
061000070;400;759;759;4;211;301;1;98;7;3;88;113;3;110
061000071;300;550;551;4;104;243;1;56;3;1;52;48;4;44
061000072;300;574;576;3;114;219;0;81;1;2;78;33;2;31
061000073;300;589;589;8;108;237;1;62;1;0;61;46;0;46
061000074;400;905;905;6;196;301;1;98;4;1;93;98;3;95
061000075;300;606;608;0;126;229;2;69;1;2;66;57;2;55
061000076;400;954;958;0;203;284;1;115;4;4;107;88;6;82
061000077;300;579;579;3;121;227;1;72;1;2;69;49;1;48
061000078;400;881;883;5;318;192;1;207;6;3;198;111;7;104
061000079;400;811;815;6;231;233;1;166;9;3;154;65;0;65
061000080;300;525;526;16;149;208;1;91;5;3;83;58;0;58
061000081;400;400;400;4;211;219;4;177;5;3;169;34;2;32
061000082;500;539;540;3;208;350;1;149;4;3;142;59;1;58
061000083;600;605;608;3;172;468;3;129;2;1;126;43;2;41
061000084;200;140;141;2;86;113;1;86;3;3;80;0;0;0
061000085;300;287;281;6;146;153;1;146;5;2;139;0;0;0
061000086;400;358;358;2;128;293;1;106;9;2;95;22;0;22
061000087;200;178;180;2;101;98;1;101;8;0;93;0;0;0
061000088;800;825;826;2;222;576;2;222;13;2;207;0;0;0
061000089;400;366;370;4;190;212;1;187;9;1;177;3;0;3
061000090;500;531;531;4;129;385;1;114;15;1;98;15;1;14
061000091;400;386;387;2;154;264;2;134;11;3;120;20;1;19
061000092;100;35;35;4;27;72;1;27;0;1;26;0;0;0
061000093;200;187;187;3;93;106;1;93;8;7;78;0;0;0
061000094;600;627;627;7;214;462;1;137;5;2;130;77;4;73
061000095;700;756;757;2;250;489;1;210;4;8;198;40;0;40
061000096;500;536;537;5;188;347;0;153;7;2;144;35;2;33
061000097;500;546;547;5;128;396;1;103;3;2;98;25;3;22
061000098;300;280;281;4;136;162;2;136;4;5;127;0;0;0
061000099;600;612;624;5;145;486;1;113;6;0;107;32;0;32
061000100;600;596;604;4;105;508;1;91;2;0;89;14;0;14
061000101;500;512;539;2;214;300;2;198;18;2;178;16;0;16
061000102;700;710;713;6;160;550;1;149;11;3;135;11;0;11
061000103;600;577;584;2;140;474;1;125;9;0;116;15;0;15
061000104;100;91;91;5;58;41;1;58;1;0;57;0;0;0
061000105;300;311;313;3;104;218;1;81;4;2;75;23;2;21
061000106;100;36;36;0;36;63;1;36;3;0;33;0;0;0
061000107;100;27;27;0;26;74;0;26;0;1;25;0;0;0
061000108;100;12;12;3;15;85;0;15;0;0;15;0;0;0
061000109;100;16;16;4;17;82;1;17;1;1;15;0;0;0
061000110;100;44;44;17;53;46;1;53;3;5;45;0;0;0
061000111;100;28;28;12;24;75;1;24;0;3;21;0;0;0
061000112;100;32;32;19;39;60;1;39;3;1;35;0;0;0
061000113;100;26;26;4;30;69;1;30;2;1;27;0;0;0
061000114;100;15;15;16;29;70;1;29;3;1;25;0;0;0
062000001;600;606;606;0;250;459;1;140;7;7;126;110;5;105
062000002;800;783;787;6;259;663;1;136;3;4;129;123;7;116
062000003;500;536;536;3;187;368;1;131;5;4;122;56;1;55
062000004;700;713;717;6;283;569;1;130;2;6;122;153;10;143
062000005;500;557;557;5;196;428;1;71;1;2;68;125;5;120
062000006;800;786;786;5;324;636;1;163;4;2;157;161;10;151
062000007;600;635;635;7;231;487;3;110;1;3;106;121;6;115
062000008;700;730;730;4;252;594;2;104;5;6;93;148;10;138
062000009;800;786;788;1;302;645;1;154;5;4;145;148;9;139
062000010;700;743;743;8;304;571;2;127;1;4;122;177;14;163
062000011;900;894;895;7;303;782;1;117;6;4;107;186;13;173
062000012;700;704;705;7;258;592;1;107;1;3;103;151;6;145
062000013;700;656;659;7;209;527;2;171;24;0;147;38;4;34
062000014;600;583;583;7;199;464;1;135;14;7;114;64;0;64
062000016;600;642;642;3;157;446;1;153;6;1;146;4;0;4
062000017;500;536;536;4;158;407;0;93;2;5;86;65;0;65
062000018;500;478;482;4;158;391;1;108;7;2;99;50;3;47
062000019;500;466;465;0;159;361;1;138;7;4;127;21;0;21
062000020;500;481;482;3;174;381;1;118;3;0;115;56;0;56
062000021;500;468;469;2;167;394;1;105;10;3;92;62;2;60
062000022;700;700;700;0;325;391;1;308;31;1;276;17;0;17
062000023;600;598;598;2;184;418;1;181;7;2;172;3;0;3
062000024;800;808;813;1;230;629;1;170;20;2;148;60;1;59
062000025;800;789;789;4;219;658;1;141;3;3;135;78;2;76
062000026;300;291;291;0;166;132;2;166;12;2;152;0;0;0
062000027;100;48;48;0;47;52;1;47;0;0;47;0;0;0
062100001;500;578;579;1;136;407;1;92;5;2;85;44;2;42
062100002;500;610;615;5;177;329;1;170;11;4;155;7;0;7
062100003;500;655;665;3;206;325;1;174;3;3;168;32;2;30
062100004;500;726;735;1;300;227;1;272;11;3;258;28;0;28
062100005;300;252;255;2;114;185;1;114;10;5;99;0;0;0
062100006;200;146;146;2;62;137;1;62;8;2;52;0;0;0
062100007;400;421;434;6;147;269;1;130;12;0;118;17;1;16
062100008;200;171;171;5;74;124;2;74;1;3;70;0;0;0
062100009;200;212;213;4;129;70;1;129;3;2;124;0;0;0
062100010;300;320;326;3;133;166;1;133;4;2;127;0;0;0
062100011;100;104;104;5;47;52;1;47;0;0;47;0;0;0
062100012;500;574;587;7;152;368;1;131;10;1;120;21;1;20
062100013;500;575;589;2;152;356;1;143;4;1;138;9;0;9
062100014;200;135;135;6;83;116;1;83;3;0;80;0;0;0
062100015;500;464;465;4;200;327;1;172;13;4;155;28;1;27
062100016;500;527;527;4;183;345;1;154;11;0;143;29;0;29
062100017;200;126;126;4;87;112;1;87;4;1;82;0;0;0
062100018;200;144;156;2;94;105;1;94;2;0;92;0;0;0
062100019;100;36;36;1;36;64;0;36;2;0;34;0;0;0
062100020;30;13;13;6;19;11;0;19;0;0;19;0;0;0
062100021;30;16;16;1;16;14;0;16;2;0;14;0;0;0
062100022;20;11;11;7;18;1;1;18;2;0;16;0;0;0
062100023;20;11;11;4;14;6;0;14;0;1;13;0;0;0
062700001;550;608;609;2;192;441;1;108;3;4;101;84;4;80
062700002;600;651;654;2;203;472;1;127;3;8;116;76;4;72
062700003;600;633;635;4;215;460;2;138;1;6;131;77;3;74
062700004;650;674;675;5;226;511;3;136;5;4;127;90;6;84
062700005;600;623;623;4;221;479;1;120;2;0;118;101;2;99
062700006;550;598;601;6;204;430;2;118;2;2;114;86;1;85
062700007;450;497;499;4;175;346;1;103;2;4;97;72;5;67
062700008;550;674;675;1;233;408;1;141;2;3;136;92;2;90
062700009;500;582;584;3;186;384;1;115;7;3;105;71;1;70
062700010;550;599;599;5;198;449;1;100;5;0;95;98;3;95
062700011;700;771;776;5;233;557;1;142;4;2;136;91;4;87
062700012;750;807;809;6;253;582;1;167;6;7;154;86;4;82
062700013;450;485;485;3;124;366;2;82;3;0;79;42;2;40
062700014;650;672;672;5;232;502;1;147;14;2;131;85;4;81
062700015;450;448;449;3;203;290;1;159;16;1;142;44;2;42
062700016;350;332;333;2;137;259;1;90;5;1;84;47;2;45
062700017;250;231;233;6;83;166;1;83;4;4;75;0;0;0
062700018;150;116;116;5;81;68;1;81;4;2;75;0;0;0
062700019;350;325;325;5;152;218;1;131;3;1;127;21;1;20
062700020;450;404;404;4;137;348;2;100;3;2;95;37;1;36
062700021;350;319;319;1;160;189;1;160;10;5;145;0;0;0
062700022;300;265;265;0;78;221;1;78;4;2;72;0;0;0
062700023;600;586;589;5;156;478;1;121;7;2;112;35;1;34
062700024;700;707;707;7;201;559;1;140;11;2;127;61;3;58
062700025;100;73;73;3;52;47;1;52;0;0;52;0;0;0
062700026;450;412;412;3;117;368;1;81;5;1;75;36;1;35
062700027;300;279;279;4;99;200;1;99;13;0;86;0;0;0
062700028;100;55;55;5;36;63;1;36;5;1;30;0;0;0
062700029;200;200;202;4;108;90;2;108;2;5;101;0;0;0
062700030;250;220;223;5;106;143;1;106;12;4;90;0;0;0
062700031;200;157;157;2;112;87;1;112;3;1;108;0;0;0
062700032;250;231;231;1;139;109;2;139;9;4;126;0;0;0
062700033;550;545;549;2;216;391;1;158;16;5;137;58;5;53
062700034;350;334;335;4;128;223;1;126;6;0;120;2;0;2
062700035;100;98;104;5;69;30;1;69;4;2;63;0;0;0
062700036;100;87;87;7;61;38;1;61;3;1;57;0;0;0
062700037;300;307;307;2;189;110;1;189;5;4;180;0;0;0
062700038;300;256;256;3;117;182;1;117;3;5;109;0;0;0
062700039;100;81;81;6;51;47;2;51;2;1;48;0;0;0
062700040;250;248;251;2;100;149;1;100;2;2;96;0;0;0
062700041;50;33;32;6;26;23;1;26;1;0;25;0;0;0
062700042;250;227;227;5;100;149;1;100;2;1;97;0;0;0
062700043;50;18;18;0;17;32;1;17;1;0;16;0;0;0
062700044;50;17;17;0;17;32;1;17;1;0;16;0;0;0
062800001;500;669;674;3;168;370;1;129;8;4;117;39;3;36
062800002;500;592;594;5;201;371;1;128;3;6;119;73;10;63
062800003;500;631;639;3;192;357;2;141;2;4;135;51;3;47
062800004;500;571;574;4;157;386;1;113;2;6;105;44;2;42
062800005;100;13;14;2;9;90;1;9;0;0;9;0;0;0
062800006;200;177;177;4;93;106;1;93;3;4;86;0;0;0
062800007;500;654;665;6;244;278;2;220;21;4;195;24;2;22
062800008;500;532;532;4;220;300;12;188;12;4;172;32;3;29
062800009;400;493;496;3;175;257;1;142;8;2;132;33;0;33
062800010;500;513;527;3;199;334;1;165;12;7;146;34;1;33
062800011;400;470;498;4;171;254;1;145;14;6;125;26;0;26
062800012;100;14;14;0;14;86;0;14;1;0;13;0;0;0
062800013;100;21;21;0;21;77;2;21;1;0;20;0;0;0
062800014;100;19;19;1;20;80;0;20;1;0;19;0;0;0
062800015;100;24;24;1;23;76;1;23;0;1;22;0;0;0
063100001;1000;1006;1008;2;353;700;1;299;12;3;284;54;7;47
063100002;900;932;936;1;317;652;1;247;1;7;239;70;1;69
063100003;700;730;738;3;227;557;1;142;0;6;136;85;2;83
063100004;500;534;540;3;168;388;1;111;7;3;101;57;4;53
063100005;900;918;927;6;344;647;1;252;5;1;246;92;3;89
063100006;500;518;527;7;152;386;1;113;5;6;102;39;1;38
063100007;600;543;551;7;136;498;3;99;16;0;83;37;1;36
063100008;500;483;483;3;144;402;1;97;3;1;93;47;4;43
063100009;600;553;573;1;163;480;1;119;6;2;111;44;1;43
063100010;600;567;590;7;182;473;1;126;7;7;112;56;2;54
063100011;500;521;521;0;66;439;1;60;0;0;60;6;1;5
063100012;500;455;455;5;85;427;1;72;1;3;68;13;0;13
063100013;200;167;186;3;78;121;1;78;6;1;71;0;0;0
063100014;100;94;105;3;45;54;1;45;4;1;40;0;0;0
063100015;500;431;435;2;124;402;1;97;3;3;91;27;1;26
063100016;200;171;177;6;46;153;1;46;4;0;42;0;0;0
063100017;100;43;43;0;40;60;0;40;2;0;38;0;0;0
063100018;100;36;36;0;35;65;0;35;0;0;35;0;0;0
063200001;400;546;549;1;140;301;1;98;6;2;90;42;3;39
063200002;500;737;743;0;273;283;1;216;8;4;204;57;3;54
063200003;350;455;457;2;105;264;2;84;4;3;77;21;0;21
063200004;450;537;539;0;169;324;1;125;7;1;117;44;0;44
063200005;200;204;205;6;149;50;1;149;5;1;143;0;0;0
063200006;400;465;468;4;189;235;1;164;10;1;153;25;0;25
063200007;300;350;351;2;165;148;2;150;9;5;136;15;1;14
063200008;120;108;121;5;87;32;1;87;1;2;84;0;0;0
063200009;250;260;266;3;134;114;2;134;8;1;125;0;0;0
063200010;250;292;298;2;170;78;2;170;7;6;157;0;0;0
063200011;50;45;45;7;40;9;1;40;0;0;40;0;0;0
063200012;100;92;92;1;61;38;1;61;2;5;54;0;0;0
063200013;150;186;186;0;116;33;1;116;3;2;111;0;0;0
063200014;50;34;34;5;32;17;1;32;0;0;32;0;0;0
063200015;200;219;219;0;122;77;1;122;9;5;108;0;0;0
063200016;30;20;20;0;20;10;0;20;1;1;18;0;0;0
063200017;30;17;17;0;15;15;0;15;0;0;15;0;0;0
063200018;70;25;25;31;56;13;1;56;7;0;49;0;0;0
063500001;500;539;547;2;206;342;2;156;13;4;139;50;5;45
063500002;500;486;495;3;204;352;1;147;5;3;139;57;0;57
063500003;100;52;40;3;40;59;1;40;6;0;34;0;0;0
063500004;300;347;350;1;186;126;1;173;3;3;167;13;0;13
063500005;300;343;346;0;138;174;1;125;2;2;121;13;0;13
063500006;400;431;436;4;158;321;1;78;1;2;75;80;0;80
063500007;300;325;330;0;154;219;1;80;1;2;77;74;0;74
063500008;200;162;161;2;76;123;1;76;2;1;73;0;0;0
063500009;300;293;295;2;91;208;1;91;5;2;84;0;0;0
063500010;400;368;374;2;131;276;1;123;4;0;119;8;0;8
063500011;100;57;57;1;28;69;3;28;1;0;27;0;0;0
063500012;100;19;19;0;18;81;1;18;1;0;17;0;0;0
070500001;1000;970;974;4;233;904;1;95;1;3;91;138;7;131
070500002;900;881;883;4;233;769;1;130;2;5;123;103;2;101
070500003;700;701;701;3;188;602;1;97;6;3;88;91;4;87
070500004;400;405;405;6;116;363;1;36;1;1;34;80;3;77
070500005;500;587;587;6;153;424;1;75;2;2;71;78;0;78
070500006;700;704;704;7;188;599;1;100;1;1;98;88;2;86
070500007;600;619;620;8;159;516;1;83;6;2;75;76;2;74
070500008;600;611;612;6;140;524;1;75;1;0;74;65;3;62
070500009;700;627;629;7;144;628;2;70;3;2;65;74;2;72
070500010;700;704;709;4;157;625;1;74;0;2;72;83;1;82
070500011;500;458;458;7;139;426;1;73;3;3;67;66;1;65
070500012;800;822;825;9;185;659;1;140;3;7;130;45;1;44
070500013;600;637;637;4;174;522;1;77;4;1;72;97;2;95
070500014;800;762;762;5;188;723;1;76;3;1;72;112;10;102
070500015;500;543;543;8;159;420;2;78;0;6;72;81;6;75
070500016;600;603;604;7;143;527;1;72;2;0;70;71;1;70
070500017;500;529;532;7;149;438;1;61;2;1;58;88;5;83
070500018;500;548;548;7;161;413;1;86;1;1;84;75;1;74
070500019;800;802;801;10;242;666;1;133;2;3;128;109;6;103
070500020;600;604;607;5;204;493;2;105;1;4;100;99;1;98
070500021;500;531;531;8;171;421;1;78;4;4;70;93;4;89
070500022;500;537;537;7;167;407;1;92;0;3;89;75;0;75
070500023;500;555;554;9;147;440;5;55;0;1;54;92;2;90
070500024;900;913;914;7;220;817;2;81;1;1;79;139;5;134
070500025;700;701;701;10;210;596;2;102;3;3;96;108;4;104
070500026;500;515;517;10;162;418;1;81;0;2;79;81;1;80
070500027;200;150;150;8;50;149;1;50;1;2;47;0;0;0
070500028;500;479;494;7;182;436;1;63;2;1;60;119;7;112
070500029;500;555;555;9;201;410;1;89;4;2;83;112;3;109
070500030;400;459;461;6;153;326;3;71;2;1;68;82;3;79
070500031;400;395;396;8;141;310;1;89;2;6;81;52;0;52
070500032;600;630;641;8;211;481;2;117;5;3;109;94;6;88
070500033;700;731;732;10;230;573;1;126;0;2;124;104;2;102
070500034;600;660;660;6;229;489;2;109;4;1;104;120;7;113
070500035;700;736;736;8;215;582;1;117;6;5;106;98;4;94
070500036;500;553;550;9;180;406;2;92;5;5;82;88;3;85
070500037;700;669;670;5;166;601;1;98;1;5;92;68;1;67
070500038;500;582;582;6;179;408;1;91;7;1;83;88;3;85
070500039;500;586;586;9;153;427;2;71;3;0;68;82;1;81
070500040;500;513;511;5;164;407;1;92;4;1;87;72;2;70
070500041;800;845;846;7;259;695;1;104;2;0;102;155;6;149
070500042;700;794;689;7;125;625;1;74;1;1;72;51;1;50
070500043;600;643;643;6;178;500;4;96;2;5;89;82;3;79
070500044;700;720;722;4;245;600;1;99;1;2;96;146;8;138
070500045;800;769;774;9;243;703;1;96;2;7;87;147;4;143
070500046;700;692;692;1;175;629;1;70;1;2;67;105;2;103
070500047;500;563;565;9;182;414;1;85;1;2;82;97;6;91
070500048;500;474;474;2;169;331;1;168;3;4;161;1;0;1
070500049;700;650;651;10;201;586;3;111;2;2;107;90;3;87
070500050;500;482;484;4;146;419;2;79;1;4;74;67;1;66
070500051;700;756;757;4;208;581;1;118;3;3;112;90;0;90
070500052;600;593;592;9;166;436;1;163;5;7;151;3;0;3
070500053;500;569;570;4;185;397;1;102;5;0;97;83;3;80
070500054;500;580;581;5;153;420;1;79;2;1;76;74;4;70
070500055;400;340;340;7;87;349;1;50;0;0;50;37;3;34
070500056;600;663;662;5;148;515;1;84;3;1;80;64;3;61
070500057;600;654;655;9;178;523;1;76;2;4;70;102;7;95
070500058;500;564;565;7;126;433;2;65;1;1;63;61;2;59
070500059;500;518;519;9;175;423;1;76;4;1;71;99;3;96
070500060;500;575;576;8;180;375;2;123;5;4;114;57;2;55
070500061;600;617;617;9;201;397;2;201;2;6;193;0;0;0
070500062;500;551;551;7;186;324;1;175;3;5;167;11;1;10
070500063;400;447;447;8;188;280;3;117;3;3;111;71;1;70
070500064;500;556;560;5;184;406;1;93;1;4;88;91;2;89
070500065;500;554;553;6;184;414;1;85;0;2;83;99;1;98
070500066;600;599;599;9;194;509;1;90;4;3;83;104;4;100
070500067;400;358;358;7;122;332;2;66;0;3;63;56;1;55
070500068;500;552;554;7;164;417;1;82;1;1;80;82;2;80
070500069;500;456;456;7;104;441;1;58;1;1;56;46;1;45
070500070;700;633;634;10;169;621;6;73;4;0;69;96;3;93
070500071;700;646;646;8;200;592;1;107;5;2;100;93;2;91
070500072;800;771;771;8;212;707;1;92;2;1;89;120;2;118
070500073;800;755;758;4;200;703;1;96;5;2;89;104;5;99
070500074;700;738;739;5;239;633;1;66;1;2;63;173;11;162
070500075;400;380;380;2;86;352;1;47;2;0;45;39;1;38
070500076;500;559;561;6;137;438;1;61;1;0;60;76;3;73
070500077;800;780;780;6;263;635;4;161;3;4;154;102;2;100
070500078;600;614;610;6;138;528;1;71;3;2;66;67;0;67
070500079;300;335;336;5;95;205;1;94;2;2;90;1;0;1
070500080;700;662;662;10;146;629;1;70;2;0;68;76;0;76
070500081;500;524;524;5;143;418;2;80;2;5;73;63;5;58
070500082;200;144;144;6;53;146;1;53;0;1;52;0;0;0
070500083;200;124;124;8;51;148;1;51;2;3;46;0;0;0
070500084;100;52;52;6;50;49;1;50;0;2;48;0;0;0
070500085;100;47;48;7;26;72;2;26;1;1;24;0;0;0
070500086;100;89;89;7;69;30;1;69;3;0;66;0;0;0
070500087;100;73;73;8;65;34;1;65;4;0;61;0;0;0
070500088;300;231;231;7;88;211;1;88;4;0;84;0;0;0
070500089;200;136;136;7;47;152;1;47;0;1;46;0;0;0
070500090;200;121;121;8;62;138;0;62;0;3;59;0;0;0
070500091;200;129;131;6;68;130;2;68;2;0;66;0;0;0
070500092;200;138;139;5;57;142;1;57;2;5;50;0;0;0
070500093;200;175;176;9;79;120;1;79;4;4;71;0;0;0
070500094;100;91;91;8;60;39;1;60;2;1;57;0;0;0
070500095;100;67;67;5;42;57;1;42;0;0;42;0;0;0
070500096;100;60;60;8;46;53;1;46;0;1;45;0;0;0
070500097;400;382;383;6;153;296;1;103;3;4;96;50;2;48
070500098;200;110;110;5;62;137;1;62;1;2;59;0;0;0
070500099;200;110;115;7;57;142;1;57;1;3;53;0;0;0
070500100;300;254;254;5;122;177;1;122;4;5;113;0;0;0
070500101;100;78;79;6;51;48;1;51;1;1;49;0;0;0
070500102;100;100;103;5;59;40;1;59;1;0;58;0;0;0
070500103;100;104;104;6;91;8;1;91;6;3;82;0;0;0
070500104;300;260;260;6;95;204;1;95;5;8;82;0;0;0
070500105;200;120;120;6;76;123;1;76;3;3;70;0;0;0
070500106;500;565;565;7;110;413;1;86;11;5;70;24;2;22
070500107;200;186;187;6;78;121;1;78;2;1;75;0;0;0
070500108;200;114;114;7;62;137;1;62;1;0;61;0;0;0
070500109;200;91;91;8;62;137;1;62;0;0;62;0;0;0
070500110;50;16;17;13;23;25;2;23;6;0;17;0;0;0
070500111;100;25;25;6;19;80;1;19;0;3;16;0;0;0
070500112;200;143;143;8;73;126;1;73;3;4;66;0;0;0
070500113;200;210;211;6;80;119;1;80;2;5;73;0;0;0
070500114;100;92;92;5;34;64;2;34;2;1;31;0;0;0
070500115;100;26;26;6;19;80;1;19;0;1;18;0;0;0
070500116;100;53;53;7;27;72;1;27;0;0;27;0;0;0
070500117;100;100;100;7;48;52;0;48;3;1;44;0;0;0
070500118;200;29;29;65;70;129;1;70;1;3;66;0;0;0
070500119;100;26;26;16;34;65;1;34;1;0;33;0;0;0
070500120;100;35;35;13;22;76;2;22;0;0;22;0;0;0
070500121;50;15;15;8;22;27;1;22;0;0;22;0;0;0
071200001;380;397;397;5;102;314;1;65;0;1;64;37;1;36
071200002;500;525;525;3;157;412;1;87;3;3;81;70;2;68
071200003;450;460;462;8;140;365;1;84;3;4;77;56;2;54
071200004;530;536;538;5;139;441;1;88;1;1;86;51;4;47
071200005;400;415;419;2;120;352;1;47;1;1;45;73;6;67
071200006;360;376;377;0;126;290;1;69;3;1;65;57;1;56
071200007;310;312;314;4;90;258;1;51;3;0;48;39;1;38
071200008;670;694;697;5;55;619;6;45;5;2;38;10;0;10
071200009;480;495;498;8;144;405;3;72;2;0;70;72;1;71
071200010;500;529;530;4;122;414;2;84;2;0;82;38;2;36
071200011;600;612;619;4;153;507;2;91;1;3;87;62;2;60
071200012;380;390;391;3;121;308;1;71;3;3;65;50;2;48
071200013;500;502;503;7;127;428;1;71;3;4;64;56;3;53
071200014;430;450;453;5;154;332;1;97;3;8;86;57;2;55
071200015;30;27;27;5;29;0;1;29;0;0;29;0;0;0
071200016;100;94;94;6;43;56;1;43;0;0;43;0;0;0
071200017;190;187;187;6;82;107;1;82;3;1;78;0;0;0
071200018;40;37;37;8;23;16;1;23;1;0;22;0;0;0
071200019;74;72;72;7;39;34;1;39;1;3;35;0;0;0
071200020;185;183;183;4;96;88;1;96;0;6;90;0;0;0
071200021;85;85;85;7;41;43;1;41;1;1;39;0;0;0
071200022;40;38;38;10;27;11;2;27;4;0;23;0;0;0
071200023;40;40;40;2;2;37;1;2;0;0;2;0;0;0
071200024;26;26;26;0;25;0;1;25;6;0;19;0;0;0
072900001;800;845;845;6;127;704;2;94;7;5;82;33;1;32
072900002;500;480;481;3;135;422;1;77;3;2;72;58;3;55
072900003;500;458;460;4;140;421;1;78;1;1;76;62;1;61
072900004;500;501;502;5;170;430;1;69;3;3;63;101;4;97
072900005;700;666;666;6;129;631;2;67;1;4;62;62;2;60
072900006;700;674;674;7;152;618;1;81;1;0;80;71;6;65
072900007;500;507;507;6;80;442;1;57;4;2;51;23;1;22
072900008;900;948;948;6;116;790;2;108;10;1;97;8;0;8
072900009;600;582;583;6;165;514;1;85;3;2;80;80;5;75
072900010;700;725;725;7;205;599;3;98;0;2;96;107;4;103
072900011;900;867;868;6;210;776;2;122;3;4;115;88;7;81
072900012;600;625;625;8;158;514;1;85;4;1;80;73;4;69
072900013;500;501;502;8;154;438;1;61;1;0;60;93;6;87
072900014;600;624;624;9;200;503;1;96;2;2;92;104;1;103
072900015;500;541;541;2;152;434;1;65;0;0;65;87;2;85
072900016;500;480;480;5;142;431;1;68;0;1;67;74;3;71
072900017;700;663;663;9;194;604;1;95;1;1;93;99;4;95
072900018;700;700;702;9;181;606;1;93;1;3;89;88;7;81
072900019;600;562;562;10;117;497;1;102;0;6;96;15;0;15
072900020;700;750;750;0;168;613;1;86;4;2;80;82;3;79
072900021;600;576;577;7;171;518;1;81;0;3;78;90;4;86
072900022;700;741;742;3;175;607;1;92;9;5;78;83;4;79
072900023;900;868;861;9;260;749;1;150;7;3;140;110;4;106
072900024;600;621;623;4;156;529;1;70;3;2;65;86;4;82
072900025;500;543;541;6;142;425;1;74;1;5;68;68;2;66
072900026;600;632;634;3;180;534;1;65;2;0;63;115;13;102
072900027;700;689;691;0;178;597;1;102;2;2;98;76;6;70
072900028;900;889;889;5;219;783;1;116;4;1;111;103;5;98
072900029;800;853;855;8;201;701;3;96;0;0;96;105;2;103
072900030;700;732;733;2;150;635;1;64;1;1;62;86;3;83
072900031;200;238;238;5;76;123;1;76;3;1;72;0;0;0
072900032;700;705;705;2;133;589;1;110;11;1;98;23;1;22
072900033;200;203;203;6;91;108;1;91;2;1;88;0;0;0
072900034;300;258;258;8;110;189;1;110;4;2;104;0;0;0
072900035;100;121;121;3;48;51;1;48;1;0;47;0;0;0
072900036;100;73;73;5;41;58;1;41;1;1;39;0;0;0
072900037;400;476;477;3;144;290;1;109;4;2;103;35;0;35
072900038;400;407;412;4;171;268;1;131;4;2;125;40;0;40
072900039;500;501;506;5;178;364;1;135;2;0;133;43;0;43
072900040;300;295;298;5;103;196;1;103;2;2;99;0;0;0
072900041;400;428;428;6;101;312;1;87;3;4;80;14;0;14
072900042;600;569;570;7;91;530;1;69;8;3;58;22;0;22
072900043;600;595;598;6;77;525;1;74;8;4;62;3;0;3
072900044;100;83;83;4;26;73;1;26;3;0;23;0;0;0
072900045;500;480;483;6;120;426;1;73;5;2;66;47;2;45
072900046;300;302;302;3;91;208;1;91;7;4;80;0;0;0
072900047;300;373;375;5;174;141;1;158;4;2;152;16;1;15
072900048;200;152;153;5;55;144;1;55;1;2;52;0;0;0
072900049;100;157;157;4;78;21;1;78;2;1;75;0;0;0
072900050;100;105;105;6;61;38;1;61;2;6;53;0;0;0
072900051;100;69;69;7;39;60;1;39;1;3;35;0;0;0
072900052;100;114;114;7;51;48;1;51;2;2;47;0;0;0
072900053;300;324;324;3;123;190;1;109;4;2;103;14;0;14
072900054;500;538;538;6;229;274;2;224;5;2;217;5;0;5
072900055;600;606;608;6;210;414;1;185;1;4;180;25;2;23
072900056;500;146;559;5;151;374;1;125;6;1;118;26;0;26
072900057;100;62;62;6;30;69;1;30;0;2;28;0;0;0
072900058;200;170;176;5;69;130;1;69;2;1;66;0;0;0
072900059;200;170;187;3;49;150;1;49;0;1;48;0;0;0
072900060;500;509;509;0;143;396;1;103;3;0;100;40;4;36
072900061;50;57;57;5;33;16;1;33;2;2;29;0;0;0
072900062;50;39;39;6;28;21;1;28;0;0;28;0;0;0
072900063;100;51;52;6;19;80;1;19;2;0;17;0;0;0
072900064;50;31;31;7;21;28;1;21;0;0;21;0;0;0
072900065;100;100;100;7;57;42;1;57;3;1;53;0;0;0
072900066;700;775;776;6;179;555;1;144;30;2;112;35;0;35
072900067;50;24;24;18;24;25;1;24;1;0;23;0;0;0
072900068;50;33;33;20;40;9;1;40;5;0;35;0;0;0
072900069;100;25;25;7;25;75;0;25;0;1;24;0;0;0
072900070;50;28;28;5;33;17;0;33;2;0;31;0;0;0
073500001;500;544;544;7;140;424;2;74;0;1;73;66;0;66
073500002;800;793;800;8;209;688;1;111;1;2;108;98;5;93
073500003;700;697;702;1;209;600;1;99;3;0;96;110;2;108
073500004;700;739;743;9;239;590;5;105;4;2;99;134;4;130
073500005;600;551;553;7;175;493;2;105;1;3;101;70;5;65
073500006;600;622;624;8;149;514;1;85;3;1;81;64;1;63
073500007;600;587;590;8;142;522;1;77;3;0;74;65;0;65
073500008;600;608;610;7;118;539;2;59;4;1;54;59;1;58
073500009;700;685;685;5;179;594;5;101;4;2;95;78;1;77
073500010;600;603;604;9;164;522;1;77;4;2;71;87;5;82
073500011;300;355;355;7;91;246;1;53;2;0;51;38;1;37
073500012;500;500;501;4;108;421;1;78;3;4;71;30;2;28
073500013;500;537;539;5;132;370;1;129;0;2;127;3;0;3
073500014;100;34;34;8;21;78;1;21;0;0;21;0;0;0
073500015;100;26;26;8;20;79;1;20;1;0;19;0;0;0
073500016;100;44;44;8;27;72;1;27;0;2;25;0;0;0
073500017;100;83;83;7;30;69;1;30;1;0;29;0;0;0
073500018;700;681;684;5;160;602;1;97;3;2;92;63;2;61
073500019;700;764;768;8;190;601;1;98;2;2;94;92;3;89
073500020;100;33;33;8;28;71;1;28;2;0;26;0;0;0
080300001;1000;1083;1084;9;361;791;2;207;8;3;196;154;4;150
080300002;500;632;633;7;143;423;1;76;0;1;75;67;2;65
080300003;1000;1118;1118;5;136;863;1;136;11;0;125;0;0;0
080300004;500;651;651;5;190;376;1;123;11;2;110;67;2;65
080300005;500;561;561;7;134;408;1;91;8;0;83;43;3;40
080300006;500;790;790;7;247;390;1;109;4;5;100;138;4;134
080300007;1000;1113;1113;6;186;871;1;128;11;2;115;58;2;56
080300008;500;596;596;5;140;445;1;54;0;3;51;86;5;81
080300009;500;626;628;5;149;420;1;79;2;2;75;70;1;69
080300010;500;600;600;4;149;407;1;92;2;2;88;57;3;54
080300011;500;607;608;4;178;400;1;99;2;0;97;79;5;74
080300012;500;805;807;5;169;389;1;110;4;4;102;59;6;53
080300013;1000;921;922;7;241;856;1;143;3;6;134;98;7;91
080300014;500;514;515;6;159;428;1;71;2;0;69;88;6;82
080300015;100;17;17;17;29;70;1;29;0;0;29;0;0;0
080300016;300;274;274;6;139;160;1;139;16;0;123;0;0;0
080300017;200;120;120;5;40;159;1;40;0;0;40;0;0;0
080300018;500;426;426;1;136;378;1;121;3;0;118;15;0;15
080300019;300;217;217;7;76;223;1;76;1;2;73;0;0;0
080300020;300;114;114;6;38;261;1;38;0;0;38;0;0;0
080300021;300;150;150;7;57;242;1;57;3;0;54;0;0;0
080300022;700;638;638;7;289;492;1;207;6;7;194;82;5;77
080300023;200;105;105;8;66;133;1;66;3;0;63;0;0;0
080300024;500;380;380;6;167;332;1;167;10;2;155;0;0;0
080300025;300;106;106;5;48;251;1;48;1;4;43;0;0;0
080300026;1000;768;768;3;209;851;1;148;4;2;142;61;4;57
080300027;1000;1057;1059;5;211;819;1;180;16;1;163;31;0;31
080300028;200;162;162;8;104;95;1;104;2;0;102;0;0;0
080300029;300;172;172;6;64;235;1;64;3;0;61;0;0;0
080300030;500;492;495;5;134;391;1;108;5;1;102;26;0;26
080300031;100;47;47;13;34;65;1;34;4;1;29;0;0;0
080300032;700;791;794;3;285;449;2;249;8;10;231;36;2;34
080300033;500;357;357;4;142;357;1;142;6;1;135;0;0;0
080300034;200;63;63;6;39;160;1;39;0;0;39;0;0;0
080300035;100;37;37;5;20;79;1;20;3;0;17;0;0;0
080300036;400;239;239;7;98;301;1;98;2;2;94;0;0;0
080300037;100;32;32;40;59;40;1;59;2;4;53;0;0;0
080300038;100;30;30;10;39;60;1;39;0;4;35;0;0;0
081200001;600;598;600;6;198;478;1;121;6;2;113;77;1;76
081200002;600;597;597;6;155;497;1;102;4;0;98;53;0;53
081200003;700;682;682;8;207;567;1;132;5;12;115;75;6;69
081200004;700;715;715;2;197;588;2;110;0;3;107;87;5;82
081200005;600;647;648;4;194;469;1;130;3;3;124;64;1;63
081200006;700;716;720;7;177;585;4;111;3;2;106;66;0;66
081200007;700;759;762;8;107;615;1;84;5;2;77;23;0;23
081200008;600;632;636;8;175;504;1;95;5;0;90;80;1;79
081200009;300;285;285;6;105;194;1;105;1;1;103;0;0;0
081200010;100;45;45;3;29;70;1;29;0;1;28;0;0;0
081200011;100;36;36;4;14;85;1;14;1;1;12;0;0;0
081200012;300;293;293;5;63;236;1;63;0;0;63;0;0;0
081200013;100;27;27;8;16;83;1;16;0;1;15;0;0;0
081200014;100;60;60;7;25;74;1;25;3;0;22;0;0;0
081200015;100;23;24;5;17;82;1;17;1;0;16;0;0;0
081200016;100;76;76;6;40;59;1;40;3;0;37;0;0;0
081200017;200;103;103;6;57;142;1;57;0;2;55;0;0;0
081200018;100;23;57;6;29;70;1;29;1;0;28;0;0;0
081200019;200;157;157;5;55;144;1;55;1;2;52;0;0;0
081200020;300;649;649;9;109;190;1;109;7;1;101;0;0;0
081200021;100;35;35;6;17;82;1;17;1;0;16;0;0;0
081200022;400;381;381;2;111;307;1;92;2;0;90;19;1;18
081200023;400;365;368;1;98;309;1;90;6;3;81;8;1;7
081200024;200;146;154;6;53;146;1;53;3;0;50;0;0;0
081200025;300;297;298;6;37;270;1;29;0;0;29;8;0;8
081200026;500;516;517;5;75;428;2;70;3;1;66;5;0;5
081200027;200;158;159;5;68;131;1;68;7;0;61;0;0;0
081200028;200;161;161;5;51;148;1;51;2;2;47;0;0;0
081200029;100;76;76;6;29;70;1;29;0;1;28;0;0;0
081200030;100;40;41;6;23;76;1;23;2;0;21;0;0;0
081200031;200;181;181;2;46;153;1;46;4;0;42;0;0;0
081200032;300;366;367;8;112;187;1;112;12;0;100;0;0;0
081200033;400;409;412;5;110;298;1;101;9;1;91;9;0;9
081200034;200;225;225;8;56;141;3;56;4;2;50;0;0;0
081200035;100;126;126;6;24;75;1;24;0;0;24;0;0;0
081200036;100;46;46;7;27;72;1;27;2;0;25;0;0;0
081200037;400;329;331;5;53;361;1;38;1;0;37;15;0;15
081200038;100;35;35;6;17;82;1;17;0;0;17;0;0;0
081200039;100;66;66;5;32;67;1;32;1;1;30;0;0;0
081200040;200;236;236;6;70;129;1;70;8;0;62;0;0;0
081200041;400;396;396;5;63;344;1;55;4;3;48;8;3;5
081200042;400;336;336;7;50;366;1;33;5;0;28;17;3;14
081200043;100;48;48;7;15;84;1;15;0;0;15;0;0;0
081200044;100;32;32;5;18;80;2;18;1;0;17;0;0;0
081200045;200;140;140;5;36;163;1;36;2;1;33;0;0;0
081500001;100;107;107;6;63;36;1;63;2;0;61;0;0;0
081500002;300;298;298;5;64;235;1;64;4;0;60;0;0;0
081500003;600;568;568;6;180;463;2;135;11;5;119;45;0;45
081500004;50;41;42;4;30;19;1;30;0;0;30;0;0;0
081500005;850;842;843;13;165;702;1;147;9;3;135;18;0;18
081500006;900;898;898;7;230;669;1;230;8;5;217;0;0;0
081500007;200;152;152;6;71;128;1;71;1;1;69;0;0;0
081500008;1000;1064;1067;7;211;813;2;185;11;2;172;26;0;26
081500009;400;379;380;5;98;338;1;61;5;1;55;37;3;34
081500010;500;508;509;8;121;390;1;109;7;4;98;12;0;12
081500011;200;159;159;1;60;139;1;60;3;1;56;0;0;0
081500012;400;372;372;3;100;299;1;100;16;2;82;0;0;0
081500013;50;31;31;7;27;22;1;27;0;0;27;0;0;0
081500014;50;51;46;5;33;16;1;33;2;0;31;0;0;0
081500015;100;74;74;3;44;55;1;44;0;1;43;0;0;0
081500016;100;68;68;3;47;52;1;47;5;0;42;0;0;0
081500017;700;773;782;5;272;478;2;220;21;2;197;52;1;51
081500018;200;136;136;5;40;159;1;40;0;0;40;0;0;0
081500019;50;24;39;6;30;19;1;30;0;0;30;0;0;0
081500020;200;181;183;2;79;120;1;79;9;2;68;0;0;0
081500021;700;708;710;7;228;527;2;171;5;5;161;57;0;57
081500022;150;119;119;7;41;108;1;41;0;0;41;0;0;0
081500023;400;435;435;8;82;317;1;82;2;0;80;0;0;0
081500024;400;354;355;4;85;318;1;81;7;1;73;4;0;4
081500025;100;89;89;7;56;43;1;56;0;1;55;0;0;0
081500026;200;169;169;5;55;144;1;55;4;3;48;0;0;0
081500027;900;915;916;4;238;678;1;221;15;2;204;17;0;17
081500028;300;305;305;5;83;216;1;83;2;0;81;0;0;0
081500029;200;210;212;4;88;111;1;88;3;1;84;0;0;0
081500030;50;24;24;5;17;32;1;17;0;0;17;0;0;0
081500031;600;662;668;6;145;463;1;136;14;0;122;9;0;9
081500032;300;312;312;5;142;157;1;142;6;1;135;0;0;0
081500033;300;261;261;8;130;169;1;130;5;2;123;0;0;0
081500034;100;83;83;7;48;51;1;48;0;0;48;0;0;0
081500035;50;20;20;7;19;30;1;19;0;0;19;0;0;0
081500036;200;154;155;5;62;137;1;62;2;0;60;0;0;0
081500037;100;84;84;7;49;50;1;49;2;1;46;0;0;0
081500038;400;448;449;2;164;257;1;142;10;2;130;22;1;21
081500039;200;165;165;3;85;114;1;85;3;2;80;0;0;0
081500040;500;495;500;5;154;344;2;154;11;3;140;0;0;140
081500041;200;109;104;6;42;157;1;42;2;1;39;0;0;0
081500042;100;59;59;6;39;60;1;39;0;1;38;0;0;0
081500043;500;549;550;6;144;399;1;100;6;0;94;44;0;44
081500044;500;456;456;2;116;434;2;64;6;0;58;52;2;50
081500045;400;500;500;6;154;259;1;140;9;0;131;14;2;12
081500046;100;112;112;7;73;26;1;73;4;3;66;0;0;0
081500047;100;56;56;6;41;58;1;41;0;0;41;0;0;0
081500048;100;58;58;4;37;62;1;37;4;1;32;0;0;0
081500049;100;53;53;6;30;69;1;30;1;0;29;0;0;0
081500050;200;183;184;5;89;110;1;89;1;0;88;0;0;0
081500051;50;38;38;6;26;23;1;26;2;0;24;0;0;0
081500052;200;221;221;7;74;124;2;74;7;2;65;0;0;0
081500053;150;123;123;7;61;88;1;61;4;1;56;0;0;0
081500054;150;127;129;4;55;94;1;55;3;0;52;0;0;0
081500055;200;204;204;5;68;131;1;68;2;0;66;0;0;0
081500056;300;304;304;2;107;193;1;106;8;1;97;1;0;1
081500057;50;49;49;5;24;25;1;24;3;1;20;0;0;0
081500058;800;820;820;7;187;664;1;135;6;0;129;52;0;52
081500059;250;281;281;4;126;123;1;126;5;3;118;0;0;0
081500060;700;735;737;7;223;483;2;215;4;4;207;8;0;8
081500061;500;521;520;9;141;371;1;128;9;0;119;13;0;13
081500062;50;21;21;6;13;36;1;13;1;1;11;0;0;0
081500063;150;113;113;2;44;105;1;44;5;1;38;0;0;0
081500064;900;981;982;6;263;636;1;263;24;2;237;0;0;0
081500065;200;182;182;6;49;150;1;49;0;0;49;0;0;0
081500066;300;376;384;4;123;177;1;122;9;1;112;1;0;1
081500067;600;626;628;7;162;443;7;150;6;0;144;12;0;12
081500068;50;20;20;5;25;24;1;25;0;0;25;0;0;0
081700001;600;583;583;11;208;479;1;120;2;2;116;88;3;85
081700002;800;737;740;10;233;637;1;162;7;3;152;71;1;70
081700003;1000;942;946;8;177;839;5;156;14;2;140;21;1;20
081700004;1000;954;955;10;144;854;2;144;15;0;129;0;0;0
081700005;900;891;892;6;281;734;1;165;4;0;161;116;8;108
081700006;900;913;913;6;267;739;1;160;6;3;151;107;2;105
081700007;700;642;642;5;227;580;1;119;4;4;111;108;4;104
081700008;500;469;469;7;153;426;1;73;4;4;65;80;2;78
081700009;700;738;739;8;221;583;1;116;3;3;110;105;3;102
081700010;600;616;616;9;207;484;2;114;3;0;111;93;8;85
081700011;800;826;827;11;137;666;1;133;20;3;110;4;0;4
081700012;800;796;796;8;210;602;1;197;6;1;190;13;0;13
081700013;600;600;570;8;176;508;2;90;2;2;86;86;1;85
081700014;300;272;272;9;51;248;1;51;0;2;49;0;0;0
081700015;100;78;77;8;39;60;1;39;1;1;37;0;0;0
081700016;500;494;496;5;144;409;1;90;5;3;82;54;2;52
081700017;500;467;468;5;196;358;1;141;5;5;131;55;0;55
081700018;100;70;70;8;28;71;1;28;1;1;26;0;0;0
081700019;200;204;204;7;85;114;1;85;6;0;79;0;0;0
081700020;50;48;48;7;31;18;1;31;0;3;28;0;0;0
081700021;100;58;58;6;33;66;1;33;0;0;33;0;0;0
081700022;50;38;38;7;17;32;1;17;0;0;17;0;0;0
081700023;50;20;21;8;18;31;1;18;0;0;18;0;0;0
081700024;200;158;158;7;30;169;1;30;1;2;27;0;0;0
081700025;100;84;84;7;26;73;1;26;1;0;25;0;0;0
081700026;100;69;69;7;18;81;1;18;1;0;17;0;0;0
081700027;400;354;354;4;92;307;1;92;5;1;86;0;0;0
081700028;200;146;146;6;53;146;1;53;3;1;49;0;0;0
081700029;100;50;50;8;26;73;1;26;1;0;25;0;0;0
081700030;50;47;47;7;29;20;1;29;1;1;27;0;0;0
082000001;600;633;633;3;187;472;2;126;5;1;120;61;3;58
082000002;400;371;372;4;92;323;1;76;5;0;71;16;1;15
082000003;300;313;313;12;81;218;1;81;2;0;79;0;0;0
082000004;300;282;282;8;87;244;2;54;4;0;50;33;1;32
082000005;150;107;107;7;71;78;1;71;0;1;70;0;0;0
082000006;700;661;663;10;173;540;1;159;6;0;153;14;0;14
082000007;350;305;306;5;143;212;1;137;6;1;130;6;0;6
082000008;100;48;48;7;30;69;1;30;0;0;30;0;0;0
082000009;750;729;729;13;244;504;3;243;12;2;229;1;0;1
082000010;200;134;134;7;61;138;1;61;3;0;58;0;0;0
082000011;600;550;550;16;202;394;4;202;3;1;198;0;0;0
082000012;400;319;319;5;120;282;1;117;6;0;111;3;0;3
082000013;200;185;185;6;96;103;1;96;8;1;87;0;0;0
082000014;100;46;46;6;37;62;1;37;2;0;35;0;0;0
082000015;200;191;191;7;84;115;1;84;4;1;79;0;0;0
082000016;100;87;129;6;61;38;1;61;1;0;60;0;0;0
082000017;50;21;21;7;25;24;1;25;6;0;19;0;0;0
082700001;800;787;787;5;214;658;1;141;2;4;135;73;2;71
082700002;800;759;760;7;185;696;1;103;1;2;100;82;4;78
082700003;600;592;594;6;157;503;1;96;6;3;87;61;3;58
082700004;1400;1378;1378;6;241;1158;1;241;25;6;210;0;0;0
082700005;900;920;924;9;157;790;1;109;6;1;102;48;1;47
082700006;600;617;619;7;186;472;1;127;3;2;122;59;1;58
082700007;700;776;776;7;223;539;1;160;2;4;154;63;5;58
082700008;300;235;235;5;74;225;1;74;3;0;71;0;0;0
082700009;400;394;394;7;117;301;1;98;5;0;93;19;0;19
082700010;1000;1003;1003;4;239;779;1;220;15;0;205;19;0;19
082700011;800;735;735;7;158;650;1;149;4;1;144;9;0;9
082700012;1000;943;943;7;223;787;1;212;12;4;196;11;0;11
082700013;400;384;384;23;78;321;1;78;3;0;75;0;0;0
082700014;300;269;263;6;54;244;2;54;1;0;53;0;0;0
082700015;500;518;518;10;145;354;1;145;13;0;132;0;0;0
082700016;200;124;124;7;27;172;1;27;0;0;27;0;0;0
082700017;1400;767;1307;7;276;1149;1;250;7;0;243;26;2;24
082700018;1300;1224;1225;15;355;948;1;351;18;3;330;4;0;4
082700019;1300;1195;1195;18;383;925;1;374;21;3;350;9;0;9
082700020;600;582;583;6;180;419;1;180;16;0;164;0;0;0
082700021;100;67;67;7;36;63;1;36;0;2;34;0;0;0
082700022;700;651;651;6;151;549;1;150;10;1;139;1;0;1
082700023;200;159;159;4;70;129;1;70;1;0;69;0;0;0
082700024;300;268;268;5;115;184;1;115;7;3;105;0;0;0
082700025;100;37;37;7;18;81;1;18;2;0;16;0;0;0
082700026;1200;1269;1272;6;276;925;1;274;20;1;253;2;0;2
082700027;1000;1069;1069;10;262;747;19;234;18;1;215;28;0;28
082700028;400;373;375;7;99;303;1;96;1;0;95;3;0;3
082700029;800;821;821;8;185;616;1;183;2;2;179;2;0;2
082700030;300;228;228;4;72;227;1;72;6;0;66;0;0;0
082700031;400;407;407;3;104;296;1;103;2;2;99;1;0;1
082700032;100;23;23;6;28;71;1;28;0;0;28;0;0;0
082800001;500;547;548;8;137;415;1;84;5;1;78;53;1;52
082800002;500;613;614;5;153;402;1;97;2;2;93;56;0;56
082800003;500;519;521;6;152;405;3;92;3;2;87;60;3;57
082800004;500;539;541;9;171;387;1;112;6;0;106;59;1;58
082800005;500;637;638;9;217;395;1;104;1;3;100;113;7;106
082800006;500;967;1014;9;293;360;2;138;6;3;129;155;6;149
082800007;500;771;771;9;313;351;1;148;3;3;142;165;5;160
082800008;500;616;628;7;246;401;2;97;3;3;91;149;6;143
082800009;500;574;584;5;226;387;3;110;2;2;106;116;4;112
082800010;500;603;603;8;212;403;1;96;5;1;90;116;8;108
082800011;500;606;607;7;253;354;2;144;1;6;135;109;13;96
082800012;500;534;535;6;167;423;1;76;1;0;75;91;1;90
082800013;500;529;530;7;195;400;1;99;2;7;90;96;2;94
082800014;500;822;853;8;312;301;1;198;3;8;187;114;5;109
082800015;500;708;711;5;269;360;2;138;4;3;131;131;5;126
082800016;500;742;744;6;292;357;1;142;3;1;138;150;3;147
082800017;500;597;600;9;233;390;1;109;5;2;102;124;9;115
082800018;500;815;817;7;287;356;1;143;4;0;139;144;3;141
082800019;500;608;608;8;231;403;1;96;2;3;91;135;2;133
082800020;500;540;540;6;193;402;3;95;2;0;93;98;7;91
082800021;500;508;508;6;190;405;1;94;0;2;92;96;5;91
082800022;500;800;803;10;300;346;1;153;7;7;139;147;5;142
082800023;500;568;570;7;226;382;2;116;1;0;115;110;4;106
082800024;500;521;521;10;205;398;1;101;3;1;97;104;3;101
082800025;500;681;683;4;257;390;1;109;2;0;107;148;5;143
082800026;500;677;677;9;210;416;2;82;2;2;78;128;4;124
082800027;500;568;571;9;205;395;2;103;5;0;98;102;5;97
082800028;500;667;667;4;237;394;1;106;4;0;102;131;0;131
082800029;500;658;661;8;192;401;1;98;6;3;89;94;3;91
082800030;500;813;816;7;236;332;1;167;10;5;152;69;2;67
082800031;500;831;834;5;214;365;1;134;9;4;121;80;3;77
082800032;500;730;731;6;226;371;2;127;8;3;116;99;3;96
082800033;500;590;604;7;195;402;2;96;2;2;92;99;4;95
082800034;500;571;572;5;175;391;1;108;3;1;104;67;0;67
082800035;500;524;526;7;155;431;1;68;2;4;62;87;2;85
082800036;500;630;630;5;178;390;1;109;2;1;106;69;1;68
082800037;500;645;646;5;207;382;2;116;3;3;110;91;1;90
082800038;500;659;661;6;105;429;1;70;3;5;62;35;0;35
082800039;500;554;555;4;106;426;2;72;1;1;70;34;0;34
082800040;500;608;610;7;205;399;1;100;1;0;99;105;3;102
082800041;500;615;618;9;218;387;2;111;1;1;109;107;5;102
082800042;500;766;770;7;213;370;2;128;3;2;123;85;2;83
082800043;500;603;605;9;213;378;1;121;1;1;119;92;3;89
082800044;500;719;720;10;208;398;1;101;5;1;95;107;4;103
082800045;500;814;816;8;246;353;1;146;1;4;141;100;2;98
082800046;500;675;678;7;221;388;1;111;2;2;107;110;3;107
082800047;500;809;810;8;263;368;2;130;4;4;122;133;5;128
082800048;500;734;737;5;131;401;2;97;5;2;90;34;3;31
082800049;500;640;641;8;140;410;1;89;7;2;80;51;2;49
082800050;500;831;833;5;287;346;1;153;3;5;145;134;9;125
082800051;500;620;621;10;194;383;1;116;5;1;110;78;2;76
082800052;500;603;603;8;193;396;2;102;4;1;97;91;4;87
082800053;500;518;520;8;129;436;1;63;6;0;57;66;2;64
082800054;500;361;362;8;99;444;1;55;1;0;54;44;0;44
082800055;500;630;634;4;140;413;2;85;3;2;80;55;3;52
082800056;500;821;824;5;242;372;2;126;6;3;117;116;5;111
082800057;500;675;676;7;195;400;1;99;2;0;97;96;1;95
082800058;500;581;658;4;167;400;1;99;7;3;89;68;4;64
082800059;500;734;738;8;291;360;1;139;4;2;133;152;5;147
082800060;500;718;719;8;237;377;2;121;2;4;115;116;5;111
082800061;500;697;697;5;272;361;1;138;5;4;129;134;4;130
082800062;500;738;741;4;272;358;1;141;2;1;138;131;6;125
082800063;500;597;597;3;243;361;1;138;3;2;133;105;3;102
082800064;500;697;698;7;258;376;1;123;2;2;119;135;3;132
082800065;500;586;586;7;165;417;2;81;3;0;78;84;3;81
082800066;500;653;653;8;204;396;1;103;4;0;99;101;7;94
082800067;500;652;654;7;232;383;2;115;2;1;112;117;4;113
082800068;500;608;611;6;200;342;4;154;3;4;147;46;1;45
082800069;500;647;648;5;185;406;1;93;2;1;90;92;5;87
082800070;500;651;651;6;211;390;2;108;2;0;106;103;7;96
082800071;500;673;673;9;174;400;2;98;4;2;92;76;4;72
082800072;500;729;717;7;179;407;3;90;7;2;81;89;3;86
082800073;500;534;535;8;140;432;1;67;2;1;64;73;2;71
082800074;500;540;540;3;167;407;3;90;4;4;82;77;4;73
082800075;500;493;493;9;117;436;1;63;2;1;60;54;2;52
082800076;500;720;720;7;229;371;2;127;0;2;125;102;4;98
082800077;500;634;641;10;66;436;1;63;7;0;56;3;0;3
082800078;500;727;731;7;107;425;1;74;10;1;63;33;0;33
082800079;500;737;737;8;150;405;1;94;4;2;88;56;1;55
082800080;500;672;674;7;91;442;1;57;3;1;53;34;1;33
082800081;500;673;673;11;118;418;1;81;9;2;70;37;0;37
082800082;500;673;673;7;125;417;1;82;8;4;70;43;0;43
082800083;500;742;743;9;117;389;1;110;8;0;102;7;0;7
082800084;500;685;688;9;133;370;1;129;12;5;112;4;1;3
082800085;500;551;551;8;94;441;1;58;4;3;51;36;0;36
082800086;500;526;526;8;94;445;2;53;5;0;48;41;0;41
082800087;500;576;576;7;123;450;1;49;4;1;44;74;2;72
082800088;500;556;558;6;131;423;1;76;4;0;72;55;5;50
082800089;500;460;460;6;106;449;1;50;3;1;46;56;3;53
082800090;500;532;534;7;133;438;1;61;2;0;59;72;6;66
082800091;500;776;780;8;228;362;1;137;8;7;122;91;1;90
082800092;500;581;581;8;168;393;2;105;4;0;101;63;2;61
082800093;500;631;631;5;167;397;1;102;3;1;98;65;1;64
082800094;500;672;675;5;173;404;1;95;2;2;91;78;2;76
082800095;500;589;590;7;133;393;1;106;3;1;102;27;2;25
082800096;500;636;638;5;173;399;1;100;4;0;96;73;1;72
082800097;500;691;691;10;173;390;2;108;5;2;101;65;1;64
082800098;500;637;638;8;155;398;1;101;2;2;97;54;1;53
082800099;500;681;681;3;160;390;1;109;6;2;101;51;1;50
082800100;500;699;699;4;145;406;1;93;4;3;86;52;2;50
082800101;500;400;404;7;55;476;1;23;0;0;23;32;0;32
082800102;500;648;652;4;189;394;1;105;3;1;101;84;5;79
082800103;500;633;634;8;195;388;1;111;5;1;105;84;5;79
082800104;200;120;120;9;52;147;1;52;1;3;48;0;0;0
082800105;500;644;645;4;197;398;1;101;1;5;95;96;3;93
082800106;500;685;687;6;202;390;1;109;4;6;99;93;2;91
082800107;500;481;482;6;88;451;1;48;1;1;46;40;4;36
082800108;500;431;431;7;86;450;1;49;1;3;45;37;1;36
082800109;500;599;601;5;111;436;1;63;1;1;61;48;1;47
082800110;500;820;821;7;152;388;1;111;1;2;108;41;1;40
082800111;500;707;710;7;157;395;1;104;3;3;98;53;3;50
082800112;500;507;509;6;118;422;1;77;2;2;73;41;0;41
082800113;500;609;610;8;112;437;1;62;1;1;60;50;1;49
082800114;500;610;611;10;140;417;2;81;4;3;74;59;3;56
082800115;500;652;654;7;188;393;1;106;3;0;103;82;2;80
082800116;500;510;511;7;115;431;1;68;4;1;63;47;4;43
082800117;500;571;575;7;151;407;3;90;2;4;84;61;2;59
082800118;500;578;578;10;163;400;1;99;5;1;93;64;2;62
082800119;500;636;640;5;116;423;1;76;7;2;67;40;0;40
082800120;500;576;580;6;95;436;1;63;3;1;59;32;2;30
082800121;500;609;612;6;57;465;1;34;2;0;32;23;2;21
082800122;500;645;645;7;40;473;5;22;4;0;18;18;0;18
082800123;500;718;718;6;46;468;0;32;7;0;25;14;0;14
082800124;500;595;603;7;29;470;1;29;5;0;24;0;0;0
082800125;500;636;636;6;27;472;1;27;9;0;18;0;0;0
082800126;500;681;683;2;37;462;1;37;7;1;29;0;0;0
082800127;300;79;79;55;76;222;4;73;2;1;73;0;0;0
082800128;200;106;106;22;91;108;1;91;10;2;79;0;0;0
082800129;100;15;15;9;24;73;3;24;1;1;22;0;0;0
082800130;100;24;24;0;24;75;1;24;0;0;24;0;0;0
082900001;600;658;660;2;223;465;2;133;4;4;125;90;3;87
082900002;500;565;565;3;146;420;1;79;1;1;77;67;4;63
082900003;500;485;488;5;148;400;1;99;3;1;95;49;3;46
082900004;800;920;920;5;220;656;1;143;7;3;133;77;5;72
082900005;200;106;106;8;41;158;1;41;3;0;38;0;0;0
082900006;100;40;40;6;27;72;1;27;0;1;26;0;0;0
082900007;100;57;57;7;30;69;1;30;2;0;28;0;0;0
082900008;200;112;112;5;39;160;1;39;0;1;38;0;0;0
082900009;300;288;288;5;120;179;1;120;1;4;115;0;0;0
082900010;100;95;96;8;47;52;1;47;1;1;45;0;0;0
082900011;100;60;60;9;32;67;1;32;0;4;28;0;0;0
082900012;300;204;204;2;81;218;1;81;1;2;78;0;0;0
082900013;100;17;17;8;16;83;1;16;0;0;16;0;0;0
082900014;100;37;40;7;14;85;1;14;0;1;13;0;0;0
082900015;100;48;48;7;40;59;1;40;2;0;38;0;0;0
082900016;100;38;31;7;11;88;1;11;0;0;11;0;0;0
090200001;1800;1670;1691;1;368;1475;1;324;10;3;311;44;2;42
090200002;1900;1868;1896;1;425;1508;0;392;9;4;379;33;5;28
090200003;2100;2175;2197;7;479;1683;1;416;19;7;390;63;3;60
090200004;2000;1912;1941;3;363;1659;1;340;10;1;329;23;0;23
090200005;200;223;223;8;72;127;1;72;0;3;69;0;0;0
090200006;500;287;560;11;173;326;1;173;1;1;171;0;0;0
090200007;500;534;534;4;113;386;1;113;1;0;112;0;0;0
090200008;700;725;736;8;221;478;1;221;0;0;221;0;0;0
090200009;600;614;626;10;141;458;1;141;5;1;135;0;0;0
090200010;700;1167;1203;6;288;424;0;276;0;2;274;12;0;12
090200011;300;300;293;6;112;187;1;112;3;0;109;0;0;0
090200012;600;984;1000;17;228;369;3;228;13;4;211;0;0;0
090200013;500;526;532;8;116;382;2;116;11;1;104;0;0;0
090200014;800;785;785;7;128;670;2;128;14;2;112;0;0;0
090200015;500;553;585;8;230;271;1;228;4;0;224;2;0;2
090200016;400;368;374;6;100;299;1;100;4;0;96;0;0;0
090200017;300;347;352;6;81;218;1;81;1;0;80;0;0;0
090200018;100;112;112;7;46;53;1;46;1;0;45;0;0;0
090200019;200;173;173;4;77;123;0;77;1;3;73;0;0;0
090200020;800;782;782;3;250;561;2;237;6;3;228;13;0;13
090200021;200;199;200;8;79;121;0;79;0;0;79;0;0;0
090200022;300;289;301;6;85;214;1;85;5;1;79;0;0;0
090200023;200;205;205;5;61;138;1;61;1;1;59;0;0;0
090200024;600;553;557;8;81;518;1;81;1;1;79;0;0;0
090200025;181;35;181;5;40;141;0;40;0;0;40;0;0;0
090200026;200;155;155;10;46;152;2;46;1;1;44;0;0;0
090200027;1000;999;1010;9;208;792;0;208;12;1;195;0;0;0
090200028;700;727;727;8;277;431;1;268;11;8;249;9;1;8
090200029;400;389;389;6;121;277;2;121;1;0;120;0;0;0
090200030;200;148;153;8;69;130;1;69;2;0;67;0;0;0
090200031;700;697;700;9;153;546;1;153;1;0;152;0;0;0
090200032;100;107;107;5;74;24;2;74;1;1;72;0;0;0
090200033;400;393;393;6;72;327;1;72;1;0;71;0;0;0
090200034;200;157;158;3;57;143;0;57;5;2;50;0;0;0
090200035;100;43;43;6;42;57;1;42;0;0;42;0;0;0
090200036;200;192;196;6;60;139;1;60;1;0;59;0;0;0
090200037;100;74;75;3;54;45;1;54;1;0;53;0;0;0
090200038;300;285;289;7;81;218;1;81;0;0;81;0;0;0
090200039;500;491;498;8;118;381;1;118;4;0;114;0;0;0
090200040;900;795;816;11;139;760;1;139;7;0;132;0;0;0
090200041;200;51;210;7;51;148;1;51;0;0;51;0;0;0
090200042;400;336;336;5;75;325;3;72;2;0;70;3;0;3
090200043;200;245;245;4;62;137;1;62;5;0;57;0;0;0
090200044;300;260;260;19;88;210;2;88;0;1;87;0;0;0
090200045;200;177;177;6;47;152;1;47;0;0;47;0;0;0
090200046;200;212;212;4;55;144;1;55;1;0;54;0;0;0
090200047;200;193;196;5;50;150;0;50;1;1;48;0;0;0
090200048;300;243;246;7;68;231;1;68;6;0;62;0;0;0
090200049;100;51;103;6;37;61;2;37;1;0;36;0;0;0
090200050;100;96;96;0;95;5;0;95;0;0;95;0;0;0
090200051;100;65;65;0;63;37;0;63;0;0;63;0;0;0
090200052;100;35;35;0;34;66;0;34;0;0;34;0;0;0
090200053;100;42;42;0;40;60;0;40;0;0;40;0;0;0
090200054;100;48;48;0;48;52;0;48;0;0;48;0;0;0
090200055;100;33;33;0;30;70;0;30;0;0;30;0;0;0
090200056;100;73;73;1;74;26;0;74;0;0;74;0;0;0
090200057;100;29;29;0;29;71;0;29;0;0;29;0;0;0
090200058;100;41;41;0;41;59;0;41;0;2;39;0;0;0
090800001;2400;2445;2449;6;568;1863;1;536;32;3;501;32;0;32
090800002;1300;1272;1273;13;348;951;1;348;0;0;348;0;0;0
090800003;650;625;625;8;224;446;1;203;1;3;199;21;1;20
090800004;1700;1627;1631;6;452;1306;1;393;24;3;366;59;1;58
090800005;500;453;455;7;133;490;1;9;0;0;9;124;0;124
090800006;550;540;541;13;104;445;1;104;10;0;94;0;0;0
090800007;550;542;542;6;115;506;1;43;0;0;43;72;0;72
090800008;200;198;198;7;70;129;1;70;7;1;62;0;0;0
090800009;500;481;482;5;156;345;1;154;2;2;150;2;0;2
090800010;400;413;416;4;115;368;1;31;0;1;30;84;0;84
090800011;300;283;283;6;83;216;1;83;0;0;83;0;0;0
090800012;200;216;216;9;42;157;1;42;3;0;39;0;0;0
090800013;600;559;561;7;115;484;1;115;2;2;111;0;0;0
090800014;400;430;430;4;133;397;1;2;0;0;2;131;0;131
090800015;400;353;353;5;103;345;0;55;0;0;55;48;0;48
090800016;500;451;451;2;81;500;0;0;0;0;0;81;0;81
090800017;600;618;619;9;131;467;2;131;1;0;130;0;0;0
090800018;650;636;636;8;114;611;1;38;1;0;37;76;0;76
090800019;850;827;831;5;266;583;1;266;0;0;266;0;0;0
090800020;700;659;661;8;188;699;1;0;0;0;0;188;0;188
090800021;1000;1015;1026;6;237;762;1;237;1;0;236;0;0;0
090800022;550;129;550;12;141;547;1;2;0;0;2;139;0;139
090800023;850;855;856;8;213;637;1;212;0;3;209;1;0;1
090800024;250;53;239;9;53;193;4;53;3;0;50;0;0;0
090800025;300;303;303;4;76;223;1;76;1;0;75;0;0;0
090800026;400;123;414;3;72;328;0;72;0;2;70;0;0;0
090800027;300;272;272;4;56;243;1;56;0;0;56;0;0;0
090800028;100;80;80;3;43;56;1;43;0;0;43;0;0;0
090800029;200;219;219;8;38;161;1;38;1;0;37;0;0;0
090800030;700;689;689;5;273;591;2;107;7;1;99;166;2;164
090800031;500;466;466;4;64;465;1;34;0;0;34;30;0;30
090800032;800;815;815;4;160;799;1;0;0;0;0;160;1;159
090800033;700;709;709;8;151;655;1;44;0;0;44;107;0;107
090800034;400;387;387;6;102;399;1;0;0;0;0;102;0;102
090800035;400;391;393;5;103;302;1;97;2;0;95;6;0;6
090800036;150;159;152;7;30;119;1;30;1;0;29;0;0;0
090800037;1200;1203;1203;6;125;1075;1;124;0;0;124;1;0;1
090800038;450;129;432;4;133;450;0;0;0;0;0;133;1;132
090800039;300;293;293;7;104;195;1;104;1;0;103;0;0;0
090800040;300;266;266;6;71;228;1;71;0;0;71;0;0;0
090800041;200;208;208;7;60;140;0;60;1;0;59;0;0;0
090800042;200;198;198;6;64;134;2;64;0;1;63;0;0;0
090800043;300;263;263;11;86;213;1;86;1;0;85;0;0;0
090800044;400;364;364;3;89;310;1;89;3;0;86;0;0;0
090800045;100;44;44;0;44;55;1;44;0;1;43;0;0;0
091400001;700;637;637;3;246;527;1;172;2;3;167;74;2;72
091400002;500;418;418;0;198;339;2;159;8;2;149;39;2;37
091400003;400;363;365;2;131;295;0;105;3;1;101;26;0;26
091400004;100;94;94;4;78;21;1;78;3;1;74;0;0;0
091400005;200;144;150;0;119;80;1;119;0;0;119;0;0;0
091400006;300;279;279;3;135;164;1;135;6;1;128;0;0;0
091400007;300;265;265;3;141;158;1;141;5;1;135;0;0;0
091400008;200;112;112;0;78;121;1;78;0;1;77;0;0;0
091400009;300;295;311;6;90;210;0;90;2;1;87;0;0;0
091400010;400;324;324;8;196;203;1;196;6;1;189;0;0;0
091400011;500;445;450;3;190;333;1;166;13;0;153;24;1;23
091400012;700;643;655;5;326;390;1;309;6;2;301;17;1;16
091400013;100;86;86;0;72;27;1;72;2;0;70;0;0;0
091400014;300;260;260;0;132;167;1;132;1;2;129;0;0;0
091400015;100;40;50;2;40;59;1;40;0;3;37;0;0;0
091400016;300;250;250;0;111;188;1;111;8;6;97;0;0;0
091400017;300;241;241;1;120;179;1;120;6;0;114;0;0;0
091400018;700;1057;1058;0;218;545;1;154;8;1;145;64;5;59
091400019;600;871;871;1;192;405;18;177;17;3;157;15;0;15
091400020;600;982;982;3;225;377;1;222;25;0;197;3;0;3
091400021;400;1062;1064;10;185;214;1;185;15;0;170;0;0;0
091400022;500;1388;1389;4;300;199;1;300;6;3;291;0;0;0
091400023;400;584;584;4;118;399;1;0;0;0;0;118;0;118
091400024;200;301;301;6;65;134;1;65;2;0;63;0;0;0
091400025;200;266;266;10;75;123;2;75;7;0;68;0;0;0
091400026;300;651;651;0;148;152;1;147;6;0;141;1;0;1
091400027;300;262;264;3;76;223;1;76;8;0;68;0;0;0
091400028;500;1220;1220;1;220;279;1;220;13;0;207;0;0;0
091400029;400;1048;1051;4;243;329;1;70;0;0;70;173;1;172
091400030;300;384;385;3;119;254;1;45;0;0;45;74;0;74
091400031;400;357;808;8;200;200;1;199;3;0;196;1;0;1
091400032;400;653;661;5;164;350;2;48;7;0;41;116;2;114
091400033;399;232;685;5;236;160;3;236;2;1;233;0;0;0
091400034;500;498;504;1;143;386;1;113;4;1;108;30;0;30
091400035;400;329;334;1;72;341;1;58;1;0;57;14;0;14
091400036;300;490;490;5;132;167;1;132;15;0;117;0;0;0
091400037;400;949;952;6;161;366;1;33;0;0;33;128;0;128
091400038;400;742;753;4;144;255;1;144;7;1;136;0;0;0
091400039;300;454;454;3;99;300;0;0;0;0;0;99;1;98
091400040;400;688;688;4;190;399;1;0;0;0;0;190;0;190
091400041;200;211;390;2;89;116;0;84;3;0;81;5;1;4
091400042;500;1389;1400;4;357;443;1;56;0;0;56;301;5;296
091400043;500;978;987;8;261;470;1;29;2;0;27;232;1;231
091400044;300;481;481;6;129;170;1;129;2;0;127;0;0;0
091400045;400;667;669;8;189;377;1;22;0;1;21;167;0;167
091400046;400;740;744;8;213;185;2;213;6;3;204;0;0;0
091400047;400;785;785;8;189;352;1;47;0;0;47;142;1;141
091400048;400;668;668;3;163;237;1;162;5;0;157;1;0;1
091400049;200;181;182;0;63;136;1;63;0;1;62;0;0;0
091400050;100;106;106;7;53;46;1;53;0;0;53;0;0;0
091400051;300;275;275;5;137;162;1;137;1;0;136;0;0;0
091400052;300;286;286;3;76;223;1;76;0;0;76;0;0;0
091400053;200;205;205;4;56;143;1;56;0;0;56;0;0;0
091400054;200;228;228;2;77;122;1;77;2;0;75;0;0;0
091400055;200;367;367;7;97;184;0;16;1;0;15;81;0;81
091400056;400;505;511;6;146;248;6;146;3;2;141;0;0;0
091400057;600;907;933;1;250;356;5;239;19;7;213;11;2;9
091400058;400;579;587;4;170;229;1;170;7;1;162;0;0;0
091400059;100;65;136;2;65;35;0;65;0;0;65;0;0;0
091400060;500;749;769;1;201;298;1;201;3;1;197;0;0;0
091400061;200;146;143;3;64;135;1;64;0;2;62;0;0;0
091400062;100;102;102;2;51;48;1;51;1;1;49;0;0;0
091400063;200;188;188;7;87;112;1;87;1;1;85;0;0;0
091400064;200;248;248;4;115;84;1;115;0;0;115;0;0;0
091400065;500;474;475;2;151;375;0;125;5;2;118;26;3;23
091400066;500;491;492;0;133;379;1;120;3;3;114;13;0;13
091400067;400;424;426;4;170;232;2;166;4;0;162;4;0;4
091400068;200;162;355;76;82;117;1;82;5;1;76;0;0;0
091400069;200;381;380;1;73;126;1;73;9;0;64;0;0;0
091400070;200;320;320;10;83;178;1;21;0;0;21;62;0;62
091400071;200;251;251;2;72;127;1;72;0;0;72;0;0;0
091400072;200;332;323;0;80;119;1;80;0;0;80;0;0;0
091400073;200;197;197;0;46;153;1;46;0;0;46;0;0;0
091400074;200;329;329;5;78;122;1;77;3;0;74;1;0;1
091400075;200;270;270;3;78;121;1;78;1;0;77;0;0;0
091400076;300;261;261;6;65;235;0;65;3;0;62;0;0;0
091400077;100;36;36;0;36;64;0;36;1;0;35;0;0;0
091400078;100;71;71;0;67;33;0;67;0;0;67;0;0;0
091400079;100;34;34;0;33;67;0;33;0;0;33;0;0;0
091400080;100;44;44;0;43;57;0;43;0;0;43;0;0;0
091500001;1000;1134;1142;3;342;721;1;278;14;7;257;64;4;60
091500002;1000;1268;1274;4;357;747;1;252;12;3;237;104;10;94
091500003;1000;783;787;3;217;850;1;149;6;1;142;68;3;65
091500004;1000;987;995;8;249;816;1;183;6;5;172;66;0;66
091500005;1000;1282;1285;7;266;784;1;215;8;8;199;51;4;47
091500006;1000;1142;1152;8;299;701;1;298;12;6;280;1;0;1
091500007;500;463;464;12;114;385;1;114;9;2;103;0;0;0
091500008;500;435;436;4;94;404;2;94;5;0;89;0;0;0
091500009;1000;1071;1077;20;240;762;1;237;9;3;225;3;0;3
091500010;400;317;318;6;77;322;1;77;0;0;77;0;0;0
091500011;1000;1190;1201;13;349;649;2;349;20;5;324;0;0;0
091500012;500;419;419;10;119;380;1;119;5;0;114;0;0;0
091500013;600;606;616;5;200;399;1;200;4;0;196;0;0;0
091500014;1000;1369;1394;20;445;554;1;445;20;10;415;0;0;0
091500015;300;197;197;5;44;255;1;44;1;1;42;0;0;0
091500016;300;251;253;8;101;197;2;101;1;0;100;0;0;0
091500017;500;480;485;8;97;402;1;97;2;1;94;0;0;0
091500018;300;234;234;8;58;241;1;58;3;0;55;0;0;0
091500019;300;300;260;10;71;228;1;71;0;2;69;0;0;0
091500020;600;725;725;12;151;448;1;151;11;0;140;0;0;0
091500021;600;252;521;9;190;409;1;190;0;2;188;0;0;0
091500022;500;477;477;6;217;281;2;217;2;3;212;0;0;0
091500023;500;525;525;13;144;355;1;144;4;2;138;0;0;0
091500024;200;141;143;9;39;159;2;39;1;0;38;0;0;0
091500025;200;188;188;5;67;132;1;67;1;2;64;0;0;0
091500026;600;542;544;15;177;422;1;177;2;0;175;0;0;0
091500027;800;790;804;12;185;618;1;181;11;1;169;4;0;4
091500028;300;229;229;6;59;240;1;59;0;2;57;0;0;0
091500029;300;79;286;7;79;220;1;79;2;0;77;0;0;0
091500030;700;736;742;13;176;523;1;176;10;0;166;0;0;0
091500031;200;181;181;9;45;154;1;45;0;0;45;0;0;0
091500032;200;128;137;7;34;165;1;34;0;0;34;0;0;0
091500033;600;485;485;7;86;513;1;86;0;2;84;0;0;0
091500034;600;608;608;4;169;430;1;169;0;0;169;0;0;0
091500035;700;195;654;9;195;504;1;195;1;0;194;0;0;0
091500036;1000;1051;1061;14;220;777;4;219;0;2;217;1;0;1
091500037;200;148;148;7;54;145;1;54;0;0;54;0;0;0
091500038;400;329;329;12;76;322;2;76;4;1;71;0;0;0
091500039;400;338;338;10;63;336;1;63;1;0;62;0;0;0
091500040;250;225;225;7;57;192;1;57;1;0;56;0;0;0
091500041;250;192;192;8;39;209;2;39;0;1;38;0;0;0
091500042;600;564;568;11;276;322;2;276;1;0;275;0;0;0
091500043;600;609;624;7;278;322;1;277;5;4;268;1;0;1
091500044;200;153;154;6;82;117;1;82;0;0;82;0;0;0
091500045;200;180;180;9;69;130;1;69;0;2;67;0;0;0
091500046;200;119;119;7;23;176;1;23;0;0;23;0;0;0
091500047;1000;1035;1057;11;235;763;2;235;10;0;225;0;0;0
091500048;500;472;476;15;113;385;2;113;2;0;111;0;0;0
091500049;700;621;624;9;126;573;1;126;2;1;123;0;0;0
091500050;300;256;256;5;49;250;1;49;0;2;47;0;0;0
091500051;200;190;190;8;49;150;1;49;0;0;49;0;0;0
091500052;700;687;695;13;164;536;1;163;3;0;160;1;0;1
091500053;300;258;259;8;61;238;1;61;0;0;61;0;0;0
091500054;400;386;386;19;91;399;1;0;0;0;0;91;0;91
091500055;400;354;354;11;75;324;1;75;5;0;70;0;0;0
091500056;200;123;123;7;42;157;1;42;2;2;38;0;0;0
091500057;300;292;298;1;102;206;1;93;1;3;89;9;1;8
091500058;200;192;192;2;127;72;1;127;6;0;121;0;0;0
091500059;300;230;233;2;96;203;1;96;2;0;94;0;0;0
091500060;100;78;81;6;52;47;1;52;0;0;52;0;0;0
091500061;100;26;39;6;32;66;2;32;0;1;31;0;0;0
091500062;100;40;40;6;45;54;1;45;0;0;45;0;0;0
091500063;400;385;404;1;195;210;1;189;3;7;179;6;0;6
091500064;250;220;221;2;98;150;2;98;3;2;93;0;0;0
091500065;300;266;266;7;45;254;1;45;2;0;43;0;0;0
091500066;200;37;135;3;27;172;1;27;1;0;26;0;0;0
091500067;400;338;338;7;29;371;0;29;0;0;29;0;0;0
091500068;100;75;75;5;56;43;1;56;1;0;55;0;0;0
091500069;500;480;481;6;192;309;2;189;14;1;174;3;1;2
091500070;500;442;442;7;189;309;2;189;4;4;181;0;0;0
091500071;400;337;337;8;78;321;1;78;1;0;77;0;0;0
091500072;200;125;125;8;42;156;2;42;1;0;41;0;0;0
091500073;200;135;135;4;26;173;1;26;0;0;26;0;0;0
091500074;100;77;77;7;14;85;1;14;0;0;14;0;0;0
091500075;200;151;151;8;62;137;1;62;3;1;58;0;0;0
091500076;400;424;429;4;102;297;1;102;4;0;98;0;0;0
091500077;300;222;222;6;36;263;1;36;0;0;36;0;0;0
091500078;100;80;80;4;11;88;1;11;0;0;11;0;0;0
091500079;50;34;34;8;25;24;1;25;3;1;21;0;0;0
091500080;100;55;55;1;54;46;0;54;0;0;54;0;0;0
091500081;50;31;31;1;32;16;2;32;0;0;32;0;0;0
091500082;50;37;37;1;38;10;2;38;0;1;37;0;0;0
091500083;50;34;34;0;33;17;0;33;0;0;33;0;0;0
091500084;50;28;28;0;28;22;0;28;0;0;28;0;0;0
091500085;100;47;47;0;46;54;0;46;0;0;46;0;0;0
091500086;100;39;39;0;38;62;0;38;0;0;38;0;0;0
091600001;900;842;842;7;166;800;1;99;7;5;87;67;3;64
091600002;1000;1153;1153;9;149;869;1;130;7;1;122;19;0;19
091600003;800;809;809;8;130;701;4;95;4;0;91;35;0;35
091600004;800;817;818;6;146;704;1;95;9;2;84;51;1;50
091600005;500;474;474;7;134;431;1;68;3;0;65;66;4;62
091600006;900;903;897;6;136;763;1;136;25;1;110;0;0;0
091600007;717;717;732;6;116;600;1;116;16;0;100;0;0;0
091600008;800;821;822;7;136;670;1;129;14;0;115;7;0;7
091600009;600;647;647;12;103;512;1;87;14;1;72;16;0;16
091600010;400;380;380;5;87;354;1;44;1;0;43;43;0;43
091600011;900;1006;1006;7;285;737;1;162;5;6;151;123;0;123
091600012;800;759;762;5;241;669;2;129;4;4;121;112;7;105
091600013;800;785;785;7;251;681;1;118;1;4;113;133;8;125
091600014;600;572;575;6;186;505;1;94;3;6;85;92;0;92
091600015;600;560;565;10;216;489;1;110;4;4;102;106;3;103
091600016;600;571;571;12;151;507;1;92;5;1;86;59;2;57
091600017;500;460;460;6;155;386;4;110;6;5;99;45;4;41
091600018;700;713;718;10;249;536;1;163;4;5;154;86;6;80
091600019;600;551;554;9;205;498;1;101;0;3;98;104;5;99
091600020;900;941;941;6;290;730;1;169;1;3;165;121;4;117
091600021;700;672;673;4;199;591;3;106;3;1;102;93;5;88
091600022;600;617;618;7;193;483;4;113;2;4;107;80;3;77
091600023;600;193;623;8;200;503;2;95;2;2;91;105;1;104
091600024;700;652;652;7;189;601;5;94;5;2;87;95;5;90
091600025;600;623;623;4;167;515;1;84;4;4;76;83;4;79
091600026;700;636;638;8;154;620;1;79;3;6;70;75;4;71
091600027;500;520;521;8;174;407;1;92;1;2;89;82;6;76
091600028;700;643;645;5;176;601;2;97;2;1;94;79;6;73
091600029;500;479;479;6;153;413;1;86;1;1;84;67;8;59
091600030;700;635;639;12;143;615;1;84;4;0;80;59;4;55
091600031;700;707;711;8;153;615;1;84;5;3;76;69;0;69
091600032;600;554;557;8;138;522;1;77;3;1;73;61;5;56
091600033;600;599;601;7;157;493;1;106;3;8;95;51;2;49
091600034;600;604;606;7;145;523;5;72;5;3;64;73;2;71
091600035;700;640;642;5;127;628;1;71;1;2;68;56;3;53
091600036;400;394;394;9;129;314;1;85;3;4;78;44;2;42
091600037;400;433;433;5;128;334;1;65;4;2;59;63;10;53
091600038;600;585;582;4;162;500;1;99;4;5;90;63;6;57
091600039;600;590;593;4;144;517;1;82;5;1;76;62;3;59
091600040;700;694;694;7;149;603;3;94;2;1;91;55;3;52
091600041;600;549;550;8;145;500;1;99;5;2;92;46;5;41
091600042;900;870;870;11;207;758;1;141;5;8;128;66;0;66
091600043;1058;1055;1058;9;207;896;2;160;11;3;146;47;5;42
091600044;900;882;882;8;234;721;1;178;6;9;163;56;2;54
091600045;1000;993;997;6;210;841;1;158;6;5;147;52;3;49
091600046;1000;1023;1024;5;239;797;1;202;17;4;181;37;3;34
091600047;1000;932;934;7;218;872;1;127;1;5;121;91;4;87
091600048;900;987;988;4;219;733;2;165;8;5;152;54;3;51
091600049;900;850;852;7;176;789;1;110;5;1;104;66;3;63
091600050;900;870;871;2;189;763;7;130;6;5;119;59;4;55
091600051;900;973;973;1;208;776;1;123;4;2;117;85;2;83
091600052;1000;965;965;7;243;830;1;169;5;7;157;74;6;68
091600053;800;751;753;6;178;670;1;129;12;2;115;49;4;45
091600054;1001;958;959;5;211;839;1;161;8;3;150;50;0;50
091600055;1000;1044;1044;9;162;893;1;106;3;1;102;56;2;54
091600056;800;786;787;5;171;692;1;107;4;2;101;64;0;64
091600057;800;766;766;7;124;715;4;81;4;2;75;43;4;39
091600058;1000;949;950;5;177;873;1;126;5;4;117;51;5;46
091600059;1000;1052;1054;5;180;860;1;139;6;1;132;41;5;36
091600060;1000;956;957;9;154;890;2;108;6;2;100;46;1;45
091600061;900;904;905;8;154;749;14;137;13;2;122;17;0;17
091600062;900;988;988;11;195;720;14;166;12;0;154;29;0;29
091600063;900;874;875;10;214;695;1;204;14;6;184;10;0;10
091600064;1000;969;976;9;313;806;9;185;9;3;173;128;2;126
091600065;900;897;900;10;215;687;2;211;14;5;192;4;1;3
091600066;700;638;657;6;154;558;3;139;6;3;130;15;2;13
091600067;700;708;708;6;164;535;1;164;16;0;148;0;0;0
091600068;500;534;535;10;173;326;1;173;12;0;161;0;0;0
091600069;800;820;823;9;169;630;1;169;15;1;153;0;0;0
091600070;300;262;262;6;80;219;1;80;2;1;77;0;0;0
091600071;300;329;334;9;68;231;1;68;0;0;68;0;0;0
091600072;600;629;631;10;169;430;1;169;15;2;152;0;0;0
091600073;900;898;897;16;251;687;1;212;16;3;193;39;0;39
091600074;300;279;282;8;85;213;2;85;1;0;84;0;0;0
091600075;700;657;659;10;170;529;1;170;11;3;156;0;0;0
091600076;500;500;501;13;181;318;1;181;4;0;177;0;0;0
091600077;900;888;903;14;174;729;4;167;10;1;156;7;1;6
091600078;300;314;314;8;102;197;1;102;2;1;99;0;0;0
091600079;400;476;476;7;153;244;3;153;8;2;143;0;0;0
091600080;800;367;749;8;181;624;1;175;0;1;174;6;1;5
091600081;500;533;544;11;180;319;1;180;9;2;169;0;0;0
091600082;400;438;438;6;132;260;8;132;10;3;119;0;0;0
091600083;500;505;512;10;191;308;1;191;4;2;185;0;0;0
091600084;400;422;438;11;160;239;1;160;3;1;156;0;0;0
091600085;300;257;257;9;106;192;2;106;0;0;106;0;0;0
091600086;300;277;278;5;85;214;1;85;5;2;78;0;0;0
091600087;150;118;118;7;57;92;1;57;2;0;55;0;0;0
091600088;300;293;293;8;107;192;1;107;5;1;101;0;0;0
091600089;400;402;402;8;100;299;1;100;2;0;98;0;0;0
091600090;600;660;660;9;208;407;1;192;6;3;183;16;0;16
091600091;400;456;456;7;155;243;2;155;11;3;141;0;0;0
091600092;400;420;421;14;177;225;1;174;6;0;168;3;0;3
091600093;700;704;709;11;180;519;2;179;11;2;166;1;0;1
091600094;700;717;719;11;172;527;1;172;9;0;163;0;0;0
091600095;500;530;518;7;157;340;3;157;5;2;150;0;0;0
091600096;800;762;762;7;257;542;1;257;10;0;247;0;0;0
091600097;600;558;569;11;177;422;1;177;4;2;171;0;0;0
091600098;500;514;514;17;200;299;1;200;8;1;191;0;0;0
091600099;700;713;713;8;255;447;1;252;11;1;240;3;0;3
091600100;300;286;287;7;108;191;1;108;5;0;103;0;0;0
091600101;400;419;428;7;114;285;1;114;0;0;114;0;0;0
091600102;1000;969;984;9;253;746;1;253;19;3;231;0;0;0
091600103;200;183;188;7;71;128;1;71;1;1;69;0;0;0
091600104;800;756;768;6;210;589;1;210;11;2;197;0;0;0
091600105;900;859;859;10;198;702;1;197;1;1;195;1;0;1
091600106;1000;930;942;22;249;749;2;249;12;3;234;0;0;0
091600107;700;750;754;11;235;468;1;231;11;0;220;4;0;4
091600108;800;759;759;12;212;587;1;212;7;2;203;0;0;0
091600109;400;393;395;8;115;278;7;115;7;0;108;0;0;0
091600110;500;513;514;7;169;332;1;167;0;2;165;2;0;2
091600111;400;406;407;10;144;255;1;144;1;0;143;0;0;0
091600112;1000;947;948;9;200;803;1;196;16;2;178;4;0;4
091600113;600;599;599;9;242;357;1;242;1;0;241;0;0;0
091600114;600;566;574;5;167;432;1;167;8;3;156;0;0;0
091600115;500;102;493;13;102;397;1;102;15;2;85;0;0;0
091600116;300;339;339;9;104;195;1;104;0;0;104;0;0;0
091600117;1000;995;995;21;289;709;2;289;1;0;288;0;0;0
091600118;1000;1080;1084;10;199;799;2;199;16;3;180;0;0;0
091600119;400;393;394;8;135;263;2;135;4;3;128;0;0;0
091600120;900;992;992;8;183;716;1;183;9;2;172;0;0;0
091600121;500;445;446;12;141;356;3;141;8;0;133;0;0;0
091600122;600;631;625;10;148;451;1;148;3;1;144;0;0;0
091600123;200;165;166;7;60;139;1;60;0;1;59;0;0;0
091600124;700;721;721;11;164;531;5;164;13;4;147;0;0;0
091600125;300;375;360;7;107;192;1;107;4;0;103;0;0;0
091600126;400;465;465;11;186;388;1;11;0;0;11;175;1;174
091600127;800;734;746;6;157;674;1;125;11;2;112;32;0;32
091600128;900;825;835;9;206;689;11;200;11;2;187;6;0;6
091600129;1000;1053;1053;6;223;766;11;223;11;4;208;0;0;0
091600130;900;826;839;10;181;731;1;168;15;2;151;13;0;13
091600131;700;676;678;9;203;496;1;203;6;2;195;0;0;0
091600132;900;888;899;12;272;625;3;272;13;4;255;0;0;0
091600133;900;816;818;9;178;751;1;148;9;0;139;30;0;30
091600134;300;273;277;9;86;205;9;86;8;1;77;0;0;0
091600135;500;373;373;6;90;449;1;50;2;3;45;40;0;40
091600136;600;525;527;5;103;531;1;68;2;1;65;35;2;33
091600137;800;771;771;3;148;714;1;85;3;1;81;63;4;59
091600138;1000;1142;1143;5;235;865;1;134;8;6;120;101;2;99
091600139;700;695;695;3;140;627;1;72;5;2;65;68;6;62
091600140;800;780;780;9;196;603;8;189;7;0;182;7;1;6
091600141;300;254;255;10;78;221;1;78;1;2;75;0;0;0
091600142;400;384;384;6;137;262;1;137;5;2;130;0;0;0
091600143;300;300;363;9;104;195;1;104;6;1;97;0;0;0
091600144;400;428;436;5;95;304;1;95;2;0;93;0;0;0
091600145;400;374;386;6;105;294;1;105;2;1;102;0;0;0
091600146;400;379;379;7;138;263;1;136;9;3;124;2;0;2
091600147;400;413;413;12;143;256;1;143;2;0;141;0;0;0
091600148;500;523;527;12;178;320;2;178;2;2;174;0;0;0
091600149;400;350;352;8;154;398;2;0;0;0;0;154;1;153
091600150;300;328;336;0;114;181;5;114;9;0;105;0;0;0
091600151;300;224;227;7;85;214;1;85;2;0;83;0;0;0
091600152;300;328;328;8;107;192;1;107;1;0;106;0;0;0
091600153;700;637;637;10;118;581;1;118;6;1;111;0;0;0
091600154;250;257;257;9;106;140;4;106;3;0;103;0;0;0
091600155;400;358;360;6;79;325;1;74;4;1;69;5;0;5
091600156;250;237;237;10;98;147;5;98;4;0;94;0;0;0
091600157;150;136;138;7;57;92;1;57;1;0;56;0;0;0
091600158;200;42;42;34;54;145;1;54;2;0;52;0;0;0
091600159;200;135;135;8;67;132;1;67;9;2;56;0;0;0
091600160;50;36;36;0;36;14;0;36;0;0;36;0;0;0
091600161;100;57;57;7;60;40;0;60;0;2;58;0;0;0
091600162;100;48;48;6;54;46;0;54;0;0;54;0;0;0
091600163;50;27;27;8;34;15;1;34;0;0;34;0;0;0
091600164;50;38;38;8;38;11;1;38;0;1;37;0;0;0
091600165;50;25;25;7;32;17;1;32;1;0;31;0;0;0
091600166;50;25;25;6;29;21;0;29;1;0;28;0;0;0
091600167;100;58;58;7;63;36;1;63;0;0;63;0;0;0
091600168;100;73;73;6;78;22;0;78;4;1;73;0;0;0
091600169;100;42;42;5;46;54;0;46;3;0;43;0;0;0
092100001;500;856;1179;9;296;230;1;269;5;6;258;27;0;27
092100002;500;1325;1338;2;273;263;1;236;3;7;226;37;2;35
092100003;400;961;977;7;224;186;7;207;6;3;198;17;0;17
092100004;500;1051;1063;5;239;308;1;191;10;5;176;48;3;45
092100005;500;1167;1183;9;287;272;1;227;6;1;220;60;0;60
092100006;500;1333;1348;12;277;241;1;258;22;7;229;19;0;19
092100007;600;822;1576;9;312;349;1;250;20;3;227;62;5;57
092100008;600;1379;1392;4;293;386;2;212;8;1;203;81;0;81
092100009;500;986;991;4;229;328;1;171;11;3;157;58;4;54
092100010;500;1167;1167;5;258;272;1;227;3;1;223;31;1;30
092100011;600;817;1383;6;341;264;1;335;12;8;315;6;1;5
092100012;200;90;188;8;74;125;1;74;0;1;73;0;0;0
092100013;600;1086;1126;11;340;258;2;340;7;3;330;0;0;0
092100014;200;243;248;6;81;118;1;81;4;0;77;0;0;0
092100015;100;75;75;7;44;55;1;44;1;1;42;0;0;0
092100016;200;316;316;5;86;113;1;86;0;0;86;0;0;0
092100017;200;399;400;8;90;121;3;76;0;0;76;14;3;11
092100018;200;517;517;8;156;41;4;155;6;1;148;1;0;1
092100019;100;222;223;7;55;44;1;55;0;0;55;0;0;0
092100020;200;305;319;12;106;95;1;104;1;0;103;2;0;2
092100021;300;687;687;5;144;154;2;144;13;5;126;0;0;0
092100022;100;67;67;7;27;72;1;27;0;0;27;0;0;0
092100023;100;147;153;7;58;41;1;58;0;0;58;0;0;0
092100024;300;426;429;9;140;156;4;140;4;1;135;0;0;0
092100025;300;590;608;11;167;157;2;141;9;1;131;26;0;26
092100026;300;505;514;11;170;130;1;169;11;3;155;1;0;1
092100027;200;304;306;10;114;189;1;10;0;0;10;104;0;104
092100028;100;97;100;5;47;49;4;47;3;0;44;0;0;0
092100029;400;996;1008;7;235;166;1;233;6;5;222;2;0;2
092100030;100;262;262;10;59;40;1;59;1;1;57;0;0;0
092100031;100;56;56;8;25;74;1;25;0;0;25;0;0;0
092100033;300;434;449;10;137;160;3;137;1;0;136;0;0;0
092100034;400;1074;1026;11;261;140;1;259;7;2;250;2;0;2
092100035;200;357;357;7;120;79;1;120;1;0;119;0;0;0
092100036;200;511;515;11;154;45;1;154;8;1;145;0;0;0
092100037;300;620;631;16;179;121;0;179;2;0;177;0;0;0
092100038;300;500;510;11;135;164;1;135;6;1;128;0;0;0
092100039;200;183;185;5;73;126;1;73;2;0;71;0;0;0
092100040;300;751;763;8;161;138;1;161;5;0;156;0;0;0
092100041;100;101;103;5;38;60;2;38;1;0;37;0;0;0
092100042;200;112;119;7;57;142;1;57;1;0;56;0;0;0
092100043;300;817;828;8;171;129;2;169;4;1;164;2;0;2
092100044;200;163;282;7;76;123;1;76;4;0;72;0;0;0
092100045;300;483;497;8;133;166;1;133;2;0;131;0;0;0
092100046;300;678;709;11;135;164;1;135;9;0;126;0;0;0
092100047;500;837;837;8;196;300;4;196;5;2;189;0;0;0
092100048;200;190;200;6;74;125;1;74;4;0;70;0;0;0
092100049;200;326;343;6;110;87;3;110;3;0;107;0;0;0
092100050;100;140;140;3;58;41;1;58;0;0;58;0;0;0
092100051;436;436;463;4;174;252;10;174;8;2;164;0;0;0
092100052;300;246;246;9;123;176;1;123;0;0;123;0;0;0
092100053;100;111;117;6;51;48;1;51;0;0;51;0;0;0
092100054;100;68;93;6;54;45;1;54;1;0;53;0;0;0
092100055;100;98;98;7;32;67;1;32;0;0;32;0;0;0
092100056;500;1137;1137;10;281;250;1;249;3;2;244;32;2;30
092100057;200;152;152;3;155;45;0;155;0;0;155;0;0;0
092100058;200;94;94;0;93;107;0;93;0;0;93;0;0;0
092100059;100;64;64;5;67;32;1;67;2;0;65;0;0;0
092100060;200;121;121;3;122;78;0;122;0;0;122;0;0;0
092100061;100;79;79;2;79;21;0;79;0;0;79;0;0;0
092100062;100;64;64;0;64;36;0;64;0;0;64;0;0;0
092100063;100;29;29;13;29;70;1;29;0;0;29;0;0;0
093500001;300;298;307;6;136;202;1;97;0;2;95;39;4;35
093500002;600;609;614;5;142;467;1;132;11;0;121;10;0;10
093500003;300;300;304;4;129;170;1;129;7;2;120;0;0;0
093500004;300;327;332;6;132;167;1;132;4;0;128;0;0;0
093500005;300;234;236;1;102;195;3;102;1;0;101;0;0;0
093500006;400;355;355;6;77;322;1;77;0;0;77;0;0;0
093500007;400;343;345;6;103;296;1;103;2;3;98;0;0;0
093500008;300;292;292;8;99;200;1;99;5;1;93;0;0;0
093500009;300;323;334;11;134;169;1;130;8;1;121;4;0;4
093500010;300;303;317;8;139;160;1;139;5;4;130;0;0;0
093500011;600;814;826;7;207;391;2;207;9;0;198;0;0;0
093500012;500;501;513;9;239;261;2;237;9;1;227;2;0;2
093500013;400;446;446;5;178;223;1;176;6;0;170;2;0;2
093500014;200;177;185;5;84;115;1;84;4;6;74;0;0;0
093500015;300;279;279;4;89;210;1;89;1;0;88;0;0;0
093500016;100;91;91;6;70;29;1;70;0;0;70;0;0;0
093500017;700;904;910;6;265;434;4;262;10;2;250;3;0;3
093500018;300;327;327;5;119;276;2;22;2;0;20;97;0;97
093500019;700;718;713;5;351;366;1;333;0;0;333;18;0;18
093500020;700;838;838;6;330;369;1;330;9;3;318;0;0;0
093500021;800;911;935;7;286;512;2;286;4;4;278;0;0;0
093500022;400;445;451;4;154;245;1;154;8;2;144;0;0;0
093500023;300;230;230;4;67;232;1;67;0;0;67;0;0;0
093500024;200;129;130;5;64;135;1;64;0;0;64;0;0;0
093500025;200;168;168;6;64;135;1;64;3;0;61;0;0;0
093500026;100;50;50;5;39;61;0;39;0;0;39;0;0;0
093500027;400;366;373;5;140;260;1;139;2;1;136;1;0;1
093500028;150;128;130;4;73;76;1;73;5;1;67;0;0;0
093500029;100;100;67;5;27;72;1;27;0;0;27;0;0;0
093500030;300;322;318;4;116;183;1;116;2;0;114;0;0;0
093500031;300;240;250;3;93;206;1;93;5;0;88;0;0;0
093500032;300;295;295;3;130;169;1;130;1;6;123;0;0;0
093500033;200;144;144;5;51;148;1;51;0;0;51;0;0;0
093500034;200;111;111;3;69;128;3;69;1;0;68;0;0;0
093500035;200;122;122;8;42;157;1;42;1;1;40;0;0;0
093500036;200;126;126;4;37;162;1;37;2;0;35;0;0;0
093500037;100;92;94;6;51;48;1;51;0;1;50;0;0;0
093500038;200;265;265;4;95;104;1;95;3;0;92;0;0;0
093500039;150;95;95;5;99;51;0;99;0;0;99;0;0;0
093500040;100;51;51;4;54;46;0;54;2;0;52;0;0;0
093500041;100;69;69;7;76;24;0;76;0;0;76;0;0;0
100400001;500;520;522;3;177;358;1;141;14;5;122;36;3;33
100400002;500;499;501;7;163;364;1;135;7;6;122;28;3;25
100400003;600;610;616;3;205;448;1;151;12;5;134;54;2;52
100400004;400;469;472;8;148;278;1;121;8;3;110;27;0;27
100400005;600;640;640;5;190;481;1;118;4;4;110;72;1;71
100400006;700;719;720;8;229;560;1;139;7;6;126;90;5;85
100400007;300;333;334;7;133;214;1;85;2;0;83;48;0;48
100400008;500;518;518;4;159;390;1;109;3;3;103;50;3;47
100400009;500;537;540;2;179;358;1;141;2;5;134;38;0;38
100400010;200;220;224;4;103;96;1;103;6;5;92;0;0;0
100400011;300;335;339;5;127;211;1;88;2;1;85;39;2;37
100400012;200;194;195;5;83;116;1;83;2;1;80;0;0;0
100400013;100;77;77;7;38;61;1;38;3;0;35;0;0;0
100400014;150;158;159;2;88;61;1;88;6;3;79;0;0;0
100400015;50;48;49;7;29;20;1;29;2;1;26;0;0;0
100400016;100;85;85;8;54;45;1;54;2;2;50;0;0;0
100400017;100;86;87;5;43;56;1;43;2;3;38;0;0;0
100400018;80;56;60;5;26;53;1;26;1;0;25;0;0;0
100400019;50;31;31;7;17;31;2;17;3;0;14;0;0;0
100400020;50;60;60;6;38;11;1;38;1;1;36;0;0;0
100400021;50;34;35;8;23;26;1;23;1;1;21;0;0;0
100400022;50;32;34;6;16;33;1;16;0;0;16;0;0;0
100400023;100;108;108;6;34;65;1;34;1;1;32;0;0;0
100400024;20;12;12;7;13;6;1;13;0;0;13;0;0;0
100400025;40;32;32;7;37;2;1;37;3;5;29;0;0;0
100400026;30;22;22;10;10;19;1;10;0;0;10;0;0;0
100400027;30;21;21;6;27;2;1;27;1;0;26;0;0;0
100500001;460;447;447;0;130;351;1;108;6;5;97;22;4;18
100500002;470;473;474;4;145;353;2;115;6;1;108;30;3;27
100500003;320;322;322;5;147;172;1;147;8;1;138;0;0;0
100500004;240;239;242;3;82;157;1;82;2;2;78;0;0;0
100500005;290;289;289;8;92;197;1;92;4;2;86;0;0;0
100500006;40;34;34;4;22;17;1;22;1;0;21;0;0;0
100500007;40;30;31;6;19;20;1;19;0;0;19;0;0;0
100500008;40;32;32;6;22;17;1;22;2;3;17;0;0;0
100500009;60;51;51;6;33;26;1;33;1;0;32;0;0;0
100500010;40;29;29;7;24;15;1;24;0;0;24;0;0;0
102700001;300;296;296;0;118;180;2;118;2;2;114;0;0;0
102700002;380;449;449;1;172;214;1;165;5;3;157;7;0;7
102700003;380;434;435;2;143;265;1;114;7;3;104;29;1;28
102700004;300;339;340;0;102;239;1;60;2;1;57;42;0;42
102700005;220;212;212;4;84;135;1;84;1;0;83;0;0;0
102700006;200;185;185;1;64;135;1;64;4;1;59;0;0;0
102700007;200;85;230;3;88;111;1;88;5;2;81;0;0;0
102700008;300;289;290;4;112;187;1;112;5;0;107;0;0;0
102700009;250;269;269;3;125;124;1;125;2;1;122;0;0;0
102700010;50;34;34;2;24;24;2;24;1;0;23;0;0;0
102700011;120;107;107;6;77;41;2;77;3;0;74;0;0;0
102700012;50;43;43;6;24;25;1;24;0;0;24;0;0;0
102700013;50;36;36;6;19;30;1;19;1;0;18;0;0;0
102700014;50;28;28;3;10;39;1;10;0;0;10;0;0;0
102700015;100;55;55;7;31;68;1;31;0;0;31;0;0;0
102700016;50;36;41;5;41;8;1;41;6;0;35;0;0;0
102900001;1000;1035;1037;7;104;915;1;84;10;1;73;20;1;19
102900002;1000;920;922;5;220;840;1;159;4;4;151;61;4;57
102900003;1000;892;893;3;183;893;1;106;2;2;102;77;4;73
102900004;1000;997;998;5;287;835;1;164;4;3;157;123;3;120
102900005;1000;924;926;5;171;898;1;101;7;2;92;70;0;70
102900006;500;530;531;4;154;416;2;82;2;3;77;72;3;69
102900007;500;580;580;6;184;397;1;102;1;5;96;82;7;75
102900008;500;643;643;5;182;397;1;102;4;5;93;80;3;77
102900009;1000;933;933;6;250;841;1;158;9;7;142;92;8;84
102900010;500;507;702;3;176;399;1;100;2;1;97;76;4;72
102900011;500;534;537;4;154;414;1;85;1;1;83;69;1;68
102900012;500;660;660;8;230;350;7;143;5;4;134;87;1;86
102900013;1000;892;893;7;194;875;1;124;2;0;122;70;4;66
102900014;1000;974;1044;0;124;924;2;74;4;2;68;50;1;49
102900015;1000;964;965;8;199;886;1;113;1;2;110;86;2;84
102900016;1000;1031;1032;7;140;881;1;118;18;2;98;22;2;20
102900017;1000;917;919;7;112;929;1;70;8;0;62;42;0;42
102900018;1000;986;986;7;181;892;1;107;2;3;102;74;4;70
102900019;1000;829;830;9;122;931;1;68;3;0;65;54;0;54
102900020;1000;961;963;6;232;868;1;131;5;2;124;101;5;96
102900021;1000;904;905;5;260;851;2;147;2;2;143;113;4;109
102900022;500;669;669;8;196;412;1;87;4;1;82;109;7;102
102900023;1000;1110;1115;9;106;936;1;63;3;1;59;43;4;39
102900024;1000;948;948;8;284;823;1;176;6;5;165;108;4;104
102900025;1000;881;881;5;241;870;1;129;5;5;119;112;6;106
102900026;500;754;756;6;177;407;1;92;1;1;90;85;2;83
102900027;500;761;762;9;212;376;1;123;5;1;117;89;4;85
102900028;1000;944;946;5;249;851;1;148;3;4;141;101;4;97
102900029;1000;807;807;9;187;847;1;152;5;2;145;35;2;33
102900030;500;719;719;8;191;412;1;87;2;0;85;104;1;103
102900031;1000;957;959;5;262;838;1;161;7;4;150;101;2;99
102900032;1000;1001;1001;7;191;883;1;116;4;3;109;75;1;74
102900033;1000;980;982;4;248;863;2;135;1;0;134;113;4;109
102900034;500;749;749;10;182;317;1;182;3;11;168;0;0;0
102900035;1000;802;803;7;212;884;2;114;3;3;108;98;6;92
102900036;500;676;676;6;178;405;2;93;2;3;88;85;6;79
102900037;500;780;780;12;209;396;1;103;2;3;98;106;3;103
102900038;1000;810;810;9;267;734;1;265;6;5;254;2;0;2
102900039;1000;898;900;8;248;856;1;143;2;3;138;105;8;97
102900040;500;745;747;3;192;389;2;109;7;0;102;83;0;83
102900041;500;617;734;6;191;400;2;98;5;1;92;93;5;88
102900042;1000;824;824;7;174;910;1;89;3;2;84;85;8;77
102900043;500;605;605;7;182;394;2;104;3;4;97;78;4;74
102900044;1000;908;908;6;244;866;1;133;3;1;129;111;1;110
102900045;1000;916;918;5;229;864;2;134;2;7;125;95;3;92
102900046;500;717;717;5;175;412;1;87;1;1;85;88;2;86
102900047;500;795;795;6;193;374;3;123;5;1;117;70;2;68
102900048;1000;989;989;5;251;837;1;162;8;6;148;89;6;83
102900049;500;687;688;4;152;415;1;84;2;2;80;68;2;66
102900050;1000;987;988;7;114;924;1;75;2;4;69;39;3;36
102900051;1000;910;911;3;192;879;1;120;7;2;111;72;2;70
102900052;500;760;760;6;214;378;1;121;4;6;111;93;6;87
102900053;500;601;601;6;159;394;5;101;4;4;93;58;2;56
102900054;1000;893;895;7;226;855;1;144;5;5;134;82;2;80
102900055;1000;964;964;2;225;865;7;128;6;4;118;97;6;91
102900056;1000;874;874;7;202;872;2;126;4;4;118;76;4;72
102900057;500;741;741;4;155;411;1;88;3;1;84;67;0;67
102900058;1000;847;850;7;97;931;1;68;3;1;64;29;0;29
102900059;500;777;777;6;141;418;3;79;2;1;76;62;4;58
102900060;500;679;680;4;139;404;3;93;3;1;89;46;0;46
102900061;500;654;654;5;130;423;1;76;1;3;72;54;1;53
102900062;100;55;55;0;24;75;1;24;0;1;23;0;0;0
102900063;600;604;604;3;91;520;1;79;4;1;74;12;1;11
102900064;200;203;205;6;68;131;1;68;2;1;65;0;0;0
102900065;100;45;45;5;16;83;1;16;0;0;16;0;0;0
102900066;100;13;13;6;10;89;1;10;0;0;10;0;0;0
102900067;100;87;87;7;40;59;1;40;0;0;40;0;0;0
102900068;100;66;66;5;20;79;1;20;1;0;19;0;0;0
102900069;100;13;14;6;10;89;1;10;0;1;9;0;0;0
102900070;100;17;17;7;10;89;1;10;0;1;9;0;0;0
102900071;200;199;199;5;54;145;1;54;6;0;48;0;0;0
102900072;300;259;260;5;70;229;1;70;8;3;59;0;0;0
102900073;100;75;75;5;17;82;1;17;0;0;17;0;0;0
102900074;500;497;499;3;135;405;1;94;2;3;89;41;4;37
102900075;400;409;409;3;115;323;1;76;2;2;72;39;0;39
102900076;300;258;260;5;79;220;1;79;0;6;73;0;0;0
102900077;400;352;354;3;105;319;1;80;6;3;71;25;2;23
102900078;100;102;102;4;31;68;1;31;0;1;30;0;0;0
102900079;300;255;256;7;26;273;1;26;0;2;24;0;0;0
102900080;800;791;791;7;220;642;6;152;5;3;144;68;4;64
102900081;900;889;891;6;193;761;1;138;6;4;128;55;1;54
102900082;600;557;562;0;142;457;1;142;3;2;137;0;0;0
102900083;100;21;22;5;18;81;1;18;1;0;17;0;0;0
102900084;100;107;109;6;55;43;2;55;7;1;47;0;0;0
102900085;200;131;127;5;48;150;2;48;0;1;47;0;0;0
102900086;200;124;124;1;19;180;1;19;1;1;17;0;0;0
102900087;500;512;515;2;150;387;1;112;9;3;100;38;1;37
102900088;800;830;831;5;232;622;1;177;9;2;166;55;5;50
102900089;200;151;151;2;53;146;1;53;1;3;49;0;0;0
102900090;1000;1484;962;1;187;843;2;155;9;1;145;32;1;31
102900091;700;739;740;5;178;569;7;124;4;2;118;54;4;50
102900092;100;107;107;6;64;35;1;64;3;3;58;0;0;0
102900093;600;690;691;5;180;470;1;129;9;4;116;51;1;50
102900094;100;76;76;8;36;63;1;36;1;1;34;0;0;0
102900095;100;123;124;4;46;53;1;46;1;1;44;0;0;0
102900096;400;421;421;3;80;331;2;67;5;1;61;13;0;13
102900097;100;114;115;4;34;65;1;34;0;0;34;0;0;0
102900098;200;194;194;4;81;118;1;81;1;1;79;0;0;0
102900099;100;88;89;5;41;58;1;41;3;1;37;0;0;0
102900100;300;337;337;2;115;228;1;71;2;7;62;44;3;41
102900101;200;205;206;3;92;107;1;92;8;8;76;0;0;0
102900102;500;512;512;4;123;406;1;93;3;3;87;30;0;30
102900103;100;75;75;7;38;60;2;38;1;2;35;0;0;0
102900104;400;431;433;6;113;310;1;89;3;3;83;24;0;24
102900105;300;199;326;4;97;200;3;97;4;1;92;0;0;0
102900106;700;682;682;2;187;576;1;123;8;2;113;64;6;58
102900107;200;163;163;0;54;145;1;54;1;1;52;0;0;0
102900108;900;888;888;2;161;773;2;125;4;0;121;36;1;35
102900109;100;76;76;9;43;56;1;43;0;2;41;0;0;0
102900110;100;30;30;0;16;83;1;16;0;0;16;0;0;0
102900111;100;61;61;7;38;61;1;38;2;0;36;0;0;0
102900112;100;15;15;7;20;79;1;20;6;1;13;0;0;0
102900113;100;19;19;4;23;76;1;23;1;0;22;0;0;0
103100001;250;284;284;4;90;159;1;90;4;1;85;0;0;0
103100002;30;18;18;7;12;17;1;12;0;0;12;0;0;0
103100003;105;96;97;7;41;63;1;41;2;1;38;0;0;0
103100004;35;27;27;5;21;13;1;21;1;0;20;0;0;0
103100005;85;76;76;6;38;46;1;38;0;2;36;0;0;0
103100006;65;54;54;7;29;35;1;29;0;1;28;0;0;0
103100007;50;39;39;5;19;30;1;19;1;0;18;0;0;0
103100008;30;16;16;6;12;17;1;12;0;0;12;0;0;0
103100009;40;29;29;7;21;18;1;21;1;0;20;0;0;0
103100010;110;109;109;6;29;80;1;29;2;0;27;0;0;0
103100011;35;24;24;7;24;10;1;24;0;1;23;0;0;0
103100012;235;414;416;5;142;119;1;115;2;3;110;27;1;26
103100013;80;70;70;5;36;43;1;36;3;0;33;0;0;0
103100014;45;32;32;7;27;17;1;27;2;0;25;0;0;0
103100015;75;65;65;5;34;40;1;34;2;1;31;0;0;0
103100016;50;40;40;7;17;32;1;17;1;0;16;0;0;0
103100017;105;96;96;6;46;58;1;46;3;1;42;0;0;0
103100018;40;27;27;6;13;26;1;13;0;0;13;0;0;0
103100019;33;24;24;9;17;15;1;17;1;0;16;0;0;0
103800001;620;642;647;2;201;465;1;154;2;8;144;47;4;43
103800002;640;650;655;2;191;517;2;121;4;2;115;70;3;67
103800003;680;696;701;1;201;515;1;164;11;4;149;37;1;36
103800004;40;26;26;7;21;18;1;21;0;0;21;0;0;0
103800005;110;97;97;5;53;56;1;53;1;3;49;0;0;0
103800006;150;139;139;4;54;95;1;54;1;1;52;0;0;0
103800007;35;17;17;7;18;17;0;18;0;2;16;0;0;0
103800008;25;14;14;1;14;10;1;14;2;0;12;0;0;0
104100001;500;368;372;1;144;380;1;119;4;9;106;25;2;23
104100002;500;625;629;3;214;317;1;182;9;4;169;32;2;30
104100003;500;720;728;1;250;316;1;183;7;7;169;67;3;64
104100004;1000;867;872;2;359;722;1;277;18;5;254;82;4;78
104100005;1000;944;945;5;389;673;1;326;19;8;299;63;3;60
104100006;800;789;794;0;290;578;2;220;5;8;207;70;1;69
104100007;600;812;812;0;327;319;1;280;15;7;258;47;3;44
104100008;500;552;554;1;202;342;1;157;3;4;150;45;1;44
104100009;500;469;471;1;198;339;1;160;7;1;152;38;0;38
104100010;100;21;21;0;20;79;1;20;1;0;19;0;0;0
104800001;500;132;487;5;137;401;1;98;7;1;90;39;2;37
104800002;700;676;677;4;185;584;1;115;0;5;110;70;2;68
104800003;700;726;727;7;258;503;1;196;4;3;189;62;2;60
104800004;600;618;619;6;191;427;1;172;6;6;160;19;0;19
104800005;600;517;517;8;151;507;1;92;1;1;90;59;3;56
104800006;600;574;574;1;169;485;1;114;5;0;109;55;3;52
104800007;400;390;390;6;124;326;3;71;2;3;66;53;1;52
104800008;500;454;462;4;151;428;1;71;3;0;68;80;4;76
104800009;400;373;373;7;140;324;2;74;2;1;71;66;0;66
104800010;600;622;622;7;212;481;1;118;5;2;111;94;1;93
104800011;600;645;646;4;218;485;1;114;3;3;108;104;5;99
104800012;400;435;435;3;157;316;2;82;2;0;80;75;2;73
104800013;600;666;666;4;243;470;0;130;9;3;118;113;3;110
104800014;400;391;391;7;146;310;1;89;3;3;83;57;2;55
104800015;600;641;641;0;207;470;1;129;6;1;122;78;4;74
104800016;600;575;575;6;168;465;2;133;4;2;127;35;0;35
104800017;600;604;604;2;159;511;1;88;0;2;86;71;2;69
104800018;600;682;682;4;201;462;0;138;7;5;126;63;3;60
104800019;1000;1046;1046;6;182;835;2;163;26;0;137;19;0;19
104800020;800;865;865;4;265;633;1;166;7;5;154;99;2;97
104800021;600;684;685;5;210;467;1;132;4;5;123;78;4;74
104800022;800;780;780;4;217;659;2;139;4;3;132;78;2;76
104800023;800;861;862;5;217;669;1;130;6;1;123;87;3;84
104800024;800;849;849;6;229;689;1;110;3;2;105;119;6;113
104800025;800;821;821;5;212;666;1;133;3;5;125;79;4;75
104800026;800;784;784;7;232;657;1;142;2;4;136;90;2;88
104800027;400;446;447;2;132;325;2;73;2;0;71;59;2;57
104800028;700;656;656;1;199;592;1;107;1;2;104;92;3;89
104800029;500;539;541;5;159;416;1;83;0;1;82;76;1;75
104800030;700;696;697;2;244;557;1;142;6;0;136;102;5;97
104800031;700;672;672;5;228;540;1;159;8;2;149;69;6;63
104800032;500;521;521;1;122;429;1;70;1;9;60;52;2;50
104800033;600;647;647;3;157;508;1;91;0;4;87;66;4;62
104800034;900;868;868;0;210;769;1;130;5;7;118;80;3;77
104800035;700;711;716;5;171;600;1;99;0;3;96;72;0;72
104800036;600;577;577;3;169;498;1;101;1;0;100;68;3;65
104800037;400;418;418;3;145;301;2;97;2;5;90;48;2;46
104800038;600;644;645;4;189;465;1;134;4;2;128;55;0;55
104800039;700;689;690;7;226;558;1;141;3;2;136;85;2;83
104800040;700;688;689;4;242;551;2;147;2;4;141;95;0;95
104800041;700;731;732;5;239;574;1;125;2;5;118;114;1;113
104800042;700;730;730;6;216;588;1;111;4;0;107;105;9;96
104800043;400;442;442;7;115;318;1;81;2;4;75;34;2;32
104800044;500;527;528;5;165;408;2;90;1;0;89;75;1;74
104800045;700;663;660;4;161;625;1;74;1;0;73;87;3;84
104800046;800;799;799;7;211;637;1;162;9;0;153;49;2;47
104800047;900;911;913;8;206;754;1;145;10;2;133;61;0;61
104800048;500;509;509;3;149;384;1;115;6;0;109;34;0;34
104800049;700;755;756;3;223;522;2;176;5;6;165;47;0;47
104800050;500;493;493;4;152;393;1;106;2;0;104;46;1;45
104800051;600;585;585;3;191;439;2;159;12;2;145;32;0;32
104800052;100;27;27;5;26;73;1;26;1;1;24;0;0;0
104800053;600;646;646;3;194;460;1;139;4;2;133;55;2;53
104800054;700;766;766;5;210;563;1;136;5;3;128;74;0;74
104800055;200;155;152;3;62;137;1;62;0;5;57;0;0;0
104800056;200;114;114;5;46;153;1;46;0;1;45;0;0;0
104800057;500;543;543;4;144;414;1;85;2;4;79;59;4;55
104800058;500;497;497;5;161;399;1;100;8;4;88;61;0;61
104800059;600;604;604;3;169;486;2;112;4;3;105;57;4;53
104800060;300;236;236;5;128;171;1;128;11;1;116;0;0;0
104800061;100;87;87;6;66;32;2;66;1;1;64;0;0;0
104800062;100;20;20;5;10;89;1;10;0;0;10;0;0;0
104800063;200;190;190;8;92;107;1;92;5;2;85;0;0;0
104800064;100;33;33;6;21;78;1;21;0;0;21;0;0;0
104800065;100;53;53;5;37;62;1;37;2;0;35;0;0;0
104800066;100;77;77;5;55;44;1;55;3;1;51;0;0;0
104800067;400;391;391;6;113;330;1;69;4;0;65;44;2;42
104800068;500;481;482;6;105;420;1;79;9;2;68;26;3;23
104800069;500;521;521;6;141;397;3;100;9;1;90;41;2;39
104800070;600;601;601;3;82;543;1;56;3;2;51;26;1;25
104800071;400;355;355;3;89;339;1;60;4;2;54;29;1;28
104800072;600;500;500;1;231;380;2;218;19;0;199;13;0;13
105000001;165;180;180;4;94;68;3;94;5;3;86;0;0;0
105000002;30;26;26;2;20;9;1;20;1;0;19;0;0;0
105000003;43;35;35;5;30;12;1;30;2;0;28;0;0;0
105000004;70;64;64;3;38;31;1;38;2;1;35;0;0;0
105000005;50;46;46;5;24;25;1;24;2;1;21;0;0;0
105000006;27;21;21;5;20;6;1;20;1;0;19;0;0;0
105000007;35;27;27;7;25;9;1;25;0;0;25;0;0;0
105000008;30;21;21;6;21;8;1;21;0;0;21;0;0;0
105000009;50;48;48;1;37;12;1;37;0;1;36;0;0;0
110200001;600;607;614;1;249;468;2;130;1;3;126;119;3;116
110200002;500;553;553;2;225;353;1;146;1;6;139;79;3;76
110200003;400;443;443;0;148;301;1;98;7;4;87;50;2;48
110200004;400;534;537;0;178;279;1;120;0;6;114;58;6;52
110200005;100;43;43;4;28;71;1;28;0;1;27;0;0;0
110200006;100;91;91;1;40;58;1;41;1;0;40;0;0;0
110200007;100;57;57;7;33;66;1;33;1;3;29;0;0;0
111700001;600;612;618;1;172;478;1;121;1;3;117;51;3;48
111700002;500;539;541;2;175;409;1;90;6;3;81;85;3;82
111700003;500;518;519;1;96;428;1;71;1;4;66;25;1;24
111700004;700;786;786;0;85;622;1;77;3;0;74;8;0;8
111700005;700;820;822;0;112;603;1;96;5;2;89;16;1;15
111700006;400;403;403;3;149;270;1;129;9;2;118;20;0;20
111700007;350;292;292;3;105;244;1;105;10;10;85;0;0;0
111700008;150;75;74;4;38;111;1;38;1;3;34;0;0;0
111800001;600;688;692;7;169;479;1;120;11;3;106;49;4;45
111800002;600;607;607;5;223;513;1;86;1;4;81;137;2;135
111800003;500;534;536;0;192;378;1;121;1;3;117;71;2;69
111800004;500;545;548;4;174;408;1;91;1;2;88;83;4;79
111800005;500;516;516;6;182;381;2;117;1;3;113;65;1;64
111800006;700;748;748;5;235;575;1;124;3;0;121;111;4;107
111800007;500;530;532;9;180;408;1;91;0;3;88;89;6;83
111800008;500;591;593;5;157;403;1;96;2;3;91;61;4;57
111800009;400;442;446;5;137;316;1;83;1;0;82;54;0;54
111800010;400;485;487;6;161;296;2;102;0;3;99;59;6;53
111800011;400;483;485;6;125;334;2;64;1;0;63;61;4;57
111800012;400;472;478;2;122;328;1;71;2;2;67;51;2;49
111800013;600;669;671;6;165;514;1;85;1;0;84;80;3;77
111800014;500;557;559;8;137;415;1;84;3;2;79;53;2;51
111800015;600;696;696;6;235;480;1;119;6;3;110;116;2;114
111800016;500;529;529;5;185;396;1;103;0;0;103;82;1;81
111800017;400;464;464;4;163;329;1;70;1;1;68;93;5;88
111800018;500;548;549;8;166;397;1;102;1;3;98;64;0;64
111800019;600;639;639;8;160;519;1;80;4;2;74;80;2;78
111800020;700;767;772;6;220;581;1;118;2;0;116;102;6;96
111800021;600;603;603;6;195;498;1;101;3;1;97;94;2;92
111800022;400;460;463;3;170;294;1;105;3;0;102;65;5;60
111800023;400;463;464;2;147;337;3;60;2;4;54;87;2;85
111800024;400;476;478;6;147;318;1;81;4;0;77;66;0;66
111800025;400;494;497;9;130;327;3;70;2;5;63;60;1;59
111800026;600;620;620;3;190;495;1;104;3;3;98;86;5;81
111800027;500;498;501;7;154;411;1;88;6;1;81;66;2;64
111800028;600;629;632;8;172;507;1;92;3;2;87;80;2;78
111800029;600;604;606;3;148;514;1;85;2;4;79;63;2;61
111800030;500;585;587;6;141;412;1;87;3;4;80;54;1;53
111800031;600;635;636;1;136;516;1;83;2;2;79;53;1;52
111800032;600;634;634;7;143;504;1;95;1;2;92;48;2;46
111800033;400;431;432;3;77;346;2;52;1;0;51;25;1;24
111800034;400;453;453;6;89;328;2;70;1;1;68;19;0;19
111800035;600;596;601;6;211;473;1;126;3;2;121;85;2;83
111800036;400;496;499;8;180;261;1;138;3;5;130;42;0;42
111800037;300;234;237;3;103;196;1;103;7;4;92;0;0;0
111800038;400;485;497;1;148;277;1;122;4;5;113;26;0;26
111800040;200;172;172;5;77;122;1;77;2;0;75;0;0;0
111800041;300;242;242;6;104;194;2;104;3;3;98;0;0;0
111800042;700;777;781;5;296;456;2;242;8;3;231;54;0;54
111800044;500;550;551;6;189;366;1;133;3;0;130;56;1;55
111800046;400;467;474;3;182;257;3;140;3;4;133;42;1;41
111800048;400;470;472;4;181;241;1;158;10;3;145;23;0;23
111800050;200;131;131;7;89;108;3;89;1;0;88;0;0;0
111800051;100;76;76;6;42;57;1;42;5;1;36;0;0;0
111800052;500;540;547;6;261;273;1;226;15;3;208;35;0;35
111800054;200;129;129;4;80;119;1;80;5;3;72;0;0;0
111800055;100;64;64;5;45;54;1;45;2;0;43;0;0;0
111800057;100;23;24;5;13;86;1;13;0;0;13;0;0;0
111800058;200;164;166;3;86;112;2;86;2;6;78;0;0;0
111800059;200;102;102;6;64;135;1;64;2;0;62;0;0;0
111800060;100;68;91;8;43;56;1;43;0;0;43;0;0;0
111800061;100;94;95;6;70;29;1;70;5;3;62;0;0;0
111800062;100;95;94;4;59;40;1;59;2;1;56;0;0;0
111800063;200;198;200;2;88;111;1;88;5;0;83;0;0;0
111800064;200;93;182;7;100;99;1;100;3;5;92;0;0;0
111800065;200;197;197;3;94;105;1;94;5;1;88;0;0;0
111800066;100;62;62;7;46;53;1;46;2;2;42;0;0;0
111800067;700;790;790;6;206;572;1;127;2;6;119;79;3;76
111800068;700;723;726;5;193;612;1;87;2;3;82;106;2;104
111800069;500;511;511;7;97;437;1;62;0;0;62;35;0;35
111800070;600;659;659;6;165;475;1;124;5;2;117;41;1;40
111800071;800;869;869;5;130;692;1;107;6;5;96;23;0;23
111800072;700;721;721;7;80;636;1;63;5;0;58;17;1;16
111800074;200;157;157;3;80;118;2;80;3;3;74;0;0;0
111800075;200;170;171;7;83;116;1;83;2;0;81;0;0;0
111800076;807;803;806;4;199;649;9;149;7;4;138;50;1;49
111800078;100;77;77;5;45;54;1;45;2;0;43;0;0;0
111800079;300;276;276;2;88;211;1;88;8;1;79;0;0;0
111800080;200;218;218;10;92;107;1;92;2;6;84;0;0;0
111800081;100;26;26;6;19;80;1;19;0;0;19;0;0;0
111800082;500;596;599;5;160;414;1;85;3;1;81;75;6;69
111800083;600;638;640;6;171;493;1;106;4;2;100;65;1;64
111800084;500;514;514;8;140;363;1;136;1;5;130;4;0;4
111800085;700;747;759;7;187;605;1;94;3;2;89;93;2;91
111800086;500;557;557;6;113;440;1;59;0;2;57;54;5;49
111800087;400;479;480;5;189;266;1;133;1;6;126;56;2;54
111800088;400;455;463;5;165;310;2;88;1;1;86;77;5;72
111800089;500;536;539;9;198;413;1;86;0;4;82;112;0;112
111800090;400;417;417;6;148;330;1;69;1;2;66;79;2;77
111800091;600;604;605;4;176;506;1;93;3;0;90;83;6;77
111800092;600;664;666;4;213;456;1;143;4;7;132;70;2;68
111800093;700;752;752;4;199;518;1;181;5;2;174;18;0;18
111800094;500;553;554;10;139;420;1;79;5;1;73;60;4;56
111800096;467;524;525;1;116;383;1;83;2;1;80;33;0;33
111800097;100;78;79;7;50;49;1;50;1;4;45;0;0;0
111800098;100;42;42;6;32;67;1;32;0;2;30;0;0;0
111800099;400;468;481;7;151;321;1;78;0;4;74;73;2;71
111800100;400;481;481;7;161;319;1;80;2;3;75;81;3;78
111800101;500;505;505;4;174;406;3;91;1;7;83;83;4;79
111800102;200;17;17;37;39;160;1;39;3;0;36;0;0;0
111800103;100;49;49;17;53;46;1;53;3;3;47;0;0;0
111800104;100;37;37;11;26;73;1;26;1;0;25;0;0;0
111800105;100;17;17;11;28;71;1;28;2;0;26;0;0;0
111800106;200;125;125;25;85;114;1;85;13;3;69;0;0;0
111800107;100;44;44;5;47;48;5;47;0;0;47;0;0;0
111900001;800;828;829;8;176;685;1;114;6;1;107;62;3;59
111900002;600;649;649;0;165;500;1;99;4;3;92;66;2;64
111900003;700;738;740;0;194;571;1;128;6;7;115;66;5;61
111900004;500;511;511;0;171;402;1;97;2;3;92;74;2;72
111900005;700;717;719;2;200;563;9;128;9;2;117;72;4;68
111900006;800;794;794;0;266;628;2;170;9;3;158;96;2;94
111900007;800;809;822;0;195;633;1;166;2;5;159;29;1;28
111900008;900;928;930;4;179;723;1;176;35;0;141;3;0;3
111900009;700;761;762;1;155;605;1;94;4;3;87;61;2;59
111900010;900;967;967;8;212;691;3;206;61;1;144;6;0;6
111900011;400;478;478;6;190;229;1;170;7;0;163;20;0;20
111900012;300;298;298;3;149;150;1;149;11;1;137;0;0;0
111900013;600;602;604;4;261;362;1;237;7;5;225;24;1;23
111900014;400;449;451;4;121;299;1;100;7;1;92;21;0;21
111900015;300;86;312;6;92;229;1;70;3;2;65;22;2;20
111900016;100;78;79;4;52;47;1;52;3;1;48;0;0;0
111900017;100;66;66;4;48;51;1;48;1;0;47;0;0;0
111900018;600;615;616;2;168;455;1;144;6;1;137;24;0;24
111900019;600;609;615;1;171;467;1;132;8;3;121;39;2;37
111900020;500;536;537;1;181;343;1;156;6;4;146;25;0;25
111900021;500;465;465;4;180;344;1;155;7;2;146;25;0;25
111900022;800;857;858;1;301;518;3;279;11;1;267;22;0;22
111900023;600;579;580;0;176;453;1;146;12;2;132;30;0;30
111900024;500;496;496;1;145;360;1;139;19;0;120;6;0;6
111900025;400;434;440;0;91;323;1;76;6;1;69;15;0;15
111900026;100;10;10;13;18;81;1;18;1;0;17;0;0;0
111900027;100;75;75;12;51;48;1;51;12;0;39;0;0;0
111900028;100;26;26;0;25;74;1;25;0;0;25;0;0;0
113300001;300;257;257;4;89;210;1;89;2;2;85;0;0;0
113300002;500;461;461;3;279;225;2;273;19;3;251;6;0;6
113300003;500;540;542;3;306;202;1;297;14;6;277;9;0;9
113300004;200;182;182;1;53;146;1;53;2;1;50;0;0;0
113300005;800;871;871;0;472;341;1;458;27;5;426;14;0;14
113300006;700;659;659;0;355;353;4;343;16;0;327;12;0;12
113300007;500;527;527;5;316;197;1;302;10;1;291;14;1;13
113300008;600;633;634;2;297;308;1;291;12;1;278;6;0;6
113300009;700;680;682;0;379;321;2;377;18;0;359;2;0;2
113300010;700;736;737;1;258;495;1;204;17;4;183;54;1;53
113300012;100;62;62;4;28;71;1;28;0;1;27;0;0;0
113300014;300;286;286;4;215;84;1;215;9;6;200;0;0;0
113300015;100;55;57;3;43;56;1;43;0;0;43;0;0;0
113300016;600;607;608;0;284;324;1;275;6;1;268;9;0;9
113300017;800;890;891;0;393;429;2;369;5;0;364;24;1;23
113300018;100;112;112;3;60;39;1;60;2;2;56;0;0;0
113300019;100;44;44;5;28;71;1;28;2;0;26;0;0;0
113300020;500;458;463;5;195;339;2;159;0;1;158;36;0;36
113300021;200;227;227;2;93;106;1;93;0;2;91;0;0;0
113300022;100;119;119;7;52;47;1;52;0;0;52;0;0;0
113300023;700;704;709;10;207;561;2;137;5;1;131;70;3;67
113300024;500;465;467;5;111;440;2;58;2;0;56;53;0;53
113300025;500;475;477;2;107;439;1;60;2;2;56;47;7;40
113300026;700;692;694;6;178;570;1;129;4;2;123;49;4;45
113300027;800;806;807;7;224;654;1;145;5;7;133;79;5;74
113300028;600;658;658;6;193;454;1;145;6;3;136;48;4;44
113300029;600;630;630;4;140;512;1;87;2;2;83;53;4;49
113300031;500;549;549;4;160;390;2;108;4;2;102;52;3;49
113300032;800;834;836;5;225;617;1;182;14;0;168;43;1;42
113300033;500;506;506;5;166;390;1;109;2;1;106;57;0;57
113300034;500;467;467;4;150;412;1;87;3;3;81;63;1;62
113300035;400;419;421;4;131;286;1;113;10;0;103;18;0;18
113300036;800;770;772;2;170;673;1;126;7;4;115;44;2;42
113300038;300;335;335;4;130;209;1;90;5;2;83;40;4;36
113300040;200;139;140;4;63;136;1;63;0;3;60;0;0;0
113300041;100;12;12;21;28;71;1;28;2;1;25;0;0;0
113400001;600;593;593;7;116;542;2;56;1;0;55;60;6;54
113400002;500;550;551;4;139;439;1;60;3;1;56;79;2;77
113400003;600;609;610;3;146;520;1;79;4;1;74;67;2;65
113400004;600;643;643;4;170;512;1;87;5;2;80;83;3;80
113400005;700;696;697;5;186;555;1;144;6;2;136;42;1;41
113400006;400;454;454;5;132;339;3;58;3;2;53;74;8;66
113400007;500;526;526;6;130;439;1;60;3;2;55;70;6;64
113400008;400;431;432;5;149;351;1;48;1;3;44;101;4;97
113400009;200;240;240;5;86;113;1;86;0;3;83;0;0;0
113400010;600;592;594;5;196;495;1;104;3;4;97;92;6;86
113400011;300;333;335;4;85;272;2;26;0;1;25;59;1;58
113400012;500;475;477;7;144;425;1;74;4;3;67;70;2;68
113400013;500;510;511;6;171;420;1;79;1;3;75;92;3;89
113400014;600;587;591;7;149;523;1;76;3;2;71;73;3;70
113400015;600;655;656;2;211;480;1;119;2;9;108;92;3;89
113400016;600;601;601;3;176;504;1;95;3;4;88;81;4;77
113400017;500;504;505;0;167;402;1;97;4;0;93;70;3;67
113400018;600;571;571;4;171;494;1;105;4;2;99;66;6;60
113400019;500;542;542;5;150;418;1;81;0;1;80;69;5;64
113400020;500;471;472;5;133;439;1;60;0;0;60;73;4;69
113400021;700;721;724;4;173;612;1;87;1;2;84;86;2;84
113400022;500;474;475;5;134;431;2;67;2;1;64;67;4;63
113400023;400;372;373;5;80;354;1;45;1;1;43;35;0;35
113400024;800;831;833;6;163;701;1;98;4;2;92;65;1;64
113400025;400;420;420;5;77;368;1;31;3;0;28;46;1;45
113400026;199;201;201;5;35;163;1;35;1;2;32;0;0;0
113400027;100;99;99;4;36;63;1;36;1;0;35;0;0;0
113400028;500;495;495;4;133;430;2;68;3;2;63;65;2;63
113400029;500;521;522;8;145;422;1;77;0;1;76;68;3;65
113400030;600;598;598;4;132;522;1;77;3;2;72;55;7;48
113400031;500;484;484;7;110;436;2;62;1;2;59;48;2;46
113400032;700;663;674;6;169;596;1;103;4;2;97;66;2;64
113400033;500;464;465;5;132;434;2;64;1;1;62;68;5;63
113400034;600;575;575;7;159;516;1;83;1;1;81;76;3;73
113400035;600;593;596;6;150;523;1;76;2;2;72;74;3;71
113400036;400;393;395;6;47;365;1;34;3;0;31;13;0;13
113400037;100;68;68;6;44;55;1;44;2;0;42;0;0;0
113400038;100;105;105;5;36;63;1;36;1;1;34;0;0;0
113400039;300;283;283;0;154;145;1;154;5;7;142;0;0;0
113400040;200;165;165;5;71;128;1;71;2;4;65;0;0;0
113400041;200;221;221;5;114;85;1;114;2;2;110;0;0;0
113400042;200;145;145;3;56;143;1;56;4;1;51;0;0;0
113400043;500;463;464;1;125;415;1;84;2;1;81;41;3;38
113400044;200;225;227;0;90;109;1;90;3;2;85;0;0;0
113400045;200;253;254;4;94;105;1;94;1;2;91;0;0;0
113400046;200;243;243;4;127;71;2;127;5;8;114;0;0;0
113400047;200;224;225;5;79;120;1;79;0;4;75;0;0;0
113400048;400;441;443;0;155;275;1;124;1;3;120;31;2;29
113400049;200;204;205;3;98;100;2;98;2;1;95;0;0;0
113400050;800;773;773;4;278;561;1;238;7;6;225;40;1;39
113400051;800;816;817;2;222;664;1;135;3;5;127;87;5;82
113400052;600;637;637;3;209;448;1;151;16;1;134;58;2;56
113400053;700;653;653;2;306;413;1;286;9;9;268;20;2;18
113400054;100;48;48;5;31;68;1;31;2;3;26;0;0;0
113400055;500;505;506;1;159;415;1;84;6;1;77;75;0;75
113400056;200;145;146;2;60;137;3;60;2;2;56;0;0;0
113400057;400;441;441;2;198;251;1;148;12;1;135;50;0;50
113400058;200;164;164;5;83;116;1;83;0;4;79;0;0;0
113400059;500;552;553;3;252;341;1;158;5;1;152;94;5;89
113400060;100;15;15;15;21;78;1;21;1;0;20;0;0;0
113400061;100;17;17;11;26;73;1;26;2;0;24;0;0;0
113400062;100;14;14;0;14;85;1;14;0;0;14;0;0;0
113600001;700;849;853;3;250;457;2;241;28;6;207;9;0;9
113600002;700;712;791;4;253;529;1;170;11;0;159;83;0;83
113600003;400;415;418;0;125;292;1;107;11;2;94;18;1;17
113600004;100;103;104;3;68;31;1;68;2;1;65;0;0;0
113600005;300;300;301;2;110;189;1;110;8;1;101;0;0;0
113600006;100;105;105;4;61;38;1;61;5;1;55;0;0;0
113600007;100;66;66;5;51;48;1;51;2;1;48;0;0;0
113600008;700;809;811;5;335;451;1;248;14;10;224;87;5;82
113600009;900;970;977;4;437;512;1;387;39;7;341;50;1;49
113600010;100;23;23;7;22;76;2;22;1;1;20;0;0;0
113600011;100;99;100;7;73;26;1;73;8;0;65;0;0;0
113600012;100;102;102;5;62;37;1;62;3;3;56;0;0;0
113600013;100;86;87;5;44;55;1;44;3;1;40;0;0;0
113600014;100;18;18;1;19;80;1;19;3;0;16;0;0;0
113800001;600;737;738;1;199;469;1;130;7;1;122;69;1;68
113800002;600;686;687;0;242;411;1;188;19;3;166;54;4;50
113800003;700;751;751;1;271;516;1;183;7;5;171;88;2;86
113800004;100;107;107;3;45;54;1;45;1;2;42;0;0;0
113800005;700;758;758;5;144;574;1;125;12;2;111;19;1;18
113800006;100;75;75;6;31;68;1;31;2;0;29;0;0;0
113800007;400;381;381;3;209;204;1;195;11;2;182;14;2;12
113800008;100;44;44;7;33;66;1;33;1;3;29;0;0;0
113800009;700;657;657;5;284;451;1;248;20;1;227;36;2;34
113800010;200;159;159;5;78;121;1;78;2;4;72;0;0;0
113800011;300;223;223;4;106;192;2;106;6;1;99;0;0;0
120200001;200;246;248;1;96;103;1;96;4;6;86;0;0;0
120200002;300;623;626;2;222;149;1;150;4;3;143;72;5;67
120200003;300;690;694;0;218;155;1;144;5;3;136;74;1;73
120200004;300;477;484;5;147;206;1;93;6;1;86;54;3;51
120200005;200;436;442;4;170;99;1;100;3;3;94;70;10;60
120200006;200;521;523;4;187;61;1;138;1;4;133;49;2;47
120200007;300;502;509;1;198;174;1;125;5;6;114;73;4;69
120200008;300;648;652;4;207;165;1;134;8;2;124;73;5;68
120200009;200;430;430;4;156;118;1;81;1;2;78;75;2;73
120200010;200;352;353;2;133;108;1;91;0;2;89;42;1;41
120200011;300;534;535;8;201;178;1;121;2;3;116;80;4;76
120200012;300;519;521;5;184;183;1;116;3;1;112;68;4;64
120200013;200;482;484;482;169;96;1;103;1;3;99;66;6;60
120200014;300;471;483;3;171;200;1;99;4;0;95;72;1;71
120200015;300;518;522;6;168;172;1;127;3;2;122;41;0;41
120200016;300;524;529;3;166;201;1;98;3;0;95;68;3;65
120200017;300;519;522;7;186;179;1;120;2;1;117;66;2;64
120200018;500;1089;1086;3;374;125;3;372;34;0;338;2;0;2
120200019;400;932;933;3;279;138;3;259;15;1;243;20;0;20
120200020;400;977;977;5;312;89;3;308;32;0;276;4;0;4
120200021;100;120;84;0;52;47;1;52;7;1;44;0;0;0
120200022;100;131;131;4;52;47;1;52;3;0;49;0;0;0
120200023;100;58;58;6;34;65;1;34;1;0;33;0;0;0
120200024;100;37;37;5;24;75;1;24;0;0;24;0;0;0
120200025;100;44;44;6;26;73;1;26;0;1;25;0;0;0
120200026;100;11;17;6;17;82;1;17;0;0;17;0;0;0
120200027;100;27;27;7;30;69;1;30;2;1;27;0;0;0
120200028;200;205;207;2;107;92;1;107;3;1;103;0;0;0
120200029;100;83;83;5;47;52;1;47;4;0;43;0;0;0
120200030;100;95;95;6;54;45;1;54;1;6;47;0;0;0
120200031;100;24;24;7;23;76;1;23;0;1;22;0;0;0
120200032;100;26;25;5;19;80;1;19;0;0;19;0;0;0
120200033;100;39;39;3;24;75;1;24;2;0;22;0;0;0
120200034;100;139;141;4;75;24;1;75;5;2;68;0;0;0
120200035;100;133;135;5;67;32;1;67;5;1;61;0;0;0
120200036;300;563;565;7;206;144;1;155;6;1;148;51;6;45
120200037;300;576;578;7;245;112;1;187;16;6;165;58;4;54
120200038;300;473;477;2;261;58;2;240;14;2;224;21;0;21
120200039;300;467;468;4;223;81;1;218;16;3;199;5;0;5
120200040;300;415;416;1;213;97;1;202;17;2;183;11;0;11
120200041;100;34;34;0;34;66;0;34;0;2;32;0;0;0
120400001;600;633;633;5;271;366;1;233;11;5;217;38;3;35
120400002;400;479;479;7;211;211;1;188;12;5;171;23;0;23
120400003;150;150;150;6;73;76;1;73;5;0;68;0;0;0
120400004;500;493;494;0;271;230;1;269;0;0;269;2;0;2
120400005;500;524;529;0;271;235;2;263;15;1;247;8;0;8
120400006;600;638;636;1;270;356;1;243;13;2;228;27;0;27
120400007;450;488;489;1;271;180;2;268;13;1;254;3;0;3
120400008;400;406;407;5;161;251;1;148;11;4;133;13;0;13
120400009;260;266;267;5;137;122;1;137;5;3;129;0;0;0
120400010;350;367;368;1;231;118;1;231;11;2;218;0;0;0
120400011;50;38;38;2;26;23;1;26;1;1;24;0;0;0
120400012;50;45;45;6;27;22;1;27;0;0;27;0;0;0
120400013;140;139;134;2;89;49;2;89;4;1;84;0;0;0
120400014;350;355;355;1;168;209;1;140;13;3;124;28;3;25
120400015;500;527;527;2;292;210;2;288;28;2;258;4;0;4
120400016;400;465;465;0;253;169;1;230;17;3;210;23;1;22
120400017;500;538;538;1;268;258;3;239;10;3;226;29;1;28
120400018;230;218;218;2;140;89;1;140;9;0;131;0;0;0
120400019;70;42;42;2;25;44;1;25;4;0;21;0;0;0
120700001;470;524;546;3;192;311;1;158;12;2;144;34;0;34
120700002;300;354;371;0;136;187;1;112;7;1;104;24;1;23
120700003;300;291;305;3;165;132;3;165;9;4;152;0;0;0
120700004;100;84;87;4;60;39;1;60;8;1;51;0;0;0
120700005;100;101;103;1;62;37;1;62;2;0;60;0;0;0
120700006;100;107;107;5;72;27;1;72;6;5;61;0;0;0
120700007;400;467;489;0;252;160;1;239;22;4;213;13;0;13
120700008;300;294;309;4;148;151;1;148;15;2;131;0;0;0
120700009;400;418;423;2;161;253;1;146;3;0;143;15;0;15
120700010;500;505;519;2;234;280;4;216;19;6;191;18;1;17
120700011;270;277;288;3;183;86;1;183;8;3;172;0;0;0
120700012;100;97;101;5;57;42;1;57;0;1;56;0;0;0
120700013;40;37;37;0;34;4;2;34;2;1;31;0;0;0
120700014;50;35;35;1;33;16;1;33;1;0;32;0;0;0
120700015;40;28;28;0;27;12;1;27;0;0;27;0;0;0
120700016;30;23;23;0;23;6;1;23;1;0;22;0;0;0
121100001;400;448;448;1;114;311;1;88;4;1;83;26;3;23
121100002;400;480;482;1;172;273;4;123;3;2;118;49;1;48
121100003;400;474;474;2;159;276;1;123;7;5;111;36;1;35
121100004;600;603;603;1;255;349;1;250;14;3;233;5;0;5
121100005;700;668;668;3;211;520;1;179;8;2;169;32;0;32
121100006;100;29;28;2;10;89;1;10;0;0;10;0;0;0
121100007;300;347;347;3;174;142;0;158;6;3;149;16;0;16
121100008;400;427;429;4;246;163;1;236;19;1;216;10;1;9
121100009;300;309;311;3;129;189;1;110;10;0;100;19;0;19
121100010;100;54;54;3;28;71;1;28;1;0;27;0;0;0
121100011;300;339;339;0;133;175;1;124;7;0;117;9;0;9
121100012;200;222;222;0;94;105;1;94;7;1;86;0;0;0
121100013;100;33;33;6;24;75;1;24;1;1;22;0;0;0
121100014;200;165;165;3;72;127;1;72;3;2;67;0;0;0
121100015;300;322;322;4;147;162;1;137;7;1;129;10;1;9
121100016;300;251;251;6;84;215;1;84;6;1;77;0;0;0
121100017;300;239;239;5;94;203;3;94;1;1;92;0;0;0
121100018;200;153;153;6;62;136;2;62;0;2;60;0;0;0
121100019;800;779;780;6;430;378;1;421;12;5;404;9;0;9
121100020;500;489;489;0;307;192;1;307;0;1;306;0;0;0
121100021;100;90;90;3;48;51;1;48;0;0;48;0;0;0
121200001;600;659;659;7;227;445;1;154;2;6;146;73;2;71
121200002;1030;1124;1127;0;349;664;17;349;16;1;332;0;0;0
121200003;500;499;499;5;203;378;1;121;5;5;111;82;4;78
121200004;700;743;743;1;233;544;1;155;3;2;150;78;5;73
121200005;650;652;652;3;228;521;3;126;2;5;119;102;5;97
121200006;400;445;445;2;136;318;1;81;4;0;77;55;0;55
121200007;300;347;347;0;134;212;1;87;8;0;79;47;1;46
121200008;400;408;409;2;128;310;1;89;2;1;86;39;1;38
121200009;300;325;325;0;178;121;1;178;5;9;164;0;0;0
121200010;80;72;72;6;56;23;1;56;2;1;53;0;0;0
121200011;50;33;33;6;29;20;1;29;1;1;27;0;0;0
121200012;300;281;282;5;117;182;1;117;6;3;108;0;0;0
121200013;150;151;151;4;73;76;1;73;1;1;71;0;0;0
121200014;50;27;27;3;18;31;1;18;1;0;17;0;0;0
121200015;140;140;140;4;85;54;1;85;5;3;77;0;0;0
121200016;130;135;136;6;93;36;1;93;5;0;88;0;0;0
121200017;220;94;94;30;89;130;1;89;3;6;80;0;0;0
121400001;100;78;78;5;60;38;2;60;1;1;58;0;0;0
121400002;200;182;183;3;127;72;1;127;3;3;121;0;0;0
121400003;200;328;332;2;152;64;1;135;10;2;123;17;0;17
121400004;100;50;52;2;35;64;1;35;1;0;34;0;0;0
121400005;300;262;267;3;130;168;2;130;2;7;121;0;0;0
121400006;100;71;73;4;54;45;1;54;3;3;48;0;0;0
121400007;200;118;120;2;76;123;1;76;3;4;69;0;0;0
121400008;100;21;21;5;17;82;1;17;1;0;16;0;0;0
121400009;100;79;82;6;53;46;1;53;5;4;44;0;0;0
121400010;200;370;382;5;178;42;1;157;8;6;143;21;1;20
121400011;200;153;153;5;91;108;1;91;4;4;83;0;0;0
121400012;100;53;53;7;34;65;1;34;1;0;33;0;0;0
121400013;50;11;11;2;13;37;0;13;2;0;11;0;0;0
121400014;50;21;21;0;21;29;0;21;0;0;21;0;0;0
122400001;600;591;597;5;250;398;1;201;4;4;193;49;1;48
122400002;600;569;578;3;213;461;1;138;4;4;130;75;2;73
122400003;500;495;498;6;156;395;1;104;3;1;100;52;3;49
122400004;300;330;331;6;112;220;1;79;1;1;77;33;1;32
122400005;400;399;403;4;137;307;2;91;4;0;87;46;1;45
122400006;400;430;430;5;150;290;1;109;1;1;107;41;0;41
122400007;600;615;618;4;212;397;0;203;6;3;194;9;0;9
122400008;600;572;573;6;202;484;1;115;4;1;110;87;1;86
122400009;500;482;485;2;141;402;2;96;5;1;90;45;3;42
122400010;500;450;451;5;141;410;1;89;4;1;84;52;2;50
122400011;600;588;588;8;183;492;2;106;0;7;99;76;2;74
122400012;500;501;501;6;170;374;2;124;1;4;119;46;2;44
122400013;400;388;388;5;135;301;2;97;1;6;90;38;1;37
122400014;600;530;532;4;179;426;1;173;6;6;161;6;0;6
122400015;600;571;574;7;173;489;1;110;7;0;103;63;2;61
122400016;600;572;573;5;190;478;2;120;4;1;115;70;4;66
122400017;700;679;680;6;249;447;8;245;4;0;241;4;0;4
122400018;600;649;649;0;250;355;0;245;19;2;224;5;0;5
122400019;500;466;470;6;151;401;2;97;5;0;92;54;3;51
122400020;600;578;580;4;201;397;2;201;7;3;191;0;0;0
122400021;500;506;506;3;143;360;1;139;1;2;136;4;0;4
122400022;400;463;463;5;136;290;0;110;5;0;105;26;1;25
122400023;500;503;505;8;177;382;1;117;1;4;112;60;4;56
122400024;500;535;539;8;155;393;1;106;6;2;98;49;1;48
122400025;500;491;491;7;108;419;1;80;12;0;68;28;0;28
122400026;500;487;490;2;132;386;1;113;8;3;102;19;3;16
122400027;700;681;689;5;169;542;0;158;7;1;150;11;0;11
122400028;500;549;550;7;115;399;1;100;14;1;85;15;1;14
122400029;500;507;513;2;120;403;1;96;12;0;84;24;1;23
122400030;500;531;534;6;152;361;1;138;9;5;124;14;0;14
122400031;700;733;735;8;137;590;1;109;7;1;101;28;1;27
122400032;500;524;527;7;93;414;1;85;17;1;67;8;0;8
122400033;1000;1076;1085;7;223;776;1;223;17;0;206;0;0;0
122400034;400;360;360;6;168;238;1;161;12;0;149;7;0;7
122400035;200;77;156;0;77;122;1;77;2;1;74;0;0;0
122400036;400;437;437;7;143;283;1;116;11;1;104;27;1;26
122400037;300;283;283;4;114;185;1;114;4;1;109;0;0;0
122400038;200;223;223;4;132;67;1;132;1;2;129;0;0;0
122400039;300;367;371;4;192;122;1;177;0;1;176;15;0;15
122400040;500;520;535;2;252;281;1;218;20;0;198;34;1;33
122400041;500;473;476;1;233;278;1;221;23;2;196;12;0;12
122400042;100;115;115;4;73;26;1;73;6;0;67;0;0;0
122400043;200;129;185;13;129;70;1;129;23;1;105;0;0;0
122400044;100;46;46;6;22;77;1;22;0;0;22;0;0;0
122400045;400;430;432;5;188;229;2;169;11;2;156;19;1;18
122400046;300;359;361;2;186;135;1;164;8;2;154;22;0;22
122400047;200;186;186;3;122;77;1;122;10;5;107;0;0;0
122400048;400;359;359;5;111;329;0;71;0;0;71;40;1;39
122400049;600;600;600;5;180;499;1;100;2;4;94;80;3;77
122400050;100;71;71;5;76;23;1;76;0;0;76;0;0;0
122400051;100;30;30;6;34;62;4;34;0;1;33;0;0;0
122400052;100;15;15;11;26;73;1;26;7;0;19;0;0;0
122400053;100;10;10;28;38;61;1;38;0;0;38;0;0;0
122600001;250;235;235;3;129;120;1;129;10;0;119;0;0;0
122600002;80;70;70;5;40;39;1;40;0;2;38;0;0;0
122600003;780;752;768;2;366;434;4;342;16;2;324;24;0;24
122600004;550;539;541;0;208;357;1;192;12;2;178;16;0;16
122600005;380;359;362;3;170;224;1;155;9;4;142;15;0;15
122600006;430;395;399;3;127;327;1;102;2;0;100;25;0;25
122600007;500;476;476;4;200;315;1;184;16;5;163;16;0;16
122600008;30;24;24;0;24;5;1;24;2;0;22;0;0;0
122900001;300;582;583;5;201;207;1;92;3;2;87;109;6;103
122900002;300;564;566;4;213;150;2;148;2;6;140;65;2;63
122900003;400;700;703;8;226;301;1;98;1;0;97;128;5;123
122900004;400;768;770;6;288;240;5;155;4;5;146;133;6;127
122900005;300;519;519;7;184;204;1;95;0;2;93;89;5;84
122900006;400;768;768;9;256;272;4;124;3;6;115;132;4;128
122900007;400;797;797;3;286;254;1;145;3;2;140;141;6;135
122900008;300;587;590;6;167;217;1;82;1;4;77;85;8;77
122900009;400;811;811;5;255;276;1;123;1;3;119;132;4;128
122900010;300;563;565;5;196;200;1;99;4;3;92;97;6;91
122900011;300;629;631;4;212;186;1;113;3;3;107;99;7;92
122900012;400;705;705;8;238;284;1;115;1;2;112;123;5;118
122900013;400;718;718;5;247;277;1;122;5;4;113;125;6;119
122900014;300;467;470;3;140;220;2;78;1;1;76;62;1;61
122900015;400;742;744;9;212;293;2;105;3;3;99;107;1;106
122900016;300;677;678;3;193;190;1;109;4;3;102;84;5;79
122900017;400;764;764;7;196;285;1;114;1;1;112;82;4;78
122900018;300;586;586;6;192;189;1;110;6;6;98;82;6;76
122900019;300;576;576;7;147;240;1;59;2;1;56;88;1;87
122900020;300;561;561;5;142;228;1;71;1;0;70;71;3;68
122900021;300;539;540;10;185;236;1;63;0;0;63;122;5;117
122900022;300;592;594;8;208;194;1;105;2;3;100;103;5;98
122900023;300;618;621;8;204;189;1;110;3;6;101;94;5;89
122900024;300;634;637;5;153;209;1;90;2;2;86;63;1;62
122900025;400;802;803;5;197;290;1;109;5;1;103;88;8;80
122900026;400;773;774;4;196;290;1;109;5;2;102;87;2;85
122900027;400;804;804;8;241;296;1;103;1;3;99;138;6;132
122900028;300;683;683;4;185;175;1;124;1;6;117;61;4;57
122900029;300;604;607;8;165;183;1;116;0;6;110;49;1;48
122900030;400;795;795;9;205;241;1;158;5;2;151;47;4;43
122900031;400;698;699;7;139;318;1;81;4;2;75;58;2;56
122900032;400;854;854;6;230;284;1;115;3;5;107;115;4;111
122900033;400;808;810;6;232;299;0;101;1;4;96;131;7;124
122900034;300;708;709;8;203;188;1;111;2;4;105;92;5;87
122900035;300;638;641;6;165;206;2;92;0;0;92;73;3;70
122900036;300;676;676;6;196;209;1;90;4;1;85;106;3;103
122900037;300;682;684;5;199;213;2;85;3;1;81;114;5;109
122900038;300;555;565;9;179;220;1;79;0;2;77;100;3;97
122900039;400;773;775;6;262;279;1;120;4;6;110;142;6;136
122900040;300;625;626;5;210;190;1;109;2;4;103;101;4;97
122900041;300;601;603;0;232;199;1;100;1;3;96;132;2;130
122900042;200;448;460;3;121;142;1;57;0;0;57;64;2;62
122900043;200;460;460;6;166;123;1;76;1;3;72;90;1;89
122900044;300;520;520;6;184;209;2;89;2;1;86;95;5;90
122900045;300;560;561;5;124;210;1;89;8;3;78;35;1;34
122900046;500;937;937;7;217;300;2;198;11;2;185;19;1;18
122900047;300;611;612;7;165;209;1;90;3;1;86;75;4;71
122900048;300;533;533;7;140;214;2;84;1;3;80;56;4;52
122900049;400;695;697;4;198;289;1;110;5;2;103;88;3;85
122900050;300;641;641;5;216;192;1;107;4;4;99;109;4;105
122900051;300;677;678;4;155;227;1;72;1;3;68;83;6;77
122900052;400;704;706;1;210;309;1;90;2;2;86;120;6;114
122900053;300;545;548;8;175;207;1;92;2;3;87;83;2;81
122900054;300;602;604;8;166;216;2;82;4;2;76;84;8;76
122900055;500;1025;1026;5;456;71;0;429;45;8;376;27;0;27
122900056;500;1024;1026;4;466;66;1;433;39;0;394;33;0;33
122900057;200;236;236;6;136;63;1;136;6;1;129;0;0;0
122900058;300;272;272;3;141;159;0;141;13;5;123;0;0;0
122900059;300;436;443;6;172;145;1;154;13;5;136;18;0;18
122900060;300;404;448;3;261;133;1;166;3;11;152;95;4;91
122900061;200;202;202;5;86;113;1;86;4;3;79;0;0;0
122900062;300;299;299;6;126;173;1;126;6;3;117;0;0;0
122900063;100;58;58;5;41;58;1;41;1;0;40;0;0;0
122900064;600;845;852;5;405;202;3;395;11;5;379;10;0;10
122900065;200;91;114;6;55;144;1;55;2;1;52;0;0;0
122900066;300;339;357;2;230;67;3;230;10;4;216;0;0;0
122900067;300;469;469;2;211;120;1;179;7;2;170;32;0;32
122900068;200;161;161;5;115;83;2;115;2;1;112;0;0;0
122900069;200;126;126;5;62;137;1;62;1;2;59;0;0;0
122900070;100;74;74;7;52;47;1;52;0;2;50;0;0;0
122900071;200;214;220;4;128;71;1;128;8;7;113;0;0;0
122900072;200;196;199;6;128;71;1;128;0;1;127;0;0;0
122900073;300;325;332;2;153;171;1;128;6;3;119;25;1;24
122900074;200;220;221;4;112;87;1;112;1;2;109;0;0;0
122900075;500;674;708;2;382;127;1;372;12;10;350;10;0;10
122900076;300;388;402;2;167;174;1;125;8;3;114;42;0;42
122900077;300;353;354;7;131;198;1;101;5;2;94;30;0;30
122900078;200;194;195;0;110;88;2;110;6;2;102;0;0;0
122900079;100;69;69;6;53;45;2;53;5;0;48;0;0;0
122900080;100;42;42;2;43;56;1;43;1;1;41;0;0;0
122900081;100;61;61;0;59;41;0;59;1;0;58;0;0;0
122900082;100;27;27;0;26;73;1;26;0;0;26;0;0;0
122900083;100;38;38;1;39;60;1;39;1;0;38;0;0;0
122900084;100;16;16;37;53;46;1;53;0;1;52;0;0;0
123600001;470;469;474;2;215;288;1;181;6;6;169;34;1;33
123600002;540;543;551;3;269;342;2;196;11;11;174;73;4;69
123600003;440;440;444;4;224;274;1;165;9;4;152;59;3;56
123600004;220;216;216;2;84;135;1;84;6;2;76;0;0;0
123600005;250;245;245;3;138;112;0;138;7;5;126;0;0;0
123600006;330;329;342;2;209;147;1;182;6;4;172;27;0;27
123600007;150;143;144;2;105;44;1;105;5;0;100;0;0;0
123600008;170;152;155;3;129;40;1;129;2;1;126;0;0;0
123600009;180;169;170;3;104;75;1;104;2;5;97;0;0;0
123600010;70;60;61;4;41;28;1;41;0;1;40;0;0;0
123600011;90;82;83;3;65;24;1;65;3;3;59;0;0;0
123600012;40;27;28;6;21;18;1;21;1;0;20;0;0;0
123600013;25;19;19;0;19;6;0;19;1;0;18;0;0;0
123600014;25;20;20;2;22;2;1;22;1;0;21;0;0;0
123800001;260;268;269;2;132;127;1;132;4;0;128;0;0;0
123800002;320;315;317;3;151;192;1;127;7;0;120;24;0;24
123800003;380;386;387;5;175;231;1;148;14;5;129;27;1;26
123800004;220;229;229;2;117;102;1;117;9;1;107;0;0;0
123800005;360;364;364;2;139;234;1;125;6;2;117;14;0;14
123800006;240;240;248;4;100;136;4;100;0;3;97;0;0;0
123800007;580;584;584;1;296;284;1;295;3;0;292;1;0;1
123800008;340;348;348;2;77;276;1;63;5;1;57;14;1;13
123800009;300;311;311;2;139;184;1;115;5;2;108;24;0;24
130300001;400;441;441;2;177;284;1;115;7;3;105;62;0;62
130300002;400;396;396;2;173;302;1;97;1;3;93;76;5;71
130300003;600;586;586;0;232;442;1;157;4;4;149;75;5;70
130300004;500;496;498;4;174;403;1;96;5;5;86;78;2;76
130300005;500;513;513;0;167;401;1;98;1;1;96;69;1;68
130300006;700;793;793;0;340;392;1;307;13;2;292;33;2;31
130300007;600;665;677;4;249;376;1;223;10;6;207;26;1;25
130300008;700;692;711;6;378;349;1;350;10;14;326;28;2;26
130300009;500;478;485;5;208;323;2;175;1;2;172;33;1;32
130300010;100;46;46;0;46;52;2;46;1;0;45;0;0;0
130400001;800;869;871;2;291;604;1;195;16;1;178;96;2;94
130400002;800;851;853;2;323;582;1;217;4;7;206;106;6;100
130400003;800;785;785;1;245;618;1;181;16;4;161;64;3;61
130400004;800;798;798;1;300;614;1;185;14;5;166;115;2;113
130400005;400;374;374;4;155;279;1;120;4;2;114;35;0;35
130400006;800;754;754;0;259;608;2;190;19;0;171;69;5;64
130400007;400;365;367;4;141;285;1;114;1;6;107;23;2;23
130400008;700;734;734;0;316;460;1;239;10;20;209;77;5;72
130400009;900;885;886;3;426;555;1;344;13;5;326;82;3;79
130400011;300;327;327;2;120;203;1;96;5;1;90;24;0;24
130400012;300;329;329;3;134;222;1;77;3;2;72;57;0;57
130600001;700;672;672;6;191;579;2;119;3;2;114;72;0;72
130600002;500;574;574;2;170;390;1;109;3;4;102;61;1;60
130600003;500;446;446;3;150;359;1;140;4;4;132;10;0;10
130600004;500;513;513;1;137;415;1;84;1;3;80;53;0;53
130600005;500;597;597;2;187;387;1;112;3;0;109;75;0;75
130600006;500;443;443;0;44;455;1;44;6;0;38;0;0;0
130600007;300;387;387;6;149;175;1;124;8;4;112;25;0;25
130600008;300;318;319;5;130;183;1;116;6;2;108;14;0;14
130600009;500;516;517;1;144;376;1;123;5;2;116;21;2;19
130600010;500;566;568;4;145;377;1;122;5;2;115;23;0;23
130600011;400;424;427;3;150;284;1;115;8;3;104;35;1;34
130600012;600;598;599;1;112;487;1;112;6;1;105;0;0;0
130600013;500;549;549;6;99;420;2;78;9;1;68;21;1;20
130600014;300;334;336;2;103;229;2;69;2;1;66;34;1;33
130600015;300;294;294;4;90;209;1;90;4;3;83;0;0;0
130600016;100;39;39;7;20;79;1;20;1;0;19;0;0;0
130800001;500;840;840;4;250;366;2;132;2;5;125;118;5;113
130800002;500;993;993;4;188;380;2;118;5;4;109;70;2;68
130800003;500;905;905;6;231;375;1;124;1;5;118;107;1;106
130800004;500;917;919;4;280;337;1;162;6;1;155;118;2;116
130800005;500;858;858;4;248;387;1;112;10;4;98;136;9;127
130800006;500;856;856;6;316;322;1;177;2;8;167;139;5;134
130800007;500;854;870;2;245;393;2;105;0;2;103;140;3;137
130800008;500;1061;1061;2;50;460;1;39;6;0;33;11;0;11
130800009;500;867;867;9;307;276;1;223;7;6;210;84;4;80
130800010;500;907;910;3;293;330;2;168;8;6;154;125;3;122
130800011;500;971;972;4;284;216;1;283;12;6;265;1;0;1
130800012;500;984;985;8;226;381;1;118;4;2;112;108;0;108
130800013;500;821;821;3;283;299;1;200;7;4;189;83;3;80
130800014;500;956;960;3;343;296;1;203;6;4;193;140;8;132
130800015;500;894;895;5;276;342;1;157;3;2;152;119;5;114
130800016;500;888;888;3;253;364;1;135;7;0;128;118;3;115
130800017;500;872;875;2;265;338;1;161;3;1;157;104;8;96
130800018;500;908;908;1;269;318;1;181;7;2;172;88;3;85
130800019;500;891;891;2;187;395;1;104;2;4;98;83;5;78
130800020;500;1061;1061;0;3;496;1;3;0;0;3;0;0;0
130800021;500;969;969;4;145;406;1;93;1;1;91;52;2;50
130800022;500;928;928;4;238;287;2;211;1;7;203;27;0;27
130800023;300;250;250;5;140;158;2;140;1;3;136;0;0;0
130800024;300;206;206;5;137;162;1;137;1;0;136;0;0;0
130800025;200;153;153;4;129;70;1;129;0;0;129;0;0;0
130800026;100;65;65;15;64;36;0;64;4;1;59;0;0;0
130800027;100;24;24;3;24;75;1;24;5;0;19;0;0;0
130800028;200;30;30;36;66;133;1;66;3;1;62;0;0;0
130800029;200;62;62;25;59;137;1;59;0;6;53;0;0;0
130800036;700;1069;1069;0;266;491;1;208;17;4;187;58;4;54
130800037;700;1015;1016;3;243;500;2;198;15;2;181;45;0;45
130800038;700;1025;1026;4;239;516;1;183;6;1;176;56;2;54
130800039;700;932;933;4;232;517;1;182;13;0;169;50;2;48
130800041;700;771;771;8;321;437;1;262;26;1;235;59;0;59
130800042;300;221;222;7;77;222;1;77;5;1;71;0;0;0
130800043;800;674;674;4;251;571;1;228;16;3;209;23;1;22
130800044;700;555;555;4;237;486;1;213;12;3;198;24;2;22
130800045;300;208;208;4;130;169;1;130;12;0;118;0;0;0
130800046;800;676;676;4;345;448;11;341;11;4;326;4;1;3
130800047;400;320;320;3;190;209;1;190;14;1;175;0;0;0
130800048;200;120;120;4;92;107;1;92;0;0;92;0;0;0
130800049;200;173;173;3;69;130;1;69;5;0;64;0;0;0
130800050;200;136;136;4;73;126;1;73;1;0;72;0;0;0
130800051;400;311;311;6;166;246;2;152;7;1;144;14;0;14
130800052;200;151;151;5;64;136;0;64;0;0;64;0;0;0
130800053;200;110;110;5;74;125;1;74;8;0;66;0;0;0
130800054;200;156;156;5;112;87;1;112;7;2;103;0;0;0
130800055;400;306;306;5;172;235;1;164;18;0;146;8;0;8
130800056;1000;834;836;7;437;570;1;429;8;1;420;8;0;8
130800057;200;143;143;3;67;132;1;67;6;0;61;0;0;0
130800058;100;21;21;8;14;85;1;14;0;0;14;0;0;0
131400001;500;604;612;4;259;265;1;234;7;4;223;25;1;24
131400002;400;237;471;3;237;180;1;219;15;3;201;18;0;18
131400003;250;301;301;1;83;166;1;83;4;1;78;0;0;0
131400004;400;469;470;0;154;257;1;142;2;5;135;12;0;12
131400005;350;462;464;1;162;218;1;131;2;4;125;31;2;29
131400006;250;294;294;5;137;112;1;137;12;3;122;0;0;0
131400007;500;681;681;0;157;370;1;129;4;0;125;28;0;28
131400008;200;195;200;0;95;104;1;95;4;4;87;0;0;0
131400009;50;26;26;3;17;32;1;17;0;0;17;0;0;0
131400010;550;633;633;5;187;375;1;174;19;0;155;13;0;13
131400011;50;16;16;0;16;33;1;16;2;0;14;0;0;0
131900001;400;613;614;6;201;303;1;96;3;1;92;105;4;101
131900002;500;717;747;9;257;364;1;135;3;2;130;122;5;117
131900003;400;654;655;8;233;260;1;139;2;0;137;94;7;87
131900004;400;664;664;10;246;299;1;100;4;1;95;146;2;144
131900005;500;813;818;6;333;320;2;178;4;2;172;155;13;142
131900006;600;967;968;5;353;265;1;334;1;6;327;19;0;19
131900007;600;878;907;7;314;443;2;155;3;1;151;159;9;150
131900008;500;783;785;9;303;374;3;123;2;3;118;180;3;177
131900009;500;820;823;7;282;372;4;124;4;2;118;158;6;152
131900010;300;547;548;5;176;199;3;98;3;2;93;78;3;75
131900011;400;725;726;8;264;272;1;127;2;7;118;137;9;128
131900012;400;615;616;5;189;228;1;171;0;6;165;18;2;16
131900013;400;590;591;5;206;304;1;95;3;6;86;111;3;108
131900014;500;805;806;8;315;339;1;160;1;6;153;155;4;151
131900015;500;759;759;8;219;391;1;108;2;0;106;111;0;111
131900016;500;854;856;4;236;399;1;100;0;0;100;136;0;136
131900017;400;707;709;7;254;278;2;120;3;4;113;134;5;129
131900018;500;783;786;6;273;386;1;113;3;4;106;160;5;155
131900019;400;650;651;6;233;292;1;107;3;0;104;126;13;113
131900020;400;587;587;1;194;305;1;94;2;3;89;100;4;96
131900021;500;862;862;7;323;326;1;173;3;2;168;150;7;143
131900022;400;709;710;9;245;273;1;126;2;3;121;119;6;113
131900023;400;726;726;8;263;284;2;114;4;2;108;149;2;147
131900024;400;668;693;10;222;283;1;116;9;1;106;106;1;105
131900025;500;736;737;8;175;410;1;89;3;1;85;86;0;86
131900026;400;598;597;1;159;319;1;80;3;2;75;79;4;75
131900027;400;681;681;8;108;332;1;67;5;1;61;41;1;40
131900028;500;850;850;4;259;366;1;133;5;2;126;126;7;119
131900029;300;535;543;13;160;217;5;78;4;1;73;82;7;75
131900030;400;580;582;4;191;305;2;93;1;1;91;98;6;92
131900031;500;754;755;3;246;350;2;148;1;6;141;98;2;96
131900032;500;777;777;5;280;381;1;118;5;7;106;162;5;157
131900033;400;693;714;9;297;253;2;145;6;1;138;152;7;145
131900034;600;928;928;7;326;426;1;173;5;5;163;153;3;150
131900035;500;798;813;6;265;351;1;148;6;8;134;117;4;113
131900036;500;890;891;5;265;369;1;130;6;2;122;135;4;131
131900037;500;774;774;6;120;437;1;62;1;1;60;58;3;55
131900038;500;771;772;8;248;394;1;105;2;2;101;143;7;136
131900039;200;314;314;6;100;129;1;70;0;3;67;30;1;29
131900040;500;741;755;6;260;383;2;115;1;3;111;145;2;143
131900041;600;902;901;6;287;454;1;145;1;2;142;142;5;137
131900042;300;540;541;7;82;251;1;48;1;0;47;34;1;33
131900043;600;975;975;4;63;539;1;60;3;0;57;3;0;3
131900044;700;1016;1016;7;30;675;1;24;3;0;21;6;0;6
131900045;400;617;619;5;181;298;1;101;0;0;101;80;1;79
131900046;400;656;670;8;229;293;1;106;6;1;99;123;1;122
131900047;500;795;795;8;214;351;1;148;7;2;139;66;1;65
131900048;500;744;745;7;229;384;1;115;0;5;110;114;5;109
131900049;300;513;513;3;128;243;1;56;0;2;54;72;6;66
131900050;400;720;720;8;220;291;1;108;3;4;101;112;8;104
131900051;300;504;505;11;74;256;1;43;2;0;41;31;1;30
131900052;400;692;691;3;111;344;1;55;0;1;54;56;2;54
131900053;400;677;677;0;28;371;2;27;4;0;23;1;0;1
131900054;400;629;630;13;70;344;1;55;4;1;50;15;0;15
131900055;300;531;528;7;120;239;1;60;2;2;56;60;3;57
131900056;400;685;684;8;172;319;1;80;1;3;76;92;0;92
131900057;500;782;783;6;196;390;1;109;5;4;100;87;1;86
131900058;600;841;842;4;257;457;1;142;2;8;132;115;7;108
131900059;400;722;724;8;191;330;1;69;3;1;65;122;6;116
131900060;500;835;836;7;57;442;1;57;3;1;53;0;0;0
131900061;400;737;738;8;21;399;1;0;0;0;0;21;0;21
131900062;500;809;810;9;267;368;1;131;4;1;126;136;5;131
131900063;300;489;490;6;158;205;1;94;0;0;94;64;6;58
131900064;300;497;498;5;140;221;1;78;0;1;77;62;0;62
131900065;600;848;850;6;214;468;1;131;3;2;126;83;1;82
131900066;500;773;775;8;177;418;1;81;4;2;75;96;5;91
131900067;500;762;762;6;208;403;1;96;1;6;89;112;4;108
131900068;400;629;630;2;160;319;2;79;2;2;75;81;2;79
131900069;500;791;790;7;220;382;7;111;6;1;104;109;5;104
131900070;500;773;773;8;205;412;2;86;1;0;85;119;7;112
131900071;400;649;649;6;225;283;1;116;3;1;112;109;3;106
131900072;500;759;759;5;78;461;1;38;1;1;36;40;4;36
131900073;400;628;628;6;119;340;1;59;2;1;56;60;4;56
131900074;400;704;707;8;172;324;1;75;2;0;73;97;6;91
131900075;400;672;672;6;255;284;1;115;0;5;110;140;3;137
131900076;400;641;641;3;54;365;1;34;5;0;29;20;0;20
131900077;700;1005;1006;6;55;649;1;50;12;0;38;5;0;5
131900078;500;804;805;9;190;415;1;84;3;1;80;106;3;103
131900079;400;656;657;9;238;279;2;119;3;2;114;119;4;115
131900080;400;655;660;8;220;282;2;116;3;5;108;104;2;102
131900081;400;727;734;7;205;306;1;93;2;3;88;112;5;107
131900082;300;540;539;3;128;246;1;53;2;3;48;75;2;73
131900083;600;957;956;4;28;575;1;24;1;0;23;4;0;4
131900084;600;917;917;6;44;555;1;44;8;1;35;0;0;0
131900085;600;996;996;6;55;552;2;46;5;0;41;9;0;9
131900086;400;728;728;5;51;348;1;51;5;0;46;0;0;0
131900087;400;622;623;7;150;328;1;71;0;2;69;79;5;74
131900088;200;216;218;5;108;91;1;108;1;9;98;0;0;0
131900089;400;636;636;7;28;381;1;18;1;0;17;10;0;10
131900090;400;580;582;5;205;323;1;76;3;2;71;129;6;123
131900091;500;792;792;4;31;467;4;29;5;0;24;2;0;2
131900092;100;33;33;34;35;64;1;35;0;0;35;0;0;0
131900093;100;31;31;10;21;78;1;21;1;0;20;0;0;0
131900094;100;23;23;32;53;43;4;53;3;1;49;0;0;0
131900095;200;117;117;11;51;148;1;51;15;0;36;0;0;0
131900099;100;18;18;6;24;75;1;24;1;0;23;0;0;0
131900100;100;18;18;5;23;77;0;23;0;0;23;0;0;0
131900151;500;830;830;8;172;340;2;158;3;1;154;14;1;13
131900152;600;969;970;2;154;449;1;150;27;0;123;4;0;4
131900153;400;642;645;2;133;319;1;80;4;3;73;53;1;52
131900154;300;345;345;5;145;162;2;136;11;0;125;9;1;8
131900155;400;708;709;5;203;270;1;129;7;6;116;74;5;69
131900156;700;1029;1030;6;205;503;1;196;17;0;179;9;0;9
131900157;400;716;717;0;225;255;1;144;5;4;135;81;7;74
131900158;400;561;559;4;138;302;1;97;2;2;93;41;2;39
131900159;300;565;565;4;143;198;1;101;4;3;94;42;2;40
131900160;400;575;576;4;152;283;2;115;3;5;107;37;4;33
131900161;300;466;467;3;135;239;2;59;2;1;56;76;1;75
131900162;400;701;701;7;231;184;1;215;25;0;190;16;0;16
131900163;400;676;676;3;203;250;1;149;6;2;141;54;1;53
131900164;400;627;627;2;206;253;1;146;7;5;134;60;1;59
131900165;300;503;503;3;153;206;1;93;3;6;84;60;1;59
131900166;500;832;834;3;194;363;1;136;10;4;122;58;1;57
131900167;400;701;701;1;137;307;1;92;1;1;90;45;1;44
131900168;500;879;881;3;141;400;1;99;9;1;89;42;2;40
131900169;400;741;749;3;219;275;1;124;6;3;115;95;2;93
131900170;500;866;867;2;134;431;1;68;7;2;59;66;2;64
131900171;200;330;334;5;152;61;1;138;4;2;132;14;1;13
131900172;400;727;728;7;129;311;1;88;1;10;77;41;2;39
131900173;500;801;803;3;130;403;1;96;2;5;89;34;1;33
131900174;600;971;971;3;40;564;1;35;8;0;27;5;0;5
131900175;400;707;707;4;136;328;2;70;4;2;64;66;1;65
131900176;300;478;479;3;212;151;2;147;8;5;134;65;1;64
131900177;400;756;757;4;176;248;2;150;7;0;143;26;0;26
131900178;500;814;816;1;230;371;1;128;10;6;112;102;5;97
131900179;400;564;564;1;158;268;1;131;7;2;122;27;1;26
131900180;500;770;770;0;110;420;2;78;3;1;74;32;1;31
131900181;300;483;484;1;151;207;1;92;3;3;86;59;3;56
131900182;300;426;426;3;122;220;1;79;4;0;75;43;0;43
131900183;300;458;458;1;186;171;1;128;0;1;127;58;2;56
131900184;200;154;154;2;49;150;1;49;0;3;46;0;0;0
131900185;500;811;833;3;215;344;4;152;3;2;147;63;3;60
131900186;400;738;741;4;206;245;1;154;4;7;143;52;0;52
131900187;500;873;883;3;294;277;1;222;18;0;204;72;2;70
131900188;300;414;413;1;151;210;1;89;4;0;85;62;2;60
131900189;400;643;643;4;162;265;1;134;7;2;125;28;1;27
131900190;400;547;550;0;70;337;4;59;3;1;55;11;0;11
131900191;400;738;739;3;188;296;1;103;1;1;101;85;1;84
131900192;500;879;881;3;196;349;1;150;5;1;144;46;0;46
131900193;400;707;710;4;306;134;1;265;13;3;249;41;3;38
131900194;200;163;163;1;70;129;1;70;3;1;66;0;0;0
131900195;300;380;380;5;124;179;3;118;7;0;111;6;1;5
131900196;200;206;207;5;73;126;1;73;2;2;69;0;0;0
131900197;400;747;748;5;266;186;2;212;12;3;197;54;3;51
131900198;200;135;135;5;78;121;1;78;2;3;73;0;0;0
131900200;300;510;510;2;189;167;1;132;9;5;118;57;1;56
131900201;400;669;670;2;71;336;1;63;4;0;59;8;0;8
131900202;300;447;449;0;131;224;1;75;2;3;70;56;2;54
131900203;400;639;639;3;136;313;1;86;3;1;82;50;1;49
131900204;500;788;788;5;204;357;1;142;5;6;131;62;4;58
131900205;400;663;663;4;197;205;1;194;16;2;176;3;0;3
132000001;900;896;896;0;269;764;1;135;4;1;130;134;5;129
132000002;800;806;808;0;228;706;1;93;5;6;82;135;4;131
132000003;800;909;911;0;317;618;1;181;6;4;171;136;5;131
132000004;400;893;894;0;258;237;2;161;6;4;151;97;4;93
132000005;1000;870;870;0;259;848;3;149;13;1;135;110;4;106
132000006;800;849;849;0;281;643;1;156;11;3;142;125;2;123
132000007;900;850;850;0;169;790;1;109;7;1;101;60;3;57
132000008;900;892;892;0;219;756;1;143;5;4;134;76;4;72
132000009;900;929;930;2;332;725;1;173;13;2;158;159;4;155
132000010;900;871;875;0;260;756;1;143;6;3;134;117;8;109
132000011;900;886;887;3;247;776;1;123;2;0;121;124;6;118
132000012;800;735;735;0;270;662;2;136;7;1;128;134;7;127
132000013;700;668;669;0;213;577;1;122;6;0;116;91;3;88
132000014;900;908;911;4;277;761;1;138;3;4;131;139;3;136
132000015;900;890;891;0;176;799;1;100;3;0;97;76;1;75
132000016;800;816;818;0;261;640;1;159;9;2;148;102;0;102
132000017;900;919;919;0;295;743;1;156;6;4;146;139;4;135
132000018;600;548;549;5;198;448;1;151;7;1;143;47;1;46
132000019;800;817;819;3;254;645;2;153;10;1;142;101;6;95
132000020;500;513;513;3;179;354;1;145;9;0;136;34;1;33
132000021;500;519;519;3;148;377;1;122;15;1;106;26;0;26
132000022;900;883;885;0;220;773;1;126;7;4;115;94;3;91
132000023;200;210;210;5;76;123;1;76;1;4;71;0;0;0
132000024;600;596;596;2;129;481;1;118;18;1;99;11;2;9
132000025;800;775;777;0;221;645;3;152;10;4;138;69;1;68
132000026;600;723;725;4;164;472;2;126;7;3;116;38;1;37
132000027;300;11;11;42;47;252;1;47;2;1;44;0;0;0
132100001;1000;1207;1207;0;194;809;2;189;53;0;136;5;0;5
132100002;1000;1211;1211;7;182;877;1;122;33;0;89;57;3;57
132100003;500;441;441;2;182;386;2;112;3;3;106;70;2;68
132100004;800;869;871;5;248;632;1;167;15;3;149;81;4;77
132100005;1000;1050;1050;5;171;860;1;139;39;0;100;32;0;32
132100006;1000;1183;1183;3;234;806;3;191;45;0;146;43;0;43
132100007;600;560;560;3;219;382;0;218;8;6;204;1;0;1
132100008;600;598;598;2;229;403;1;196;3;3;190;33;3;30
132100009;800;806;808;5;322;573;1;226;12;9;205;96;0;96
132100010;600;541;543;4;245;441;1;158;6;4;148;87;3;84
132100011;600;609;609;0;230;443;1;156;8;4;144;74;2;72
132100012;600;528;528;0;207;469;1;130;6;1;123;77;2;75
132100013;500;452;452;3;168;393;1;106;1;0;105;62;4;58
132100014;600;587;588;3;225;473;2;125;4;4;117;100;3;97
132100015;500;445;445;0;178;391;1;108;2;5;101;70;1;69
132100016;600;583;585;7;226;458;1;141;7;2;132;85;3;82
132100017;600;526;526;3;195;487;1;112;6;6;100;83;6;77
132100018;700;608;608;5;220;551;2;147;8;9;130;73;2;71
132100019;900;848;852;0;331;701;2;197;8;5;184;134;0;134
132100020;700;719;722;3;261;552;1;147;7;8;132;114;1;113
132100021;700;738;738;3;258;542;1;157;8;4;145;101;4;97
132100022;500;419;420;8;167;401;1;98;7;4;87;69;1;68
132100023;1000;1204;1206;6;182;860;2;138;28;0;110;44;0;44
132100024;100;20;20;0;19;80;1;19;0;0;19;0;0;0
132100026;500;580;583;1;266;285;1;214;13;0;201;52;1;51
132100027;500;497;498;0;223;341;1;158;6;5;147;65;1;64
132100028;600;559;561;4;201;435;3;162;5;1;156;39;2;37
132400001;700;652;655;2;250;520;1;179;6;2;171;71;2;69
132400002;700;690;690;0;222;493;1;206;2;4;200;16;0;16
132400003;600;649;651;0;236;426;1;173;5;2;166;63;2;61
132400004;700;667;667;0;250;504;1;195;12;7;176;55;2;53
132400005;500;529;530;0;219;293;1;206;17;4;185;13;1;12
132400006;800;769;772;3;296;519;2;279;11;6;262;17;2;15
132400007;1000;157;1144;0;157;842;1;157;18;1;138;0;0;0
132400008;1000;1077;1077;1;241;758;1;241;17;0;224;0;0;0
132400009;800;761;761;5;247;552;1;247;14;3;230;0;0;0
132400010;1000;811;811;0;262;768;1;231;16;3;212;31;1;30
132400011;1000;976;977;0;391;630;1;369;18;7;344;22;1;21
132400012;1000;1021;1021;0;273;738;1;261;19;2;240;12;0;12
132400013;700;718;720;6;312;441;1;258;7;7;244;54;1;53
132400014;1000;930;930;0;341;713;1;286;17;6;263;55;0;55
132400015;700;669;670;3;314;425;1;274;12;1;261;40;0;40
132400016;700;683;684;0;136;592;1;107;8;1;98;29;0;29
132400017;100;15;15;0;15;84;1;15;0;0;15;0;0;0
132900001;1100;1055;1057;0;447;652;1;447;14;2;431;0;0;0
132900002;1100;1063;1063;4;416;683;1;416;28;0;388;0;0;0
132900003;800;832;833;1;232;644;1;155;5;6;144;77;2;75
132900004;700;731;734;0;214;544;1;155;5;3;147;59;2;57
132900005;800;820;820;0;292;595;1;204;9;4;191;88;2;86
132900006;800;750;750;1;263;611;1;188;7;4;177;75;1;74
132900007;800;753;753;0;253;637;1;162;7;6;149;91;3;88
132900008;800;806;807;1;275;642;3;155;4;5;146;120;4;116
132900009;600;608;608;1;239;396;1;203;13;6;184;36;4;32
132900010;900;875;876;3;288;678;1;221;20;4;197;67;0;67
132900011;800;819;820;4;231;634;1;165;9;3;153;66;1;65
132900012;600;609;611;1;217;437;1;162;7;0;155;55;2;53
132900013;700;657;657;1;162;591;1;108;4;1;103;54;0;54
132900014;900;920;921;1;395;531;1;368;28;2;338;27;0;27
132900015;600;535;537;4;136;505;1;94;6;5;83;42;0;42
132900016;500;494;494;0;126;414;1;85;0;0;85;41;0;41
132900017;500;537;537;2;168;358;1;141;8;4;129;27;4;23
132900018;600;246;583;3;249;363;1;236;17;5;214;13;1;12
132900019;500;513;516;2;210;345;1;154;8;1;145;56;1;55
132900020;100;18;18;4;10;89;1;10;1;1;8;0;0;0
132900021;800;348;778;4;348;460;1;339;16;0;323;9;0;9
132900022;900;857;859;2;309;653;3;244;17;5;222;65;1;64
132900023;1100;1114;1115;0;406;693;1;406;46;1;359;0;0;0
132900024;500;417;417;3;145;394;1;105;4;1;100;40;2;38
132900025;600;592;592;2;273;343;1;256;19;6;231;17;1;16
132900026;800;777;777;5;247;616;1;183;10;13;160;64;3;61
132900027;700;740;740;1;223;544;2;154;7;2;145;69;2;67
132900028;900;884;885;1;555;346;1;553;22;1;530;2;0;2
132900029;700;746;746;4;283;474;1;225;15;9;201;58;4;54
132900030;300;228;228;6;89;210;1;89;5;7;77;0;0;0
133200001;700;716;716;4;215;571;1;128;7;3;118;87;3;84
133200002;900;877;877;1;395;567;1;332;22;1;309;63;1;62
133200003;700;737;738;4;166;592;1;107;11;4;92;59;4;55
133200004;600;533;534;2;160;504;1;95;2;2;91;65;4;61
133200005;600;571;572;4;169;511;1;88;6;0;82;81;4;77
133200006;100;122;122;6;59;40;1;59;2;1;56;0;0;0
133200007;200;189;190;6;103;96;1;103;9;3;91;0;0;0
133200008;100;112;112;5;55;44;1;55;5;2;48;0;0;0
133200009;100;119;119;3;51;48;1;51;1;0;50;0;0;0
133900001;1000;943;1036;6;681;392;1;607;3;3;601;74;1;73
133900002;1000;890;991;3;698;361;1;638;9;5;624;60;0;60
133900003;1000;901;1007;4;581;481;1;518;4;2;512;63;0;63
133900004;500;544;542;2;329;170;1;329;10;0;319;0;0;0
133900005;500;569;569;4;307;207;1;292;13;5;274;15;0;15
133900006;300;299;299;0;257;43;0;257;0;0;257;0;0;0
133900007;200;126;126;0;124;75;1;124;0;0;124;0;0;0
140800001;800;826;827;7;146;714;4;82;2;3;77;64;2;62
140800002;800;792;794;5;215;667;1;132;4;4;124;83;6;77
140800003;800;780;780;8;230;668;1;131;4;12;115;99;6;93
140800004;800;802;805;2;202;694;1;105;1;1;103;97;4;93
140800005;100;23;23;10;17;82;1;17;0;2;15;0;0;0
140800006;100;14;14;6;20;79;1;20;1;0;19;0;0;0
140800007;100;26;25;8;23;76;1;23;0;0;23;0;0;0
140800008;100;35;35;5;19;80;1;19;0;0;19;0;0;0
140800009;100;74;74;6;50;49;1;50;1;2;47;0;0;0
140800010;100;14;41;8;22;77;1;22;0;0;22;0;0;0
140800011;100;23;23;6;16;83;1;16;0;0;16;0;0;0
140800012;100;53;53;6;22;77;1;22;1;0;21;0;0;0
140800013;100;71;71;7;31;68;1;31;1;2;28;0;0;0
140800014;100;60;60;7;27;72;1;27;0;1;26;0;0;0
140800015;200;95;95;7;41;158;1;41;0;3;38;0;0;0
140800016;100;38;38;7;25;74;1;25;1;1;23;0;0;0
140800017;100;29;29;7;24;75;1;24;0;0;24;0;0;0
140800018;200;101;104;5;62;137;1;62;1;1;60;0;0;0
140800019;200;138;141;1;55;144;1;55;2;0;53;0;0;0
140800020;100;88;89;6;38;61;1;38;0;2;36;0;0;0
140800021;100;35;35;5;17;82;1;17;1;0;16;0;0;0
140800022;500;426;428;2;141;395;1;104;2;2;100;37;2;35
140800023;200;111;111;6;48;151;1;48;3;1;44;0;0;0
140800024;100;70;70;6;38;61;1;38;2;2;34;0;0;0
140800025;200;175;176;5;62;137;1;62;1;0;61;0;0;0
141900001;300;259;260;7;119;180;1;119;6;3;110;0;0;0
141900002;600;505;509;2;212;463;1;136;6;2;128;76;7;69
141900003;500;442;444;2;143;395;2;103;2;1;100;40;4;36
141900004;100;50;50;5;37;61;2;37;1;0;36;0;0;0
141900005;100;41;48;8;27;72;1;27;3;0;24;0;0;0
141900006;200;104;104;6;74;125;1;74;4;1;69;0;0;0
141900007;100;55;57;8;32;67;1;32;1;3;28;0;0;0
141900008;100;82;82;7;47;52;1;47;2;0;45;0;0;0
141900009;100;25;25;7;20;79;1;20;0;1;19;0;0;0
141900010;100;52;52;7;31;68;1;31;1;1;29;0;0;0
141900011;100;42;42;7;31;68;1;31;2;0;29;0;0;0
141900012;200;99;107;7;74;125;1;74;3;1;70;0;0;0
141900013;100;60;60;5;44;54;2;44;0;3;41;0;0;0
141900014;100;24;24;0;24;76;0;24;0;1;23;0;0;0
142200001;100;71;71;5;45;54;1;45;0;0;45;0;0;0
142200002;100;73;73;5;44;55;1;44;3;1;40;0;0;0
142200003;200;164;187;5;93;105;2;93;1;4;88;0;0;0
142200004;300;194;194;5;107;192;1;107;4;2;101;0;0;0
142200005;100;44;44;6;34;65;1;34;0;0;34;0;0;0
142200006;200;147;147;3;112;87;1;112;4;5;103;0;0;0
142200007;300;207;207;5;109;190;1;109;6;3;100;0;0;0
142200008;200;116;116;3;76;122;2;76;6;1;69;0;0;0
142200009;100;23;23;5;13;86;1;13;0;1;12;0;0;0
142200010;100;20;20;6;18;81;1;18;8;0;10;0;0;0
143200001;400;574;575;9;149;321;1;78;3;1;74;71;3;68
143200002;300;448;450;6;123;239;1;60;0;2;58;63;4;59
143200003;600;924;927;3;279;460;1;139;3;1;135;140;8;132
143200004;300;519;519;6;157;220;1;79;2;3;74;78;4;74
143200005;300;476;476;7;124;231;1;68;0;2;66;56;4;52
143200006;300;476;477;5;131;206;1;93;3;1;89;38;1;37
143200007;300;497;498;5;141;243;1;56;2;1;53;85;4;81
143200008;400;575;575;6;156;311;1;88;2;7;79;68;1;67
143200009;400;621;622;7;191;300;2;98;4;2;92;93;1;92
143200010;500;864;871;7;285;361;1;138;2;1;135;147;9;138
143200011;400;588;589;9;201;290;3;107;2;3;102;94;4;90
143200012;300;534;535;7;193;206;1;93;4;3;86;100;4;96
143200013;500;724;736;11;243;378;2;120;0;1;119;123;5;118
143200014;300;431;431;6;149;210;2;88;2;2;84;61;3;58
143200015;300;529;529;6;137;236;5;59;3;0;56;78;0;78
143200016;300;495;496;4;132;218;2;80;5;2;73;52;2;50
143200017;400;630;630;4;178;301;1;98;1;6;91;80;6;74
143200018;500;853;856;5;266;370;1;129;3;4;122;137;5;132
143200019;300;520;523;4;168;196;1;103;0;2;101;65;6;59
143200020;400;639;652;6;179;313;1;86;3;3;80;93;3;90
143200021;300;467;468;6;129;252;0;48;0;0;48;81;4;77
143200022;400;567;567;8;136;344;1;55;1;5;49;81;4;77
143200023;400;651;652;6;189;297;3;100;2;1;97;89;4;85
143200024;300;172;551;4;176;213;1;86;6;4;76;90;2;88
143200025;300;523;523;7;119;236;1;63;0;2;61;56;1;55
143200026;500;681;682;8;216;374;1;125;2;2;121;91;3;88
143200027;500;668;668;3;189;413;1;86;2;2;82;103;5;98
143200028;500;660;662;8;173;389;2;109;2;7;100;64;5;59
143200029;400;429;429;8;142;319;1;80;4;2;74;62;2;60
143200030;400;115;428;5;120;333;1;66;3;2;61;54;1;53
143200031;500;707;707;7;201;394;1;105;4;2;99;96;1;95
143200032;600;539;539;9;161;502;2;96;2;2;92;65;2;63
143200033;600;879;882;11;242;464;1;135;1;1;133;107;4;103
143200034;600;798;798;8;233;471;1;128;3;0;125;105;10;95
143200035;500;484;484;2;289;271;2;227;4;7;216;62;4;58
143200036;500;533;533;9;165;393;1;106;4;3;99;59;4;55
143200037;500;487;488;5;160;395;1;104;2;1;101;56;1;55
143200038;500;546;547;5;194;394;1;105;5;2;98;89;4;85
143200039;600;612;612;5;198;516;1;83;2;2;79;115;3;112
143200040;500;716;716;5;180;388;1;111;2;2;107;69;6;63
143200041;600;598;599;5;153;520;1;79;1;3;75;74;1;73
143200042;300;631;633;9;188;214;1;85;5;1;79;103;2;101
143200043;500;670;670;4;170;405;1;94;9;2;83;76;3;73
143200044;300;600;601;7;195;201;1;98;3;4;91;97;7;90
143200045;500;764;765;5;224;392;1;107;3;1;103;117;8;109
143200046;700;771;781;4;253;530;1;169;8;2;159;84;2;82
143200047;500;527;527;2;180;384;1;115;4;3;108;65;0;65
143200048;600;555;556;2;340;337;1;262;12;4;246;78;0;78
143200049;500;511;515;3;183;375;2;123;1;6;116;60;2;58
143200050;1000;942;942;5;337;818;2;180;8;5;167;157;4;153
143200051;200;128;128;3;62;137;1;62;0;1;61;0;0;0
143200052;100;17;17;0;17;83;0;17;0;0;17;0;0;0
143200053;300;485;487;4;139;227;1;72;1;0;71;67;3;64
143200054;500;673;676;2;221;361;1;138;4;9;125;83;3;80
143200055;300;543;543;2;169;188;2;110;1;4;105;59;3;56
143200056;400;585;585;4;142;313;1;86;1;8;77;56;6;50
143200057;300;568;568;2;142;201;1;98;2;4;92;44;1;43
143200058;300;554;554;6;147;205;1;94;4;6;84;53;0;53
143200059;300;560;563;9;157;205;1;94;1;2;91;63;3;60
143200060;400;562;562;2;179;300;1;99;3;3;93;80;7;73
143200061;400;627;629;5;167;299;1;100;1;2;97;67;7;60
143200062;600;783;785;7;102;540;1;59;4;1;54;43;1;42
143200063;400;644;647;6;127;288;1;111;4;3;104;16;1;15
143200064;600;853;855;9;276;411;2;187;9;2;176;89;8;81
143200065;500;649;651;9;208;364;1;135;7;4;124;73;4;69
143200066;600;788;789;7;239;472;1;127;1;2;124;112;5;107
143200067;200;422;423;3;137;119;1;80;5;3;72;57;0;57
143200068;500;733;734;5;220;398;2;100;0;5;95;120;5;115
143200069;300;481;484;2;161;220;1;79;7;3;69;82;5;77
143200070;600;779;782;6;289;455;1;144;3;4;137;145;8;137
143200071;600;754;756;6;269;443;2;155;3;7;145;114;8;106
143200072;600;810;810;4;88;523;1;76;8;1;67;12;0;12
143200073;600;893;893;6;274;419;1;180;5;2;173;94;2;92
143200074;500;670;670;8;273;376;1;123;5;6;112;150;7;143
143200075;200;454;467;5;164;109;1;90;2;1;87;74;5;69
143200076;500;703;705;6;257;385;1;114;2;6;106;143;8;135
143200077;500;678;678;6;269;371;1;128;1;3;124;141;5;136
143200078;300;526;527;9;213;167;1;132;6;4;122;81;2;79
143200079;300;496;496;6;150;232;2;66;1;1;64;84;4;80
143200080;500;643;644;5;238;380;1;119;0;2;117;119;2;117
143200081;400;629;629;7;231;267;1;132;5;4;123;99;4;95
143200082;300;518;518;6;205;125;0;175;7;4;164;30;0;30
143200083;500;728;729;6;262;364;2;134;2;4;128;128;6;122
143200084;500;743;761;8;290;327;1;172;3;11;158;118;6;112
143200085;300;530;531;5;183;198;2;100;0;1;99;83;3;80
143200086;300;532;533;6;201;188;1;111;4;3;104;90;4;86
143200087;300;498;508;7;143;233;2;65;0;0;65;78;3;75
143200088;600;791;794;6;282;410;1;189;4;9;176;93;6;87
143200089;300;448;448;7;165;211;0;89;0;3;86;76;2;74
143200090;400;621;623;7;252;175;3;222;23;6;193;30;3;27
143200091;300;543;543;5;255;97;1;202;12;6;184;53;7;46
143200092;600;773;792;7;267;445;2;153;5;4;144;114;4;110
143200093;400;552;554;9;172;303;2;95;2;2;91;77;5;72
143200094;500;847;847;9;217;386;1;113;5;1;107;104;1;103
143200095;500;656;657;3;211;388;1;111;5;3;103;100;4;96
143200096;500;669;670;6;209;378;1;121;3;0;118;88;10;78
143200097;300;498;501;4;162;213;1;86;0;3;83;76;7;69
143200098;700;687;688;8;272;506;1;193;9;5;179;79;5;74
143200099;300;558;559;3;195;179;1;120;4;3;113;75;2;73
143200100;300;473;475;7;190;194;1;105;5;4;96;85;1;84
143200101;600;784;785;7;292;392;1;207;6;5;196;85;5;80
143200102;200;400;400;2;101;142;1;57;2;0;55;44;0;44
143200103;200;455;455;3;145;120;1;79;2;3;74;66;4;62
143200104;300;524;526;5;140;229;1;70;4;1;65;70;4;66
143200105;500;732;733;5;240;362;1;137;6;3;128;103;3;100
143200106;500;693;694;6;199;385;2;113;4;2;107;86;5;81
143200107;300;566;568;9;193;171;1;128;2;3;123;65;4;61
143200108;300;509;509;2;173;207;1;92;2;3;87;81;8;73
143200109;300;509;512;7;170;190;4;106;2;1;103;64;2;62
143200110;600;805;805;5;243;389;1;210;7;11;192;33;0;33
143200111;300;531;532;8;193;191;1;108;4;3;101;85;5;80
143200112;600;805;805;5;250;449;1;150;5;3;142;100;6;94
143200113;200;455;456;7;169;95;1;104;0;4;100;65;5;60
143200114;300;555;557;7;197;174;1;125;2;5;118;72;2;70
143200115;500;677;677;24;242;392;1;107;2;1;104;135;13;122
143200116;200;360;360;8;137;135;1;64;2;2;60;73;4;69
143200117;500;712;712;7;295;345;1;154;3;3;148;141;5;136
143200118;700;634;634;5;206;544;3;153;5;3;145;53;2;51
143200119;700;717;724;5;277;435;2;263;16;9;238;14;1;13
143200120;700;713;713;2;259;516;2;182;10;4;168;77;3;74
143200121;600;645;648;3;190;459;1;140;3;3;134;50;5;45
143200122;200;196;196;3;112;87;1;112;5;1;106;0;0;0
143200123;300;258;259;4;87;212;1;87;3;0;84;0;0;0
143200124;300;64;64;8;45;254;1;45;1;3;41;0;0;0
143200125;100;30;30;5;25;74;1;25;0;0;25;0;0;0
143200126;400;575;575;2;136;317;1;82;3;1;78;54;3;51
143200127;600;616;622;3;167;449;4;147;3;2;142;20;3;17
143200128;600;567;568;6;169;480;1;119;1;4;114;50;3;47
143200129;300;212;212;2;84;215;1;84;1;6;77;0;0;0
143200130;400;317;317;4;127;272;1;127;5;5;117;0;0;0
143200131;500;371;371;3;159;384;3;113;3;2;108;46;4;42
143200132;500;439;444;3;208;346;1;153;5;6;142;55;0;55
143200133;100;82;84;3;41;58;1;41;2;0;39;0;0;0
143200134;100;70;70;5;46;53;1;46;1;0;45;0;0;0
143200135;100;87;88;6;40;59;1;40;0;1;39;0;0;0
143200136;500;551;559;6;215;389;10;101;5;0;96;114;6;108
143200137;100;16;16;0;15;84;1;15;0;0;15;0;0;0
143200138;100;46;46;39;46;53;1;46;2;5;39;0;0;0
143200139;100;46;46;10;18;80;2;18;3;1;14;0;0;0
143200140;100;14;14;6;12;85;3;12;0;0;12;0;0;0
143600001;500;530;530;7;159;421;1;78;2;0;76;81;2;79
143600002;800;817;817;4;183;676;1;123;4;3;116;60;2;58
143600003;900;836;836;6;216;777;1;122;0;5;117;94;1;93
143600004;700;728;728;4;158;633;1;66;2;2;62;92;5;87
143600005;700;638;639;5;196;590;1;109;3;3;103;87;1;86
143600006;600;606;606;7;211;490;1;109;0;4;105;102;8;94
143600007;700;668;668;4;135;625;1;74;3;3;68;61;3;58
143600008;500;498;498;5;131;430;1;69;4;2;63;62;1;61
143600009;500;492;492;0;82;451;1;48;1;2;45;34;3;31
143600010;700;681;682;7;166;613;3;84;2;3;79;82;6;76
143600011;400;387;387;1;126;335;1;64;0;1;63;62;0;62
143600012;800;815;817;0;118;720;1;79;4;1;74;39;1;38
143600013;800;745;745;6;173;700;1;99;8;4;87;74;9;65
143600014;700;680;680;5;131;629;1;70;0;1;69;61;1;60
143600015;800;809;810;7;139;710;1;89;8;1;80;50;2;48
143600016;400;383;385;2;92;349;1;50;0;1;49;42;2;40
143600017;800;812;812;3;164;716;1;83;1;2;80;81;2;79
143600018;600;552;552;6;135;523;1;76;1;4;71;59;2;57
143600019;300;204;204;5;49;250;1;49;1;2;46;0;0;0
143600020;400;292;293;5;69;329;2;69;1;3;65;0;0;0
143600021;300;152;153;4;55;244;1;55;0;0;55;0;0;0
143600022;400;313;313;7;182;217;1;182;8;4;170;0;0;0
143600023;300;120;120;8;74;225;1;74;2;2;70;0;0;0
143600024;200;157;157;5;69;130;1;69;5;1;63;0;0;0
143600025;400;302;303;5;91;308;1;91;2;1;88;0;0;0
143600026;200;117;117;7;53;146;1;53;2;2;49;0;0;0
143600027;200;101;102;7;38;161;1;38;1;3;34;0;0;0
143600028;200;93;93;7;79;120;1;79;5;0;74;0;0;0
143600029;200;90;90;4;53;144;3;53;2;0;51;0;0;0
143600030;100;29;29;6;20;79;1;20;0;0;20;0;0;0
143600031;200;55;55;8;42;157;1;42;5;0;37;0;0;0
143600032;300;206;206;0;87;212;1;87;4;2;81;0;0;0
143600033;300;307;307;4;104;195;1;104;4;2;98;0;0;0
143600035;200;70;70;7;42;156;2;42;1;0;41;0;0;0
143600036;300;183;183;5;65;234;1;65;1;1;63;0;0;0
143600037;400;400;402;5;164;291;1;108;4;3;101;56;0;56
143600038;200;67;67;6;40;159;1;40;1;0;39;0;0;0
143600039;100;35;35;8;26;73;1;26;0;0;26;0;0;0
143600040;100;52;52;7;42;57;1;42;5;1;36;0;0;0
143600041;200;101;101;6;53;146;1;53;1;1;51;0;0;0
143600042;200;108;108;5;32;167;1;32;2;0;30;0;0;0
143600043;200;61;61;8;32;167;1;32;1;0;31;0;0;0
143600044;100;54;54;7;40;59;1;40;1;4;35;0;0;0
143600045;100;45;45;8;38;61;1;38;0;2;36;0;0;0
143600046;100;107;107;6;45;54;1;45;1;2;42;0;0;0
143600047;100;29;29;7;27;72;1;27;0;1;26;0;0;0
143600048;100;20;20;7;15;84;1;15;0;0;15;0;0;0
143600049;100;29;29;6;23;76;1;23;0;1;22;0;0;0
143600050;100;56;56;6;33;66;1;33;2;0;31;0;0;0
143600051;100;61;61;20;63;36;1;63;11;6;46;0;0;0
145100001;500;473;485;0;154;384;2;114;9;4;101;40;1;39
145100002;500;401;402;3;138;396;1;103;10;3;90;35;3;32
145100003;600;594;594;1;184;445;2;153;15;5;133;31;1;30
145100004;700;603;607;2;144;581;1;118;11;6;101;26;1;25
145100005;200;109;109;1;63;136;1;63;5;0;58;0;0;0
145100006;200;113;118;4;66;133;1;66;1;3;62;0;0;0
145100007;200;112;112;7;70;129;1;70;4;4;62;0;0;0
145100008;100;73;73;7;52;47;1;52;1;1;50;0;0;0
145100009;100;47;47;5;38;61;1;38;0;1;37;0;0;0
145100010;100;75;80;4;33;66;1;33;2;0;31;0;0;0
145100011;100;29;29;7;24;75;1;24;1;0;23;0;0;0
145100012;100;42;42;7;30;69;1;30;0;0;30;0;0;0
145100013;100;27;27;7;22;77;1;22;0;1;21;0;0;0
145100014;100;23;47;6;23;76;1;23;0;0;23;0;0;0
145100015;100;24;25;7;19;80;1;19;0;0;19;0;0;0
145100016;200;98;98;5;53;146;1;53;0;0;53;0;0;0
145100017;200;114;128;5;54;140;6;54;0;0;54;0;0;0
145100018;100;54;54;7;34;65;1;34;0;2;32;0;0;0
145100019;100;39;40;8;24;75;1;24;2;2;20;0;0;0
145100020;100;24;24;7;23;76;1;23;1;0;22;0;0;0
145100021;100;64;64;6;13;86;1;13;0;0;13;0;0;0
145100022;100;15;15;2;17;83;0;17;1;1;15;0;0;0
150300001;900;822;822;4;254;734;2;164;6;7;151;90;3;87
150300002;700;638;639;0;180;591;1;108;2;2;104;72;4;68
150300003;900;827;828;0;230;766;1;133;3;5;125;97;5;92
150300004;500;506;507;0;148;409;1;90;3;3;84;58;3;55
150300005;500;474;474;2;147;428;3;69;2;3;64;78;1;77
150300006;600;609;610;0;133;519;1;80;5;4;71;53;5;48
150300007;800;749;749;0;130;711;1;88;2;5;81;42;1;41
150300008;900;874;875;0;217;762;1;137;2;7;128;80;4;76
150300009;300;338;343;5;106;223;1;76;2;8;66;30;4;26
150300010;200;191;191;5;89;110;1;89;5;1;83;0;0;0
150300011;200;249;249;4;112;87;1;112;7;3;102;0;0;0
150300012;100;101;106;5;54;45;1;54;1;2;51;0;0;0
150300013;200;234;234;7;62;137;1;62;5;0;57;0;0;0
150300014;100;13;13;1;11;88;1;11;2;1;8;0;0;0
150300015;300;291;292;0;71;228;1;71;2;2;67;0;0;0
150300016;700;673;674;0;177;605;1;94;5;3;86;83;6;77
150300017;100;18;18;0;18;82;0;18;0;2;16;0;0;0
150800001;300;614;616;1;160;183;1;116;3;1;112;44;3;41
150800002;300;466;466;0;104;216;1;83;4;0;79;21;1;20
150800003;400;785;786;0;180;273;1;126;6;8;112;54;4;50
150800004;400;758;761;0;172;266;1;133;5;4;124;39;1;38
150800005;200;246;245;3;110;89;1;110;4;6;100;0;0;0
150800006;200;213;214;3;61;137;2;61;6;3;52;0;0;0
150800007;200;271;271;0;97;102;1;97;6;1;90;0;0;0
150800008;400;736;736;0;165;273;2;125;5;1;119;40;1;39
150800009;300;605;605;0;110;195;1;104;6;0;98;6;0;6
150800010;200;367;367;2;110;114;1;85;9;1;75;25;2;23
150800011;300;479;479;0;114;205;1;94;4;1;89;20;2;18
150800012;200;493;494;3;169;80;1;119;15;0;104;50;0;50
150800013;300;569;570;3;179;153;2;145;6;3;136;34;2;32
150800014;200;446;449;1;173;37;1;162;8;0;154;11;0;11
150800015;200;483;483;3;95;125;1;74;2;0;72;21;1;20
150800016;300;572;573;0;141;174;1;125;8;0;117;16;0;16
150800017;200;403;403;0;101;110;1;89;4;2;83;12;0;12
150800018;100;148;148;4;50;49;1;50;0;3;47;0;0;0
150800019;100;215;215;0;75;24;1;75;2;5;68;0;0;0
150800020;200;318;335;3;87;139;1;60;4;1;55;27;0;27
150800021;100;20;20;0;20;79;1;20;2;0;18;0;0;0
151000001;300;298;298;1;121;178;1;121;3;6;112;0;0;0
151000002;500;451;452;2;74;440;1;59;2;4;53;15;0;15
151000003;500;813;814;4;139;397;1;102;5;1;96;37;2;35
151000004;300;368;369;1;131;201;1;98;7;1;90;33;2;31
151000005;500;521;521;3;90;441;1;58;3;5;50;32;0;32
151000006;400;422;422;4;101;323;1;76;3;2;71;25;2;23
151000007;400;453;454;2;99;341;1;58;1;3;54;41;1;40
151000008;200;159;160;5;67;131;2;67;1;0;66;0;0;0
151000009;500;617;617;8;153;409;1;90;3;1;86;63;2;61
151000010;500;656;656;4;173;376;1;123;3;4;116;50;2;48
151000011;500;645;646;6;194;378;1;121;1;3;117;73;4;69
151000012;500;805;806;4;192;353;1;146;6;1;139;46;0;46
151000013;400;451;452;3;110;317;1;82;5;4;73;28;4;24
151000014;300;320;321;4;64;256;1;43;3;0;40;21;0;21
151000015;300;322;322;5;62;249;1;50;3;1;46;12;0;12
151000016;300;388;388;3;107;206;1;93;2;0;91;14;0;14
151000017;300;352;353;2;114;220;1;79;1;4;74;35;2;33
151000018;400;421;421;3;86;330;1;69;1;1;67;17;2;15
151000019;300;243;244;0;64;235;1;64;3;5;56;0;0;0
151000020;300;412;412;4;111;256;1;43;5;2;36;68;3;65
151000021;500;621;622;4;152;421;1;78;3;7;68;74;1;73
151000022;500;536;537;4;202;340;1;159;6;3;150;43;0;43
151000023;300;362;363;0;150;171;1;128;13;1;114;22;1;21
151000024;300;326;326;0;90;229;1;70;0;2;68;20;0;20
151000025;300;462;464;0;78;237;1;62;2;1;59;16;0;16
151000026;300;465;469;2;87;220;5;75;5;0;70;12;0;12
151000027;500;566;567;2;169;347;1;152;10;2;140;17;0;17
151000028;300;381;381;1;97;226;1;73;0;2;71;24;1;23
151000029;300;443;443;3;141;211;1;88;10;5;73;53;5;48
151000030;300;419;422;4;84;247;1;52;5;1;46;32;0;32
151000031;500;616;618;6;123;416;2;82;7;3;72;41;1;40
151000032;500;639;640;4;111;416;1;83;1;3;79;28;0;28
151000033;400;471;473;1;97;343;1;56;3;2;51;41;2;39
151100001;300;719;720;0;130;210;1;89;7;3;79;41;3;38
151100002;200;540;540;2;147;109;1;90;5;1;84;57;4;53
151100003;200;465;465;3;121;159;1;40;2;1;37;81;3;78
151100004;200;553;553;6;142;102;1;97;2;2;93;45;4;41
151100005;200;479;479;1;128;132;1;67;0;1;66;61;4;57
151100006;200;440;440;6;115;123;1;76;4;4;68;39;2;37
151100007;200;423;423;6;102;148;2;50;1;5;44;52;1;51
151100008;300;889;890;3;103;216;1;83;1;3;79;20;1;19
151100009;200;483;484;2;67;145;3;52;2;1;49;15;1;14
151100010;300;618;619;2;73;238;1;61;2;0;59;12;0;12
151100011;300;602;602;7;109;211;1;88;13;1;74;21;0;21
151100012;300;798;798;7;85;228;1;71;5;0;66;14;1;13
151100013;200;487;487;3;119;109;1;90;0;2;88;29;1;28
151100014;300;615;615;4;166;158;1;141;4;3;137;25;1;24
151100015;200;447;448;0;129;102;1;97;11;1;85;32;1;31
151100016;300;755;756;2;116;212;1;87;2;1;84;29;0;29
151100017;200;307;307;1;98;101;1;98;3;2;93;0;0;0
151100018;200;377;377;1;84;128;1;71;1;1;69;13;1;12
151100019;300;594;594;4;138;206;1;93;6;1;86;45;0;45
151100020;200;472;472;4;101;108;1;91;4;2;85;10;1;9
151100021;200;553;553;4;88;130;1;69;4;0;65;19;2;17
151600001;300;543;545;0;161;212;1;87;3;2;82;74;2;72
151600002;400;701;706;1;205;285;1;114;2;1;111;91;0;91
151600003;400;716;721;0;208;279;1;120;2;1;117;88;2;86
151600004;300;547;549;1;132;221;1;78;1;3;74;54;2;52
151600005;200;458;459;2;132;105;1;94;6;0;88;38;1;37
151600006;400;757;762;1;194;291;2;107;1;1;105;87;3;84
151600007;400;749;750;0;217;240;1;159;9;1;149;58;1;57
151600008;500;885;888;1;258;271;1;228;25;0;203;30;0;30
151600009;500;1075;1075;0;255;243;2;255;34;2;219;0;0;0
151600010;500;859;861;1;197;312;1;187;12;2;173;10;0;10
151600011;300;511;513;3;153;202;1;97;5;0;92;56;3;53
151600012;300;587;590;0;149;205;1;94;3;0;91;55;0;55
151600013;200;445;447;0;135;127;1;72;3;1;68;63;2;61
151600014;100;16;16;2;6;93;1;6;1;0;5;0;0;0
151600015;300;651;651;4;167;144;1;155;10;1;144;12;0;12
151600016;300;638;638;0;174;130;1;169;14;0;155;5;0;5
151600017;200;446;446;1;83;147;1;52;7;0;45;31;2;29
151600018;100;74;74;7;38;61;1;38;1;2;35;0;0;0
151600019;300;614;622;0;179;163;1;136;3;2;131;43;1;42
151600020;100;15;15;0;5;94;1;5;0;0;5;0;0;0
151600021;200;465;465;1;118;115;1;84;14;0;70;34;0;34
151600022;200;321;321;0;62;146;1;53;1;2;50;9;0;9
151600023;200;334;334;2;110;106;1;93;1;0;92;17;0;17
151600024;300;593;600;0;206;147;1;152;11;13;128;54;3;51
151600025;200;485;490;3;144;72;1;127;5;4;118;17;0;17
151600026;300;563;571;1;173;140;1;159;4;3;152;14;1;13
151600027;200;386;388;5;114;121;1;78;3;6;69;36;4;32
151600028;300;507;509;5;110;216;1;83;1;3;79;27;3;24
151600029;400;672;677;1;150;272;1;127;7;2;118;23;1;22
151600030;200;307;313;2;74;125;1;74;5;1;68;0;0;0
151600031;200;443;443;4;177;55;1;144;2;5;137;33;1;32
151600032;100;37;37;0;35;65;0;35;0;0;35;0;0;0
151600033;100;49;49;0;48;52;0;48;2;2;44;0;0;0
152100001;500;1006;1006;3;394;115;1;384;13;11;360;10;0;10
152100002;300;592;604;4;176;157;1;142;5;6;131;34;1;33
152100003;400;1010;1060;4;293;111;2;287;6;5;276;6;0;6
152100004;300;701;716;4;204;147;1;152;4;2;146;52;2;50
152100005;300;437;448;1;207;109;1;190;6;0;184;17;0;17
152100006;400;528;530;5;207;224;2;174;6;5;163;33;1;32
152100007;200;116;119;4;62;137;1;62;2;2;58;0;0;0
152100008;200;140;142;4;76;123;1;76;5;2;69;0;0;0
152100009;300;350;351;0;97;208;1;91;3;5;83;6;0;6
152100010;100;74;75;7;60;39;1;60;1;1;58;0;0;0
152100011;400;560;561;4;192;210;1;189;4;8;177;3;0;3
152100012;100;53;53;5;33;66;1;33;0;2;31;0;0;0
152100013;300;390;391;1;142;166;1;133;5;2;126;9;0;9
152100014;200;159;159;1;66;133;1;66;8;2;56;0;0;0
152100015;500;840;853;4;314;238;1;261;7;7;247;53;0;53
152100016;200;225;226;1;117;82;1;117;5;3;109;0;0;0
152100017;300;360;364;1;191;129;1;170;5;1;164;21;0;21
152100018;200;149;149;2;150;50;0;150;2;1;147;0;0;0
152100019;100;35;35;0;32;68;0;32;4;0;28;0;0;0
152300001;900;881;890;1;109;807;3;90;11;6;73;19;0;19
152300002;650;608;613;3;139;545;1;104;4;1;99;35;0;35
152300003;700;669;683;2;177;565;1;134;6;0;128;43;3;40
152300004;700;668;671;3;175;571;1;128;13;0;115;47;1;46
152300005;500;446;451;1;148;403;2;95;1;6;88;53;2;51
152300006;500;486;487;2;148;396;1;103;12;1;90;45;0;45
152300007;500;493;493;2;149;393;1;106;12;1;93;43;3;40
152300008;650;636;643;6;127;555;1;94;6;0;88;33;0;33
152300009;400;359;359;1;74;339;1;60;2;1;57;14;1;13
152300010;450;412;419;3;103;359;1;90;6;6;78;13;0;13
152300011;50;41;41;0;40;9;1;40;2;1;37;0;0;0
152400001;400;833;835;14;280;286;1;113;3;1;109;167;4;163
152400002;400;794;797;30;244;310;1;89;1;3;85;155;7;148
152400003;400;829;833;10;291;252;1;147;2;6;139;144;0;144
152400004;200;435;438;10;131;122;1;77;3;1;73;54;3;51
152400005;300;681;685;8;174;213;1;86;3;0;83;88;4;84
152400006;400;951;953;4;177;311;1;88;2;2;84;89;2;87
152400007;400;931;932;7;320;236;1;163;0;13;150;157;7;150
152400008;400;890;891;5;318;226;1;173;8;4;161;145;5;140
152400009;400;785;787;6;282;241;1;158;4;4;150;124;0;124
152400010;400;787;792;8;262;266;1;133;1;4;128;129;5;124
152400011;400;886;888;9;287;258;0;142;4;1;137;145;3;142
152400012;400;827;828;6;189;229;1;170;10;6;154;19;3;16
152400013;400;802;807;7;215;293;6;101;6;2;93;114;3;111
152400014;400;821;824;7;175;325;1;74;5;3;66;101;0;101
152400015;400;762;762;7;191;230;1;169;1;6;162;22;0;22
152400016;400;800;801;5;170;302;1;97;2;2;93;73;3;70
152400017;300;659;661;8;155;241;1;58;2;2;54;97;2;95
152400018;400;740;744;7;167;319;1;80;3;4;73;87;3;84
152400019;400;853;857;8;198;295;1;104;3;0;101;94;12;82
152400020;400;794;796;6;213;293;1;106;4;1;101;107;3;104
152400021;400;837;838;7;200;301;1;98;5;5;88;102;3;99
152400022;400;834;836;10;221;267;1;132;7;4;121;89;2;87
152400023;400;861;863;7;192;311;2;87;1;3;83;105;2;103
152400024;400;905;907;6;230;286;1;113;5;6;102;117;10;107
152400025;400;757;761;7;210;300;2;98;3;1;94;112;3;109
152400026;400;772;774;8;168;322;1;77;2;2;73;91;3;88
152400027;300;681;682;8;114;240;1;59;2;1;56;55;3;52
152400028;500;951;961;8;244;378;1;121;3;2;116;123;1;122
152400029;400;906;906;2;250;274;1;125;8;1;116;125;0;125
152400030;400;823;827;7;171;300;1;99;2;1;96;72;2;70
152400031;400;761;762;6;186;292;1;107;8;2;97;79;5;74
152400032;400;794;798;8;202;301;1;98;1;2;95;104;6;98
152400033;400;789;790;5;149;344;1;55;1;0;54;94;3;91
152400034;400;854;860;10;272;278;1;121;5;4;112;151;8;143
152400035;400;817;824;9;214;270;3;127;1;8;118;87;3;84
152400036;400;882;883;5;271;298;4;98;5;3;90;173;8;165
152400037;400;853;853;3;232;299;1;100;3;3;94;132;2;130
152400038;400;739;741;9;213;237;1;162;7;8;147;51;4;47
152400039;400;766;768;8;190;301;1;98;2;2;94;92;4;88
152400040;400;821;825;5;208;299;1;100;2;0;98;108;3;105
152400041;400;727;733;8;183;298;1;101;5;8;88;82;3;79
152400042;400;743;747;7;172;322;3;75;2;1;72;97;10;87
152400043;400;729;733;4;248;283;1;116;2;3;111;132;4;128
152400044;400;797;800;4;238;293;1;106;2;2;102;132;6;126
152400045;400;737;744;7;161;314;1;85;5;3;77;76;7;69
152400046;400;790;791;4;163;303;4;93;3;1;89;70;5;65
152400047;400;845;845;4;209;293;1;106;6;1;99;103;1;102
152400048;300;534;535;5;145;237;1;62;2;0;60;83;5;78
152400049;400;831;835;10;238;272;1;127;8;4;115;111;2;109
152400050;300;686;688;5;173;216;1;83;0;2;81;90;4;86
152400051;400;829;831;5;215;292;2;106;6;1;99;109;6;103
152400052;300;701;702;6;180;190;2;108;1;2;105;72;4;68
152400053;400;750;764;7;216;304;1;95;0;6;89;121;3;118
152400054;300;710;712;4;160;230;1;69;0;3;66;91;3;88
152400055;400;776;780;8;197;303;1;96;2;2;92;101;3;98
152400056;300;700;704;6;190;220;3;77;2;0;75;113;1;112
152400057;300;634;635;6;185;208;1;91;1;2;88;94;0;94
152400058;300;704;705;6;143;228;1;71;2;1;68;72;5;67
152400059;400;723;725;6;148;335;2;63;6;6;51;85;3;82
152400060;300;682;684;6;211;186;1;113;2;5;106;98;3;95
152400061;300;559;560;11;135;226;1;73;2;1;70;62;4;58
152400062;400;858;869;9;212;287;1;112;1;2;109;100;4;96
152400063;300;620;623;8;115;245;5;50;2;1;47;65;4;61
152400064;500;960;965;11;212;404;1;95;1;3;91;117;6;111
152400065;500;1003;1008;9;356;201;1;298;5;9;284;58;4;54
152400066;400;889;892;6;261;266;1;133;1;5;127;128;7;121
152400067;400;780;780;5;232;301;1;98;0;2;96;134;10;124
152400068;400;937;938;7;322;155;1;244;2;9;233;78;0;78
152400069;400;739;740;6;240;308;1;91;5;2;84;149;7;142
152400070;400;788;789;8;306;266;1;133;4;3;126;173;2;171
152400071;300;706;708;8;209;196;1;103;3;2;98;106;5;101
152400072;300;562;562;7;224;203;3;94;3;1;90;130;7;123
152400073;400;771;772;5;245;268;1;131;3;1;127;114;4;110
152400074;400;836;842;10;259;263;1;136;8;3;125;123;12;111
152400075;500;994;1002;9;295;355;1;144;3;1;140;151;1;150
152400076;400;758;761;8;259;274;1;125;4;6;115;134;3;131
152400077;300;561;562;7;199;200;1;99;2;0;97;100;5;95
152400078;400;784;786;7;174;298;1;101;2;3;96;73;4;69
152400079;300;643;643;9;190;204;1;95;2;2;91;95;5;90
152400080;300;579;580;5;184;206;1;93;1;0;92;91;1;90
152400081;300;504;505;6;183;226;1;73;4;0;69;110;5;105
152400082;200;473;474;6;181;117;1;82;4;1;77;99;5;94
152400083;300;681;683;8;145;210;1;89;11;2;76;56;0;56
152400084;300;611;613;4;186;211;1;88;1;5;82;98;7;91
152400085;400;738;739;2;208;288;1;111;4;2;105;97;3;94
152400086;400;753;755;6;230;289;1;110;2;4;104;120;6;114
152400087;300;543;544;8;177;206;1;93;3;4;86;84;4;80
152400088;300;619;622;9;195;203;1;96;1;2;93;99;1;98
152400089;300;679;685;6;225;194;1;105;2;1;102;120;4;116
152400090;300;542;545;10;206;213;1;86;1;4;81;120;6;114
152400091;400;903;905;6;281;271;1;128;2;4;122;153;9;144
152400092;400;769;769;10;260;275;2;123;2;4;117;137;6;131
152400093;400;764;765;9;186;300;2;98;2;3;93;88;5;83
152400094;400;843;848;7;284;266;1;133;2;3;128;151;6;145
152400095;400;780;780;7;228;291;1;108;2;1;105;120;3;117
152400096;500;975;975;4;338;322;2;176;5;2;169;162;9;153
152400097;400;725;729;10;256;289;1;110;4;1;105;146;9;137
152400098;500;962;965;11;316;347;1;152;6;4;142;164;7;157
152400099;400;869;872;7;308;249;1;150;2;5;143;158;7;151
152400100;300;638;641;7;207;191;1;108;0;0;108;99;5;94
152400101;500;943;944;10;306;329;1;170;8;8;154;136;3;133
152400102;300;680;683;8;280;153;1;146;6;2;138;134;9;125
152400103;400;722;723;9;266;264;1;135;2;2;131;131;2;129
152400104;400;770;774;6;266;259;2;139;0;1;138;127;5;122
152400105;300;599;600;8;203;193;0;107;4;3;100;96;5;91
152400106;400;741;742;7;233;168;1;231;2;10;219;2;0;2
152400107;300;625;625;11;205;203;1;96;1;3;92;109;6;103
152400108;400;755;756;6;298;240;1;159;1;9;149;139;7;132
152400109;300;517;523;9;189;145;1;154;0;5;149;35;0;35
152400110;300;625;628;7;207;132;1;167;1;7;159;40;4;36
152400111;300;593;596;8;207;219;1;80;4;1;75;127;8;119
152400112;300;674;675;8;234;194;1;105;5;2;98;129;5;124
152400113;400;787;793;7;259;276;1;123;3;1;119;136;5;131
152400114;400;820;827;4;280;166;1;233;3;7;223;47;0;47
152400115;400;854;857;8;308;110;1;289;2;5;282;19;0;19
152400116;400;829;834;8;303;272;0;128;3;0;125;175;9;166
152400117;300;644;649;11;235;197;1;102;2;1;99;133;13;120
152400118;300;680;682;10;230;184;2;114;3;2;109;116;5;111
152400119;300;627;628;7;209;191;2;107;1;4;102;102;1;101
152400120;300;623;626;5;198;182;1;117;4;3;110;81;3;78
152400121;300;541;541;8;177;191;1;108;1;3;104;69;3;66
152400122;300;640;640;6;193;216;1;83;2;6;75;110;2;108
152400123;400;756;758;7;223;279;1;120;4;1;115;103;2;101
152400124;400;832;835;4;288;159;2;239;7;3;229;49;1;48
152400125;400;715;732;6;220;299;2;99;2;3;94;121;6;115
152400126;400;850;850;10;290;264;1;135;2;2;131;155;3;152
152400127;500;932;938;5;299;370;3;126;1;3;122;173;6;167
152400128;100;33;33;10;24;75;1;24;3;0;21;0;0;0
152400129;100;48;48;5;46;53;1;46;7;3;36;0;0;0
152400130;500;362;362;46;223;276;1;223;8;15;200;0;0;0
152400131;200;79;79;46;97;102;1;97;6;9;82;0;0;0
152400132;100;44;44;7;49;50;1;49;0;1;48;0;0;0
152400133;100;32;32;4;36;64;0;36;2;5;29;0;0;0
152400200;500;496;497;2;198;338;1;161;8;1;152;37;0;37
152400201;500;466;467;2;185;344;1;155;3;3;149;30;0;30
152400202;500;708;707;6;352;234;1;265;16;11;238;87;2;85
152400203;500;532;536;4;146;365;2;133;10;0;123;13;0;13
152400204;500;793;793;5;138;395;1;104;7;3;94;34;1;33
152400205;1000;1133;1136;3;271;731;1;268;1;0;267;3;0;3
152400206;1000;1101;1101;6;241;787;4;209;3;2;204;32;1;31
152400207;400;422;428;3;124;322;1;77;4;3;70;47;1;46
152400208;100;127;127;3;78;21;1;78;1;0;77;0;0;0
152400209;500;521;523;3;130;420;1;79;7;2;70;51;1;50
152400210;500;727;728;3;197;305;1;194;2;10;182;3;0;3
152400211;500;636;638;8;83;426;1;73;6;4;63;10;0;10
152400212;500;650;650;5;165;394;1;105;4;2;99;60;1;59
152400213;100;105;107;6;63;36;1;63;1;2;60;0;0;0
152400214;200;218;219;8;93;105;2;93;3;2;88;0;0;0
152400215;100;62;62;5;44;55;1;44;0;1;43;0;0;0
152400216;500;523;524;3;331;194;1;305;12;2;291;26;1;25
152400217;400;467;473;6;145;279;1;120;10;0;110;25;0;25
152400218;500;734;735;5;185;388;1;111;8;2;101;74;6;68
152400219;500;651;652;5;192;356;1;143;6;2;135;49;1;48
152400220;400;411;414;6;209;213;1;186;9;6;171;23;0;23
152400221;300;363;364;5;101;240;1;59;3;2;54;42;3;39
152400222;200;202;202;3;86;112;2;86;6;3;77;0;0;0
152400223;500;526;530;3;104;420;1;79;9;1;69;25;1;24
152400224;500;892;898;0;218;303;1;196;17;1;178;22;0;22
152400225;500;461;461;3;114;434;1;65;4;1;60;49;2;47
152400226;500;834;842;0;193;349;1;150;9;2;139;43;0;43
152400227;500;736;739;0;185;380;1;119;2;5;112;66;3;63
152400228;300;263;261;2;149;150;1;149;5;5;139;0;0;0
152400229;200;221;221;5;85;114;1;85;0;6;79;0;0;0
152400230;500;785;785;4;239;273;1;226;21;3;202;13;1;12
152400231;500;760;760;2;205;374;2;124;5;4;115;81;2;79
152400232;500;772;776;3;221;369;1;130;3;5;122;91;2;89
152400233;500;518;518;5;117;422;1;77;3;3;71;40;1;39
152700001;300;600;600;4;168;143;5;152;10;5;137;16;1;15
152700002;300;543;543;4;139;174;1;125;6;6;113;14;2;12
152700003;300;450;450;4;145;204;1;95;3;4;88;50;1;49
152700004;100;119;119;4;56;43;1;56;3;0;53;0;0;0
152700005;300;616;616;4;178;126;1;173;8;4;161;5;0;5
152700006;300;429;431;4;124;223;1;76;4;5;67;46;3;43
152700007;300;621;621;6;210;107;11;182;38;3;141;28;0;28
152700008;100;59;59;6;48;51;1;48;1;0;47;0;0;0
152700009;500;764;764;5;264;247;2;251;17;3;231;13;0;13
152700010;200;332;332;7;104;123;1;76;2;1;73;28;1;27
153700001;200;284;286;4;95;104;1;95;2;8;85;0;0;0
153700002;200;445;446;0;198;11;1;188;11;1;176;10;1;9
153700003;300;614;624;0;312;0;1;299;24;4;271;13;0;13
153700004;300;405;408;0;161;163;1;136;6;4;126;25;1;24
153700005;500;644;652;1;215;302;1;197;20;1;176;18;0;18
153700006;300;546;547;6;123;180;1;119;8;12;99;4;0;4
153700007;400;682;682;1;126;305;2;93;0;1;92;33;3;30
153700008;300;582;585;0;161;168;1;131;4;1;126;30;2;28
153700009;400;720;725;1;138;273;1;126;6;2;118;12;0;12
153700010;500;943;944;0;181;326;10;164;8;1;155;17;0;17
153700011;500;749;750;1;208;296;1;203;9;1;193;5;0;5
153700012;200;306;307;0;91;127;1;72;5;0;67;19;0;19
153700013;500;610;610;2;134;377;1;122;8;1;113;12;0;12
153700014;300;534;537;1;120;191;1;108;3;0;105;12;0;12
153700015;500;630;630;2;288;240;1;259;20;4;235;29;2;27
153700016;500;710;719;1;232;301;1;198;16;10;172;34;0;34
153700017;500;929;932;0;259;257;1;242;17;1;224;17;0;17
153700018;300;517;518;2;213;86;1;213;10;2;201;0;0;0
153700019;300;304;306;1;84;215;1;84;2;3;79;0;0;0
153700020;300;309;309;0;96;203;1;96;3;2;91;0;0;0
153700021;500;585;587;0;150;392;3;105;2;3;100;45;0;45
153700022;500;620;624;0;121;416;1;83;3;4;76;38;1;37
153700023;500;710;711;1;154;418;1;81;0;3;78;73;4;69
153700024;300;589;591;3;182;120;2;178;3;15;160;4;1;3
153700025;300;607;608;3;172;213;1;86;2;3;81;86;2;84
153700026;500;698;700;0;195;403;2;95;1;5;89;100;3;97
153700027;300;559;561;1;148;201;1;98;6;1;91;50;5;45
153700028;500;741;743;3;170;420;1;79;4;1;74;91;1;90
153700029;500;658;659;6;140;423;2;75;2;2;71;65;3;62
153700030;500;659;661;4;192;396;1;103;3;2;98;89;4;85
153700031;500;717;717;0;152;407;5;88;4;3;81;64;3;61
153700032;300;637;640;0;202;194;1;105;3;0;102;97;3;94
153700033;500;824;827;5;173;408;1;91;4;3;84;82;2;80
153700034;500;826;826;0;128;422;1;77;2;0;75;51;2;49
153700035;500;865;873;0;174;395;1;104;6;3;95;70;4;66
153700036;500;737;737;6;104;409;2;89;10;1;78;15;2;13
153700037;500;612;612;4;138;373;2;125;6;0;119;13;0;13
153700038;300;400;403;2;129;201;1;98;3;3;92;31;0;31
153700039;300;427;428;0;126;210;1;89;0;0;89;37;0;37
153700040;100;22;22;0;22;78;0;22;0;0;22;0;0;0
153700041;100;22;22;2;22;78;0;22;1;0;21;0;0;0
153700042;100;13;13;4;11;88;1;11;0;0;11;0;0;0
153900001;800;754;764;7;255;637;3;160;12;6;142;95;4;91
153900002;600;624;628;5;188;474;1;125;6;8;111;63;3;60
153900003;700;727;731;6;193;544;1;155;7;9;139;38;3;35
153900004;700;649;654;7;259;530;1;169;8;8;153;90;3;87
153900005;700;691;698;7;272;457;1;242;8;13;221;30;3;27
153900006;600;589;596;7;217;395;1;204;34;2;168;13;0;13
153900007;800;828;831;8;276;560;1;239;32;2;205;37;4;33
153900008;700;684;698;6;208;527;1;172;13;2;157;36;0;36
153900009;600;543;547;5;169;453;1;146;1;2;143;23;1;22
153900010;600;594;600;5;210;419;1;180;4;7;169;30;1;29
153900011;600;506;510;7;189;469;1;130;9;2;119;59;3;56
153900012;800;730;746;9;307;491;2;307;25;7;275;0;0;0
153900013;600;666;686;11;315;294;1;305;24;4;277;10;0;10
153900014;600;678;700;0;253;385;1;214;9;1;204;39;1;38
153900015;600;619;635;5;199;412;1;187;16;4;167;12;1;11
153900016;700;789;791;2;374;343;1;356;27;10;319;18;0;18
153900017;300;250;262;6;157;142;1;157;14;5;138;0;0;0
153900018;100;63;63;1;61;39;0;61;12;0;49;0;0;0
153900019;100;35;35;0;34;66;0;34;4;0;30;0;0;0
153900020;100;30;30;1;30;69;1;30;9;1;20;0;0;0
153900021;100;12;12;3;14;85;1;14;4;0;10;0;0;0
153900022;100;40;40;23;39;60;1;39;4;1;34;0;0;0
162201001;400;435;435;9;182;335;1;64;3;0;61;118;8;110
162201002;500;488;488;8;190;402;2;96;2;1;93;94;0;94
162201003;500;496;493;7;183;408;1;91;1;1;89;92;4;88
162201004;700;658;658;6;235;575;1;124;2;5;117;111;5;106
162201005;400;340;340;13;148;260;1;139;0;9;130;9;4;5
162201006;400;365;401;365;152;334;1;65;2;1;62;87;5;82
162201007;500;492;492;8;199;414;1;85;3;3;79;114;8;106
162201008;700;744;745;5;299;567;1;132;6;1;125;167;6;161
162201009;800;313;754;7;306;666;1;133;4;2;127;173;3;170
162201010;500;506;506;3;164;450;2;48;3;1;44;116;6;110
162201011;300;332;332;7;122;243;3;54;1;0;53;68;2;66
162201012;630;630;630;5;217;526;4;100;2;1;97;117;9;108
162201013;800;754;754;14;273;668;1;131;1;4;126;142;8;134
162201014;700;696;696;5;271;585;1;114;2;4;108;157;6;151
162201015;500;462;462;7;145;430;0;70;3;2;65;75;4;71
162201016;700;637;677;4;246;578;3;119;3;5;111;127;7;120
162201017;500;508;508;7;176;423;1;76;2;2;72;100;4;96
162201018;400;431;431;6;164;340;1;59;5;0;54;105;4;101
162201019;600;597;597;4;245;509;3;88;2;2;84;157;6;151
162201020;500;506;506;7;215;405;1;94;1;3;90;121;2;119
162201021;700;676;676;7;266;577;2;121;0;5;116;145;5;140
162201022;700;657;659;7;263;584;1;115;2;3;110;148;5;143
162201023;600;625;626;0;231;505;2;93;1;3;89;138;5;133
162201024;700;720;722;9;235;597;2;101;2;2;97;134;0;134
162201025;400;422;422;5;149;344;1;55;0;3;52;94;5;89
162201026;800;764;764;7;298;527;1;272;2;14;256;26;3;23
162201027;900;970;969;10;376;749;1;150;4;1;145;226;7;219
162201028;1000;1069;1068;11;407;805;1;194;4;2;188;213;10;203
162201029;600;632;632;9;284;471;1;128;4;5;119;156;6;150
162201030;900;918;919;7;356;751;1;148;4;8;136;208;8;200
162201031;500;516;516;7;196;400;2;98;3;2;93;98;0;98
162201032;500;527;527;4;208;416;1;83;0;0;83;125;8;117
162201033;700;657;657;3;258;541;1;158;2;7;149;100;4;96
162201034;800;770;771;6;252;699;5;96;5;3;88;156;6;150
162201035;600;547;547;6;153;525;1;74;2;2;70;79;3;76
162201036;900;842;843;7;295;747;2;151;2;1;148;144;2;142
162201037;900;871;872;6;327;787;1;112;6;2;104;215;7;208
162201038;700;658;658;7;261;610;1;89;3;3;83;172;7;165
162201039;500;482;482;6;188;420;1;79;3;3;73;109;8;101
162201040;700;755;756;6;267;602;1;97;1;3;93;170;10;160
162201041;500;456;456;8;159;417;1;82;1;1;80;77;7;70
162201042;600;634;635;5;215;494;6;100;5;1;94;115;10;105
162201043;800;923;919;3;339;575;4;221;9;5;207;118;8;110
162201044;900;977;977;4;377;691;1;208;9;5;194;169;12;157
162201045;400;440;440;15;195;250;1;149;4;10;135;46;2;44
162201046;700;664;664;9;254;576;1;123;2;1;120;131;6;125
162201047;600;613;613;5;248;486;2;112;0;3;109;136;8;128
162201048;800;795;795;8;306;639;4;157;4;3;150;149;3;146
162201049;500;499;499;5;148;425;1;74;2;1;71;74;3;71
162201050;600;595;595;3;187;528;1;71;2;2;67;116;4;112
162201051;500;540;540;7;172;427;1;72;1;2;69;100;3;97
162201052;500;444;444;4;164;435;2;63;4;2;57;101;3;98
162201053;800;798;800;14;306;677;1;122;1;4;117;184;8;176
162201054;900;850;851;4;290;773;1;126;6;2;118;164;9;155
162201055;900;972;975;3;363;740;1;159;5;5;149;204;7;197
162201056;700;735;736;5;276;581;1;118;3;1;114;158;5;153
162201057;800;772;773;2;234;692;1;107;3;1;103;127;2;125
162201058;900;856;857;10;342;772;2;126;1;3;122;216;8;208
162201059;700;714;714;16;265;581;1;118;3;0;115;147;7;140
162201060;900;958;957;6;365;632;1;267;7;9;251;98;3;95
162201061;900;859;859;6;308;756;1;143;6;4;133;165;11;154
162201062;700;705;702;11;277;574;1;125;4;5;116;152;7;145
162201063;700;692;692;6;276;566;2;132;1;6;125;144;4;140
162201064;700;740;739;7;242;602;1;97;2;5;90;145;5;140
162201065;700;719;720;7;247;581;1;118;2;2;114;129;4;125
162201066;600;641;641;10;249;475;1;124;0;0;124;125;5;120
162201067;500;478;478;7;188;431;2;67;2;2;63;121;3;118
162201068;400;398;399;10;143;321;1;78;2;1;75;65;3;62
162201069;700;672;672;6;234;583;1;116;3;4;109;118;6;112
162201070;800;758;758;7;285;678;1;121;18;5;98;164;9;155
162201071;500;442;443;4;174;431;2;67;3;2;62;107;5;102
162201072;800;807;808;6;310;641;1;158;6;6;146;152;2;150
162201073;800;824;828;6;318;672;1;127;2;3;122;191;11;180
162201074;900;832;833;8;342;737;1;162;5;2;155;180;6;174
162201075;600;601;601;7;246;483;1;116;2;5;109;130;6;124
162201076;600;601;602;11;231;482;1;117;1;4;112;114;9;105
162201077;700;634;634;7;232;583;1;116;1;1;114;116;3;113
162201078;600;570;570;8;206;508;2;90;2;2;86;116;5;111
162201079;800;744;739;9;315;676;2;122;1;4;117;193;6;187
162201080;900;897;897;9;334;603;2;295;25;0;270;39;2;37
162201081;500;534;533;11;162;398;1;101;2;5;94;61;2;59
162201082;700;688;688;6;292;565;1;134;2;7;125;158;5;153
162201083;900;881;884;4;287;707;10;183;11;3;169;104;2;102
162201084;500;504;504;14;156;371;1;128;11;2;115;28;0;28
162201085;400;428;428;3;147;336;1;63;2;0;61;84;4;80
162201086;700;733;733;9;234;580;3;117;4;2;111;117;5;112
162201087;600;585;585;5;212;497;1;102;1;6;95;110;0;110
162201088;700;739;739;7;272;556;2;142;8;2;132;130;1;129
162201089;700;700;700;4;251;532;1;167;10;6;151;84;1;83
162201090;700;664;665;7;181;599;1;100;4;2;94;81;3;78
162201091;700;673;673;7;224;581;1;118;3;3;112;106;3;103
162201092;800;778;779;11;329;639;2;159;2;1;156;170;5;165
162201093;600;564;564;9;212;507;1;92;2;6;84;120;0;120
162201094;400;432;433;6;175;317;1;82;0;0;82;93;8;85
162201095;900;861;861;6;280;746;3;151;1;4;146;129;5;124
162201096;600;560;562;6;223;485;1;114;1;4;109;109;5;104
162201097;400;392;392;3;145;339;1;60;0;0;60;85;2;83
162201098;500;455;455;2;142;450;1;49;1;0;48;93;0;93
162201099;700;702;703;5;210;617;3;80;2;2;76;130;7;123
162201100;500;521;522;5;182;416;3;81;3;1;77;101;2;99
162201101;100;31;31;7;38;61;1;38;0;0;38;0;0;0
162201102;200;12;12;17;25;174;1;25;2;2;21;0;0;0
162201103;100;17;17;21;36;63;1;36;4;1;31;0;0;0
162202001;500;498;498;7;76;456;1;43;2;0;41;33;1;32
162202002;800;775;779;2;165;653;1;146;12;0;134;19;0;19
162202003;600;579;580;7;133;502;3;95;10;0;85;38;2;36
162202004;600;651;651;3;132;525;1;74;2;0;72;58;1;57
162202005;600;555;555;6;112;526;1;73;4;1;68;39;0;39
162202006;500;529;529;8;135;425;4;71;5;1;65;64;1;63
162202007;500;493;495;4;98;428;2;70;1;1;68;28;1;27
162202008;600;567;565;11;104;541;1;58;1;2;55;46;2;44
162202009;600;533;532;12;130;514;1;85;2;3;80;45;2;43
162202010;500;485;486;8;97;448;1;51;2;0;49;46;3;43
162202011;700;674;675;6;165;612;1;87;4;3;80;78;3;75
162202012;500;439;447;3;126;440;2;58;0;0;58;68;3;65
162202013;700;552;553;5;167;604;1;95;2;2;91;72;3;69
162202014;500;516;513;4;139;419;2;79;3;0;76;60;3;57
162202015;600;653;654;5;194;492;1;107;8;2;97;87;3;84
162202016;500;415;416;6;91;446;1;53;1;1;51;38;0;38
162202017;500;538;539;4;138;428;1;71;1;1;69;67;1;66
162202018;500;494;495;4;144;414;1;85;4;4;77;59;1;58
162202019;500;102;554;6;108;429;1;70;2;3;65;38;1;37
162202020;600;545;545;4;161;497;1;102;2;3;97;59;5;54
162202021;600;611;614;5;157;447;1;152;38;0;114;5;0;5
162202022;600;600;600;8;100;539;1;60;3;2;55;40;0;40
162202023;600;601;601;601;125;487;1;112;10;0;102;13;0;13
162202024;800;839;839;4;227;572;1;227;35;1;191;0;0;0
162202025;600;606;606;5;122;479;3;118;20;0;98;4;0;4
162202026;700;706;708;4;172;536;1;163;21;0;142;9;0;9
162202027;700;718;718;8;247;452;1;247;53;0;194;0;0;0
162202028;500;485;485;3;128;426;1;73;1;2;70;55;1;54
162202029;500;473;473;7;116;401;1;98;6;3;89;18;1;17
162202030;500;491;491;6;126;400;1;99;11;0;88;27;0;27
162202031;700;653;653;21;187;512;1;187;30;0;157;0;0;0
162202032;600;618;621;8;183;421;1;178;26;0;152;5;0;5
162202033;700;709;713;3;183;516;1;183;24;1;158;0;0;0
162202034;700;746;747;6;109;590;1;109;15;0;94;0;0;0
162202035;600;552;553;5;126;473;1;126;16;0;110;0;0;0
162202036;600;590;590;5;122;482;1;117;17;0;100;5;0;5
162202037;600;623;623;7;156;444;1;151;25;0;126;5;0;5
162202038;700;714;714;7;209;495;1;204;31;0;173;5;0;5
162202039;1000;874;877;5;197;807;3;190;40;0;150;7;0;7
162202040;800;773;774;9;198;610;1;189;31;0;158;9;0;9
162202041;900;877;878;2;164;738;1;161;27;1;133;3;0;3
162202042;800;785;786;5;107;698;1;101;20;0;81;6;1;5
162202043;700;714;717;8;151;552;1;147;35;0;112;4;0;4
162202044;700;753;753;11;138;571;2;127;22;1;104;11;0;11
162202045;600;625;625;7;82;536;1;63;13;0;50;19;0;19
162202046;700;719;720;7;117;601;1;98;8;0;90;19;0;19
162202047;600;599;598;7;107;494;1;105;18;0;87;2;0;2
162202048;700;676;676;7;184;520;1;179;43;0;136;5;0;5
162202049;800;774;774;7;126;673;1;126;15;0;111;0;0;0
162202050;900;878;878;7;237;662;1;237;31;4;202;0;0;0
162202051;800;839;839;9;143;665;1;134;20;0;114;9;2;7
162202052;800;856;857;7;153;656;2;142;31;0;111;11;0;11
162202053;900;885;887;6;183;716;1;183;19;2;162;0;0;0
162202054;800;793;793;9;244;658;1;141;14;2;125;103;8;95
162202055;600;592;619;6;182;509;1;90;2;3;85;92;2;90
162202056;700;675;676;6;230;596;1;103;5;2;96;127;2;125
162202057;700;742;742;6;284;592;2;106;1;2;103;178;9;169
162202058;600;577;577;7;204;525;1;74;2;3;69;130;4;126
162202059;500;484;485;5;162;426;1;73;1;0;72;89;2;87
162202060;800;802;802;6;280;686;2;112;3;0;109;168;6;162
162202061;600;586;585;4;199;407;2;191;5;5;181;8;0;8
162202062;600;610;610;7;249;491;1;108;3;3;102;141;9;132
162202063;600;633;635;7;240;500;1;99;4;3;92;141;4;137
162202064;500;459;459;7;151;426;3;71;2;2;67;80;6;74
162202065;700;675;675;11;238;601;1;98;1;0;97;140;4;136
162202066;700;673;673;5;227;596;1;103;1;1;101;124;6;118
162202067;700;707;707;10;283;577;1;122;1;2;119;161;7;154
162202068;800;747;751;5;304;670;1;129;11;4;114;175;8;167
162202069;600;635;635;12;245;473;3;124;1;3;120;121;1;120
162202070;700;655;659;4;218;615;1;84;3;1;80;134;1;133
162203001;600;619;619;4;178;524;1;75;0;2;73;103;3;100
162203002;700;695;696;4;188;600;1;99;3;5;91;89;2;87
162203003;600;585;585;2;170;506;5;89;3;0;86;81;1;80
162203004;600;638;639;5;201;506;1;93;2;1;90;108;5;103
162203005;700;691;691;2;210;590;1;109;4;8;97;101;1;100
162203006;600;600;602;10;249;465;1;134;3;7;124;115;3;112
162203007;600;588;588;25;228;503;1;96;1;4;91;132;10;122
162203008;600;606;609;7;202;519;1;80;2;0;78;122;4;118
162203009;700;691;693;9;224;597;2;101;1;1;99;123;5;118
162203010;800;849;849;7;275;671;2;127;3;3;121;148;8;140
162203011;700;697;697;3;223;604;2;94;4;6;84;129;5;124
162203012;800;793;794;9;259;690;1;109;0;3;106;150;2;148
162203013;900;957;958;8;371;709;1;190;6;5;179;181;9;172
162203014;300;144;144;86;124;175;1;124;1;8;115;0;0;0
162203015;500;575;576;9;197;401;1;98;0;5;93;99;3;96
162203016;600;672;672;8;205;516;1;83;2;3;78;122;2;120
162203017;600;581;582;8;213;511;3;86;2;4;80;127;2;125
162203018;800;873;873;7;309;679;1;120;3;1;116;189;10;179
162203019;800;876;876;4;306;654;1;145;5;3;137;161;9;152
162203020;700;776;778;4;226;585;1;114;3;4;107;112;0;112
162203021;700;680;680;7;174;621;1;78;2;1;75;96;2;94
162203022;700;680;680;6;219;609;1;90;4;3;83;129;4;125
162203023;600;673;673;2;233;468;6;126;4;3;119;107;4;103
162203024;600;609;609;5;197;496;2;102;2;4;96;95;3;92
162203025;900;898;899;4;268;772;1;127;0;4;123;141;8;133
162203026;600;676;678;5;219;492;1;107;3;3;101;112;7;105
162203027;600;667;667;2;184;478;1;121;3;1;117;63;1;62
162203028;700;729;729;4;230;595;1;104;3;4;97;126;8;118
162203029;700;714;714;5;195;591;1;108;2;4;102;87;4;83
162203030;1000;1041;1041;5;312;857;1;142;4;4;134;170;10;160
162203031;700;738;739;4;250;592;1;107;1;2;104;143;4;139
162203032;500;564;564;12;202;418;1;81;0;1;80;121;6;115
162203033;600;644;645;5;251;494;1;105;0;2;103;146;5;141
162203034;800;869;869;4;310;669;1;130;11;3;116;180;3;177
162203035;500;547;547;8;178;407;1;92;3;1;88;86;9;77
162203036;600;657;657;2;242;475;1;124;2;2;120;118;5;113
162203037;600;674;675;7;285;500;1;99;6;2;91;186;8;178
162203038;700;731;731;6;274;588;1;111;1;4;106;163;7;156
162203039;800;813;813;1;315;644;1;155;2;4;149;160;1;159
162203040;700;658;658;7;212;610;1;89;4;2;83;123;9;114
162203041;800;782;783;6;247;695;1;104;2;7;95;143;3;140
162203042;800;872;872;3;292;653;1;146;4;1;141;146;5;141
162203043;800;846;847;5;259;643;1;156;2;8;146;103;6;97
162203044;900;939;939;3;256;778;1;121;8;0;113;135;9;126
162203045;900;914;915;4;310;728;2;170;7;4;159;140;9;131
162203046;600;662;662;3;182;510;1;89;4;4;81;93;7;86
162203047;400;333;347;6;132;346;1;53;1;2;50;79;6;73
162203048;400;24;24;86;88;311;1;88;3;4;81;0;0;0
162203049;400;49;49;47;51;347;2;51;3;8;40;0;0;0
162203050;300;21;21;17;19;280;1;19;0;1;18;0;0;0
162203051;400;19;19;63;74;324;2;74;1;8;65;0;0;0
162204001;500;497;498;8;171;393;1;106;0;5;101;65;3;62
162204002;600;588;588;5;216;495;1;104;5;1;98;112;7;105
162204003;500;477;477;7;152;433;1;66;1;0;65;86;15;71
162204004;500;536;537;5;195;399;1;100;2;5;93;95;5;90
162204005;600;601;601;5;184;514;1;85;5;1;79;99;2;97
162204006;500;531;535;6;107;450;1;49;5;1;43;58;2;56
162204007;600;583;584;8;190;493;1;106;2;3;101;84;0;84
162204008;500;512;514;5;139;427;8;65;7;1;57;74;3;71
162204009;600;621;621;7;198;513;1;86;3;3;80;112;2;110
162204010;500;529;531;6;163;411;3;86;2;4;80;77;2;75
162204011;700;675;675;6;199;600;1;99;3;4;92;100;3;97
162204012;700;648;651;5;222;606;2;92;1;7;84;130;5;125
162204013;500;501;501;5;164;426;1;73;2;11;60;91;2;89
162204014;600;625;625;3;129;501;1;98;24;1;73;31;1;30
162204015;700;780;780;3;164;566;1;133;13;2;118;31;1;30
162204016;700;794;794;7;186;513;1;186;33;0;153;0;0;0
162204017;600;589;591;11;184;514;1;85;2;1;82;99;2;97
162204018;500;540;540;6;191;409;1;90;1;2;87;101;6;95
162204019;700;806;807;5;291;523;1;176;1;5;170;115;27;88
162204020;700;713;713;7;280;557;1;142;1;3;138;138;8;130
162204021;700;651;656;5;239;597;1;102;1;0;101;137;5;132
162204022;600;567;594;8;180;537;1;62;1;5;56;118;8;110
162204023;800;850;850;5;336;670;1;129;4;2;123;207;7;200
162204024;600;651;651;6;237;502;1;97;1;4;92;140;6;134
162204025;700;736;738;2;249;586;1;113;4;0;109;136;6;130
162204026;700;725;725;2;276;592;1;107;0;3;104;169;8;161
162204027;500;465;465;5;148;425;1;74;5;1;68;74;5;69
162204028;500;465;466;7;144;426;1;73;1;2;70;71;4;67
162204029;600;578;578;4;209;492;1;107;3;3;101;102;3;99
162204030;600;610;610;4;189;508;2;90;7;2;81;99;5;94
162204031;500;524;525;6;176;417;1;82;1;2;79;94;6;88
162204032;600;599;600;6;195;511;1;88;0;6;82;107;5;102
162204033;800;813;813;3;252;547;1;252;13;0;239;0;0;0
162204034;500;506;506;2;168;415;1;84;3;1;80;84;3;81
162204035;800;902;902;6;317;676;1;123;2;6;115;194;7;187
162204036;400;435;435;0;123;342;1;57;4;2;51;66;2;64
162204037;800;800;801;3;308;674;1;125;1;1;123;183;3;180
162204038;700;731;731;6;248;573;2;125;4;4;117;123;1;122
162204039;700;648;650;4;245;583;1;116;2;2;112;129;1;128
162204040;700;681;681;4;225;595;2;103;4;3;96;122;5;117
162204041;600;559;559;4;220;524;1;75;0;1;74;145;1;144
162204042;500;524;524;4;205;425;1;74;5;3;66;131;11;120
162204043;500;481;482;6;170;427;1;72;4;1;67;98;3;95
162204044;700;690;690;8;226;517;2;181;4;7;170;45;1;44
162204045;700;693;693;3;253;433;16;251;15;2;234;2;0;2
162204046;700;684;684;6;206;606;1;93;0;2;91;113;8;105
162204047;600;550;550;3;157;507;1;92;3;2;87;65;4;61
162204048;600;555;556;8;155;520;1;79;1;0;78;76;1;75
162204049;600;562;563;2;146;533;2;65;5;0;60;81;4;77
162204050;600;588;588;6;152;535;1;64;1;0;63;88;5;83
162204051;600;587;587;5;141;530;1;69;0;6;63;72;4;68
162204052;700;644;648;0;249;602;1;97;4;6;87;152;7;145
162204053;600;598;598;5;206;516;1;83;3;1;79;123;10;113
162204054;400;374;374;9;140;337;1;62;0;2;60;78;7;71
162204055;400;381;382;5;114;324;1;75;1;3;71;39;2;37
162204056;400;360;361;4;134;325;1;74;4;5;65;60;4;56
162204057;500;442;442;1;158;419;1;80;3;2;75;78;5;73
162204058;800;731;731;2;213;704;1;95;1;3;91;118;3;115
162204059;400;396;396;1;122;333;1;66;2;0;64;56;4;52
162204060;700;609;609;4;199;588;2;110;4;2;104;89;3;86
162204061;600;566;566;5;199;513;1;86;2;1;83;113;4;109
162204062;700;615;616;5;192;605;1;94;3;6;85;98;5;93
162204063;700;714;714;5;275;586;1;113;1;7;105;162;11;151
162204064;700;690;690;2;210;598;1;101;2;4;95;109;5;104
162204065;600;571;571;5;151;517;1;82;5;4;73;69;5;64
162204066;500;470;472;17;156;419;1;80;3;2;75;76;4;72
162204067;600;614;614;3;192;539;1;60;0;0;60;132;7;125
162204068;600;592;593;7;242;499;1;100;4;5;91;142;3;139
162204069;500;508;508;9;82;436;1;63;1;2;60;19;1;18
162204070;400;382;403;8;161;327;1;72;1;3;68;89;3;86
162204071;700;626;627;6;247;610;1;89;0;1;88;158;3;155
162204072;600;529;530;3;199;400;1;199;9;3;187;0;0;0
162204073;800;867;867;4;382;639;1;160;1;6;153;222;6;216
162204074;100;18;18;1;19;81;0;19;0;0;19;0;0;0
162204075;200;7;7;40;47;149;4;47;2;0;45;0;0;0
162205001;600;531;532;11;180;509;1;90;1;3;86;90;1;89
162205002;700;665;668;8;214;540;2;158;5;0;153;56;0;56
162205003;600;597;597;7;207;484;1;115;3;3;109;92;3;89
162205004;600;625;626;8;215;491;1;108;2;3;103;107;7;100
162205005;700;724;724;12;285;569;1;130;0;8;122;155;6;149
162205006;600;640;641;8;226;475;1;124;3;4;117;102;3;99
162205007;700;604;605;8;227;607;1;92;2;4;86;135;5;130
162205008;700;679;679;6;243;578;1;121;4;3;114;122;8;114
162205009;600;648;648;7;236;505;1;94;5;1;88;142;9;133
162205010;600;638;639;6;233;466;2;132;0;2;130;101;3;98
162205011;700;654;654;3;205;600;1;99;1;4;94;106;1;105
162205012;700;657;658;6;190;609;1;90;5;2;83;100;3;97
162205013;500;561;562;8;185;345;1;154;7;5;142;31;0;31
162205014;600;617;617;7;201;522;1;77;1;0;76;124;5;119
162205015;600;616;616;5;182;525;1;74;1;3;70;108;7;101
162205016;700;609;608;5;213;605;3;92;0;2;90;121;6;115
162205017;700;713;712;4;216;601;2;97;3;4;90;119;3;116
162205018;600;612;612;7;192;517;1;82;1;3;78;110;5;105
162205019;600;639;639;6;219;406;2;192;6;7;179;27;1;26
162205020;700;643;643;7;264;545;1;154;10;1;143;110;8;102
162205021;700;789;789;23;277;586;1;113;7;4;102;164;7;157
162205022;600;181;617;10;191;519;1;80;2;5;73;111;4;107
162205023;600;582;582;9;208;492;2;106;2;4;100;102;3;99
162205024;700;612;614;10;254;566;3;131;8;3;120;123;6;117
162205025;600;653;652;14;241;515;1;84;1;2;81;157;10;147
162205026;700;680;680;7;203;605;1;94;5;1;88;109;8;101
162205027;600;582;584;5;194;519;1;80;1;2;77;114;4;110
162205028;800;786;786;5;291;641;2;157;1;5;151;134;5;129
162205029;700;674;675;10;237;596;2;102;2;1;99;135;4;131
162205030;600;626;626;6;194;436;1;163;2;5;156;31;1;30
162205031;600;641;643;9;211;518;2;80;3;2;75;131;5;126
162205032;800;669;672;6;162;728;1;71;1;1;69;91;5;86
162205033;700;710;710;3;232;570;1;129;6;0;123;103;6;97
162205034;700;809;809;8;231;598;1;101;3;3;95;130;6;124
162205035;700;723;723;7;225;582;1;117;2;1;114;108;8;100
162205036;700;762;763;9;223;613;1;86;1;3;82;137;4;133
162205037;700;724;725;6;246;594;1;105;8;2;95;141;9;132
162205038;900;828;828;9;278;787;2;111;8;6;97;167;11;156
162205039;800;759;781;7;238;666;7;127;6;5;116;111;8;103
162205040;800;880;881;6;326;638;1;161;7;4;150;165;6;159
162205041;900;944;944;8;308;703;1;196;4;14;178;112;3;109
162205042;800;700;702;12;245;675;1;124;5;5;114;121;6;115
162205043;700;665;665;5;184;595;1;104;5;1;98;80;2;78
162205044;700;663;664;10;220;592;2;106;5;3;98;114;8;106
162205045;700;685;685;4;243;583;1;116;6;4;106;127;5;122
162205046;700;754;754;6;260;602;1;97;1;3;93;163;11;152
162205047;700;667;668;8;228;606;2;92;4;5;83;136;15;121
162205048;600;595;596;6;165;513;2;85;5;4;76;80;3;77
162205049;600;615;615;3;162;520;2;78;4;1;73;84;1;83
162205050;600;599;599;6;172;487;2;111;6;1;104;61;1;60
162205051;700;702;703;8;222;611;1;88;1;2;85;134;4;130
162205052;600;666;666;9;200;508;1;91;4;1;86;109;6;103
162205053;800;741;741;33;259;670;1;129;6;1;122;130;2;128
162205054;800;843;843;10;291;670;2;128;6;6;116;163;7;156
162205055;900;909;908;3;295;666;1;233;5;5;223;62;2;60
162205056;900;903;903;9;291;780;1;119;3;4;112;172;5;167
162205057;900;1001;1002;11;334;784;1;115;0;5;110;219;9;210
162205058;900;904;904;6;287;782;2;116;1;0;115;171;2;169
162205059;800;778;780;8;285;596;1;203;5;6;192;82;3;79
162205060;800;800;800;7;225;684;1;115;3;2;110;110;4;106
162205061;800;790;791;8;252;674;1;125;4;3;118;127;3;124
162205062;700;736;736;7;245;590;1;109;3;2;104;136;2;134
162205063;700;764;764;2;277;569;1;130;3;7;120;147;1;146
162205064;800;833;834;5;242;696;1;103;4;1;98;139;7;132
162205065;800;787;790;4;219;690;1;109;5;5;99;110;7;103
162205066;800;838;838;0;196;702;2;96;3;5;88;100;7;93
162205067;700;762;762;7;206;594;1;105;7;2;96;101;4;97
162205068;900;983;985;6;332;776;1;123;3;3;117;209;13;196
162205069;800;861;863;6;216;707;1;92;5;3;84;124;4;120
162205070;800;849;849;18;238;700;1;99;5;2;92;139;12;127
162205071;800;683;684;12;205;711;1;88;2;0;86;117;4;113
162205072;700;740;740;0;235;538;6;156;9;3;144;79;6;73
162205073;748;736;736;12;233;639;1;108;6;3;99;125;0;125
162205074;700;694;694;6;205;593;1;106;4;3;99;99;5;94
162205075;700;713;714;6;242;573;1;126;5;4;117;116;5;111
162205076;700;740;740;7;244;572;1;127;4;5;118;117;9;108
162205077;700;719;719;7;233;560;1;139;4;3;132;94;3;91
162205078;700;692;692;3;188;602;3;95;1;0;94;93;3;90
162205079;700;700;700;7;227;589;1;110;1;0;109;117;5;112
162205080;700;699;699;5;208;618;1;81;2;3;76;127;8;119
162205081;700;711;712;8;204;609;1;90;4;2;84;114;5;109
162205082;700;780;781;7;222;605;1;94;5;2;87;128;7;121
162205083;700;756;759;6;221;595;2;103;2;5;96;118;2;116
162205084;900;950;951;3;285;747;1;152;0;7;145;133;8;125
162205085;800;840;835;5;258;692;1;107;2;3;102;151;3;148
162205086;800;656;657;36;272;655;1;144;14;2;128;128;8;120
162205087;800;641;640;9;222;697;1;102;6;1;95;120;5;115
162205088;600;662;662;3;204;502;1;97;0;4;93;107;1;106
162205089;700;662;662;6;210;586;1;113;3;2;108;97;1;96
162205090;600;655;656;5;204;485;1;114;4;3;107;90;8;82
162205091;600;670;672;5;167;528;1;71;0;2;69;96;2;94
162205092;700;712;712;4;230;606;1;93;5;2;86;137;10;127
162205093;700;677;678;3;229;583;2;115;3;5;107;114;5;109
162205094;600;642;642;3;197;521;1;78;2;4;72;119;4;115
162205095;600;623;625;3;163;515;1;84;1;0;83;79;0;79
162205096;300;25;25;6;31;269;0;31;1;0;30;0;0;0
162205097;400;67;67;24;84;315;1;84;20;4;60;0;0;0
162205098;500;117;117;20;112;387;1;112;26;6;80;0;0;0
162206001;700;673;673;4;216;590;2;108;3;6;99;108;7;101
162206002;600;610;608;0;211;494;1;105;2;2;101;106;3;103
162206003;500;457;486;9;159;423;2;75;3;5;67;84;6;78
162206004;700;653;653;7;178;625;1;74;1;4;69;104;6;98
162206005;600;577;577;4;192;528;1;71;3;0;68;121;3;118
162206006;600;578;577;3;154;540;1;59;4;1;54;95;8;87
162206007;800;749;770;7;233;707;1;92;0;2;90;141;5;136
162206008;600;644;640;4;182;501;1;98;1;0;97;84;7;77
162206009;600;610;630;5;209;467;2;131;3;3;125;78;4;74
162206010;600;607;607;7;180;511;1;88;4;3;81;92;5;87
162206011;700;662;665;8;234;606;1;93;2;3;88;141;8;133
162206012;600;632;626;8;157;529;1;70;2;0;68;87;3;84
162206013;700;671;671;4;195;618;1;81;1;4;76;114;5;109
162206014;700;717;717;3;205;610;1;89;6;2;81;116;2;114
162206015;700;701;702;3;187;611;1;88;4;5;79;99;6;93
162206016;800;743;758;2;198;692;1;107;8;4;95;91;4;87
162206017;600;609;609;7;160;518;3;79;3;1;75;81;1;80
162206018;700;645;646;4;153;634;2;64;1;3;60;89;2;87
162206019;600;597;597;5;175;512;1;87;2;2;83;88;4;84
162206020;600;638;639;4;205;518;1;81;2;5;74;124;4;120
162206021;700;682;681;0;227;590;1;109;0;1;108;118;9;109
162206022;600;607;608;5;181;509;2;89;3;6;80;92;4;88
162206023;700;758;757;7;232;586;1;113;2;2;109;119;7;112
162206024;700;710;711;4;239;576;3;121;2;5;114;118;4;114
162206025;600;619;619;7;192;486;3;111;3;5;103;81;4;77
162206026;700;680;680;2;266;515;1;184;5;6;173;82;4;78
162206027;600;628;629;8;205;494;1;105;0;7;98;100;4;96
162206028;700;737;739;6;247;592;1;107;5;2;100;140;10;130
162206029;700;703;703;5;236;586;1;113;1;5;107;123;7;116
162206030;700;671;673;7;195;613;1;86;6;2;78;109;6;103
162206031;600;616;616;4;172;537;1;62;1;0;61;110;5;105
162206032;600;629;629;0;191;510;1;89;2;1;86;102;6;96
162206033;600;632;631;1;222;498;1;101;3;3;95;121;6;115
162206034;700;680;682;1;239;580;2;118;7;2;109;121;7;114
162206035;700;649;649;5;191;591;2;107;3;3;101;84;5;79
162206036;700;713;714;4;214;588;2;110;2;5;103;104;5;99
162206037;600;573;575;13;181;499;1;100;5;2;93;81;2;79
162206038;700;661;661;4;179;607;1;92;2;0;90;87;6;81
162206039;600;607;607;5;158;535;2;63;1;1;61;95;9;86
162206040;500;440;442;40;162;410;1;89;3;1;85;73;2;71
162206041;600;595;595;3;160;510;1;89;4;1;84;71;1;70
162206042;400;430;431;3;112;340;2;58;0;1;57;54;0;54
162206043;500;516;517;6;163;428;1;71;2;0;69;92;5;87
162206044;600;609;611;6;198;502;1;97;1;3;93;101;5;96
162206045;700;674;695;3;216;602;2;96;4;3;89;120;0;120
162206046;600;595;596;6;223;480;2;118;1;10;107;105;5;100
162206047;700;689;690;6;232;588;1;111;2;4;105;121;11;110
162206048;700;699;699;4;275;594;1;105;0;2;103;170;7;163
162206049;700;636;637;3;187;613;1;86;0;1;85;101;1;100
162206050;600;559;561;0;197;490;1;109;0;1;108;88;6;82
162206051;700;621;622;3;191;595;3;102;1;2;99;89;3;86
162206052;600;611;611;6;152;525;1;74;0;3;71;78;0;78
162206053;800;813;815;1;210;708;1;91;3;3;85;119;4;115
162206054;800;789;789;7;264;677;4;119;0;5;114;145;4;141
162206055;700;720;731;11;281;623;1;76;3;0;73;205;16;189
162206056;700;635;643;0;205;592;1;107;6;3;98;98;3;95
162206057;700;728;728;4;230;505;1;194;3;8;183;36;4;32
162206058;700;675;675;3;206;608;1;91;2;3;86;115;5;110
162206059;700;700;700;6;234;562;1;137;0;4;133;97;4;93
162206060;600;611;613;0;177;513;4;83;3;0;80;94;2;92
162206061;800;730;731;7;252;682;1;117;2;2;113;135;4;131
162206062;800;747;747;4;292;690;1;109;5;1;103;183;5;178
162206063;800;753;752;6;279;668;1;131;1;4;126;148;5;143
162206064;800;770;770;2;309;662;2;136;2;2;132;173;4;169
162206065;799;765;767;2;229;704;1;94;5;2;87;135;5;130
162206066;800;759;759;4;222;697;1;102;3;3;96;120;1;119
162206067;800;780;779;4;210;711;1;88;3;2;83;122;3;119
162206068;700;725;725;15;273;596;1;103;1;0;102;170;6;164
162206069;800;751;751;4;255;716;2;82;2;1;79;173;2;171
162206070;900;913;914;1;282;794;1;105;2;7;96;177;10;167
162206071;900;855;855;4;253;698;1;201;2;7;192;52;4;48
162206072;700;674;676;9;208;602;1;97;3;4;90;111;3;108
162206073;100;63;63;6;23;75;2;23;6;2;15;0;0;0
162206074;100;8;8;16;19;79;2;19;3;2;14;0;0;0
162206075;100;21;21;7;27;73;0;27;0;0;27;0;0;0
170100001;500;766;766;5;191;363;1;136;7;3;126;55;0;55
170100002;400;693;693;6;193;288;2;110;7;2;101;83;4;79
170100003;500;832;832;3;213;357;1;142;6;4;132;71;1;70
170100004;500;798;799;2;228;357;1;142;4;2;136;86;2;84
170100005;500;771;771;2;200;379;1;120;1;5;114;80;7;73
170100006;400;580;580;7;202;288;1;111;3;2;106;91;1;90
170100007;500;906;909;8;319;324;1;175;5;4;166;144;6;138
170100008;500;826;829;6;263;337;1;162;5;5;152;101;5;96
170100009;400;691;691;10;257;265;1;134;5;2;127;123;5;118
170100010;400;630;631;5;219;240;1;159;5;7;147;60;3;57
170100011;500;778;782;2;295;299;1;200;3;5;192;95;5;90
170100012;400;685;685;6;242;290;1;109;3;1;105;133;10;123
170100013;300;440;440;5;137;229;1;70;4;2;64;67;2;65
170100014;300;502;502;5;192;195;1;104;2;0;102;88;5;83
170100015;400;619;621;5;225;263;1;136;7;8;121;89;3;75
170100016;400;741;741;9;233;280;1;119;3;3;113;114;6;108
170100017;300;433;442;3;167;199;1;100;4;2;94;67;3;64
170100018;300;473;473;2;175;215;1;84;1;0;83;91;4;87
170100019;300;536;536;4;181;215;4;81;4;1;76;100;6;94
170100020;400;697;700;4;274;266;1;133;3;4;126;141;11;130
170100021;500;819;819;2;298;344;2;154;6;1;147;144;9;135
170100022;500;845;864;3;289;337;2;161;2;5;154;128;8;120
170100023;300;494;494;4;172;206;1;93;1;3;89;79;10;69
170100024;400;724;726;8;249;256;1;143;3;2;138;106;7;99
170100025;200;355;355;0;131;118;1;81;0;0;81;50;2;48
170100026;400;628;628;11;240;256;1;143;7;2;134;97;7;90
170100027;300;533;533;0;181;195;1;104;4;1;99;77;0;77
170100028;300;393;393;6;152;219;1;80;1;0;79;72;2;70
170100029;400;692;692;8;199;264;1;135;4;3;128;64;1;63
170100030;300;399;399;7;133;241;1;58;1;1;56;75;1;74
170100031;500;745;745;9;187;361;1;138;4;6;128;49;2;47
170100032;400;656;656;5;214;267;1;132;5;9;118;82;4;78
170100033;400;658;659;7;217;241;4;155;3;2;150;62;4;58
170100034;500;773;776;5;192;392;1;107;3;1;103;85;2;83
170100035;300;536;547;7;208;180;1;119;3;1;115;89;2;87
170100036;300;493;494;8;126;228;1;71;5;1;65;55;2;53
170100037;300;571;571;7;189;194;1;105;2;2;101;84;1;83
170100038;500;877;879;7;197;389;1;110;7;6;97;87;3;84
170100039;500;764;764;11;204;382;1;117;3;4;110;87;3;84
170100040;400;613;613;6;161;275;1;124;7;3;114;37;1;36
170100041;300;494;494;5;184;194;1;105;1;7;97;79;4;75
170100042;400;657;659;3;188;283;3;114;2;2;110;74;2;72
170100043;400;703;703;13;244;256;2;142;2;3;137;102;4;98
170100044;400;694;695;3;198;218;1;181;4;2;175;17;1;16
170100045;300;461;467;7;143;217;3;80;3;2;75;63;2;61
170100046;500;787;788;4;226;363;1;136;1;1;134;90;2;88
170100047;500;802;803;8;171;393;1;106;8;3;95;65;2;63
170100048;400;627;628;8;139;323;1;76;2;1;73;63;0;63
170100049;400;679;679;5;177;300;1;99;2;1;96;78;1;77
170100050;400;657;657;2;132;326;2;72;3;0;69;60;3;57
170100051;200;342;342;9;103;132;1;67;1;2;64;36;1;35
170100052;400;726;726;4;178;278;4;118;3;1;114;60;3;57
170100053;400;624;625;8;160;294;1;105;0;1;104;55;4;51
170100054;400;730;731;9;126;295;1;104;4;0;100;22;1;21
170100055;300;444;444;16;91;221;1;78;3;0;75;13;0;13
170100056;400;681;681;14;107;296;1;103;6;1;96;4;0;4
170100057;500;807;808;6;113;411;1;88;5;6;77;25;3;22
170100058;500;840;840;7;87;412;1;87;27;3;57;0;0;0
170100059;600;935;935;6;80;522;1;77;29;1;47;3;0;3
170100060;300;482;483;2;174;194;1;105;3;3;99;69;4;65
170100061;400;589;590;5;110;315;1;84;2;6;76;26;2;24
170100062;300;536;538;3;139;176;1;123;0;0;123;16;0;16
170100063;400;709;709;6;195;257;1;142;5;2;135;53;0;53
170100064;300;544;545;7;179;143;1;156;6;6;144;23;0;23
170100065;500;836;838;9;207;362;1;137;4;4;129;70;2;68
170100066;500;871;871;8;281;257;2;241;1;3;237;40;2;38
170100067;300;258;260;6;128;171;1;128;12;4;112;0;0;0
170100068;500;445;445;3;98;447;1;52;1;1;50;46;0;46
170100069;100;10;10;8;12;87;1;12;0;0;12;0;0;0
170100070;100;18;18;8;11;88;1;11;0;0;11;0;0;0
170100071;100;71;74;7;58;41;1;58;4;1;53;0;0;0
170100072;300;251;253;4;143;156;1;143;7;7;129;0;0;0
170100073;100;15;15;7;16;83;1;16;0;0;16;0;0;0
170100074;400;366;369;4;103;321;2;77;2;2;73;26;2;24
170100075;600;631;631;2;214;429;1;170;5;4;161;44;1;43
170100076;500;469;475;0;106;415;1;84;1;2;81;22;0;22
170100077;500;492;497;2;125;412;1;87;4;3;80;38;0;38
170100078;100;19;19;4;23;77;0;23;1;0;22;0;0;0
170100079;700;762;762;5;308;398;1;301;8;10;283;7;0;7
170100080;100;35;35;6;27;72;1;27;0;0;27;0;0;0
170100081;300;291;291;2;132;167;1;132;7;3;122;0;0;0
170100082;300;295;295;3;138;161;1;138;3;2;133;0;0;0
170100083;200;199;200;4;81;118;1;81;2;1;78;0;0;0
170100084;300;261;262;4;105;194;1;105;4;4;97;0;0;0
170100085;200;137;137;7;68;131;1;68;4;0;64;0;0;0
170100086;200;107;107;2;70;129;1;70;3;0;67;0;0;0
170100087;100;28;28;6;26;73;1;26;0;1;25;0;0;0
170100088;300;278;278;0;154;145;1;154;2;3;149;0;0;0
170100089;600;605;605;5;201;398;1;201;6;6;189;0;0;0
170100090;800;792;792;2;65;735;5;60;4;0;56;5;0;5
170100091;600;603;604;3;179;466;3;131;1;0;130;48;2;46
170100092;600;569;569;4;163;461;1;138;7;0;131;25;1;24
170100093;700;698;698;4;186;535;1;164;5;2;157;22;2;20
170100094;100;22;22;7;20;79;1;20;0;1;19;0;0;0
170100095;100;14;14;4;18;82;0;18;1;0;17;0;0;0
170100096;600;561;561;3;218;452;1;147;5;5;137;71;4;67
170100097;100;26;26;8;25;74;1;25;3;1;21;0;0;0
170100098;500;831;833;4;184;346;1;153;8;1;144;31;1;30
170100099;300;302;304;6;145;153;2;145;7;3;135;0;0;0
170100100;600;614;614;3;199;429;1;170;6;7;157;29;2;27
170100101;400;705;705;10;103;307;1;92;23;1;68;11;0;11
170100102;500;793;793;4;198;341;1;158;3;5;150;40;1;37
170100103;300;312;312;0;89;226;1;73;3;0;70;16;0;16
170100104;500;752;752;6;60;439;1;60;30;0;30;0;0;0
170100105;500;875;881;3;249;267;1;232;1;2;229;17;2;15
170100106;100;8;8;8;16;84;0;16;0;2;14;0;0;0
170100107;100;11;11;25;26;73;1;26;0;1;25;0;0;0
170100108;100;17;17;14;31;68;1;31;3;0;28;0;0;0
170100109;100;25;25;22;47;52;1;47;4;0;43;0;0;0
170700001;400;418;421;3;144;293;2;105;3;1;101;39;2;37
170700002;300;340;344;4;127;172;1;127;2;5;120;0;0;0
170700003;600;602;608;3;124;490;1;109;6;1;102;15;0;15
170700004;300;307;308;5;79;232;1;67;6;4;57;12;0;12
170700005;300;317;317;6;66;255;1;44;2;0;42;22;0;22
170700006;200;191;192;2;73;126;1;73;4;1;68;0;0;0
170700007;200;267;269;3;117;82;1;117;4;3;110;0;0;0
170700008;100;61;61;5;42;57;1;42;0;1;41;0;0;0
170700009;150;154;155;4;79;69;2;79;5;4;70;0;0;0
170700010;50;52;52;5;39;10;1;39;3;0;36;0;0;0
170700011;100;130;130;4;86;13;1;86;4;4;78;0;0;0
170700012;100;97;97;4;63;36;1;63;2;3;58;0;0;0
170700013;250;273;273;3;63;186;1;63;4;1;58;0;0;0
170700014;200;195;195;1;62;137;1;62;1;1;60;0;0;0
170700015;500;556;559;2;128;386;1;113;7;0;106;15;1;14
170700016;100;105;105;6;60;39;1;60;3;1;56;0;0;0
170700017;300;325;325;2;111;224;1;75;1;0;74;36;1;35
170700018;400;450;451;2;84;336;1;63;4;4;55;21;0;21
170700019;100;78;78;7;58;41;1;58;5;2;51;0;0;0
170700020;50;13;13;2;15;34;1;15;0;0;15;0;0;0
171200001;800;852;852;1;226;635;3;162;6;3;153;64;1;63
171200002;600;632;633;1;239;442;1;157;5;1;151;82;9;73
171200003;500;545;548;0;168;396;2;102;1;2;99;66;4;62
171200004;400;448;448;1;175;299;1;100;2;4;94;75;1;74
171200005;600;663;663;2;185;490;4;106;5;4;97;79;3;76
171200006;600;594;596;2;159;504;1;95;5;1;89;64;2;62
171200007;1000;980;981;1;165;900;1;99;6;0;93;66;1;65
171200008;600;604;607;2;140;514;1;85;1;1;83;55;3;52
171200009;600;601;602;2;139;525;1;74;2;0;72;65;1;64
171200010;500;505;505;0;135;410;1;89;6;1;82;46;1;45
171200011;200;159;159;0;76;123;1;76;3;1;72;0;0;0
171200012;200;188;188;2;80;119;1;80;5;2;73;0;0;0
171200013;300;309;313;0;134;165;1;134;4;1;129;0;0;0
171200014;600;583;584;1;102;522;1;77;3;1;73;25;1;24
171200015;100;98;99;1;49;50;1;49;2;1;46;0;0;0
171200016;100;121;121;2;65;34;1;65;4;1;60;0;0;0
171200017;300;349;350;2;81;234;2;64;5;0;59;17;0;17
171200018;200;151;152;1;79;120;1;79;1;2;76;0;0;0
171200019;200;248;248;3;86;113;1;86;3;2;81;0;0;0
171200020;400;377;377;1;112;302;1;97;4;1;92;15;1;14
171300001;600;631;632;7;199;521;1;78;3;3;72;121;7;114
171300002;600;625;625;4;221;485;1;114;4;2;108;107;1;106
171300003;600;629;630;4;160;526;1;73;2;0;71;87;3;84
171300004;600;551;551;5;205;489;1;110;1;1;108;95;3;92
171300005;600;642;645;8;138;533;1;66;1;1;64;72;8;64
171300006;600;656;657;8;84;545;1;54;9;0;45;30;2;28
171300007;600;600;602;7;181;500;1;99;9;2;88;82;5;77
171300008;700;718;722;6;226;570;1;129;2;0;127;97;2;95
171300009;700;758;758;8;248;578;1;121;5;5;111;127;6;121
171300010;700;703;703;9;178;627;1;72;3;2;67;106;12;94
171300011;600;602;602;8;164;517;1;82;4;2;76;82;2;80
171300012;700;725;729;8;234;569;3;128;4;5;119;106;2;104
171300013;700;685;685;4;210;585;1;114;6;3;105;96;2;94
171300014;700;681;681;6;214;567;2;131;5;5;121;83;2;81
171300015;600;663;663;7;85;552;1;47;6;1;40;38;1;37
171300016;500;553;553;8;95;431;1;68;4;1;63;27;2;25
171300017;700;673;673;6;183;608;1;91;5;0;86;92;6;86
171300018;600;646;647;6;161;511;1;88;4;1;83;73;4;69
171300019;700;665;666;2;184;586;1;113;26;1;86;71;5;66
171300020;700;672;672;3;176;616;1;83;5;3;75;93;2;91
171300021;700;749;750;6;287;564;1;135;7;1;127;152;7;145
171300022;600;584;584;7;183;485;1;114;1;4;109;69;2;67
171300023;700;666;667;3;194;606;2;92;5;1;86;102;1;101
171300024;600;616;616;4;175;540;1;59;0;1;58;116;2;114
171300025;600;631;632;5;191;417;1;182;4;8;170;9;0;9
171300026;700;665;665;4;210;594;1;105;6;4;95;105;9;96
171300027;700;688;688;3;191;598;1;101;1;3;97;90;8;82
171300028;700;729;729;4;179;596;1;103;9;5;89;76;3;73
171300029;500;579;579;7;167;413;1;86;0;1;85;81;4;77
171300030;700;679;679;8;171;614;1;85;7;1;77;86;0;86
171300031;700;693;693;3;211;583;2;115;7;2;106;96;3;93
171300032;500;475;475;3;99;422;1;77;5;0;72;22;0;22
171300033;100;25;25;6;18;81;1;18;0;1;17;0;0;0
171300034;400;386;386;5;118;314;1;85;5;1;79;33;1;32
171300035;500;541;541;0;124;414;1;85;3;1;81;39;3;36
171300036;500;573;574;4;183;384;1;115;7;6;102;68;0;68
171300037;700;653;655;3;191;592;1;107;4;1;102;84;2;82
171300038;700;698;700;1;161;600;2;98;9;2;87;63;4;59
171300039;900;845;845;3;136;814;1;85;4;2;79;51;2;49
171300040;400;410;412;8;141;288;1;111;8;2;101;30;1;29
171300041;200;147;147;4;68;131;1;68;2;4;62;0;0;0
171300042;300;343;343;3;163;136;1;163;17;2;144;0;0;0
171300043;400;389;389;3;79;343;1;56;4;3;49;23;0;23
171300044;300;284;284;3;98;201;1;98;5;8;85;0;0;0
171300045;100;63;63;8;34;65;1;34;4;1;29;0;0;0
171300046;500;537;537;4;164;381;1;118;6;2;110;46;3;43
171300047;600;627;627;3;242;419;1;180;5;4;171;62;7;55
171300048;500;577;577;4;110;443;1;56;4;1;51;54;1;53
171300049;600;599;599;4;178;476;1;123;7;3;113;55;3;52
171300050;600;619;619;2;184;477;1;122;5;4;113;62;7;55
171300051;600;582;585;1;150;518;1;81;6;5;70;69;7;62
171300052;200;184;184;5;61;138;1;61;1;6;54;0;0;0
171300053;700;741;741;5;198;579;1;120;4;4;112;78;3;75
171300054;600;588;588;5;161;492;1;107;5;9;93;54;4;50
171300055;500;465;465;3;143;400;1;99;3;2;94;44;0;44
171300056;500;481;481;5;130;389;2;109;4;1;104;21;1;20
171300057;500;478;478;6;172;377;1;122;6;3;113;50;0;50
171300058;500;500;448;4;98;432;4;64;3;1;60;34;3;31
171300059;400;409;409;1;114;322;1;77;4;8;65;37;4;33
171300060;600;574;579;5;143;501;1;98;2;5;91;45;6;39
171300061;700;665;665;1;158;590;1;109;2;1;106;49;2;47
171300062;400;393;394;5;110;289;1;110;2;3;105;0;0;0
171300063;300;347;347;2;89;219;1;80;3;1;76;9;0;9
171300064;700;711;713;6;160;605;1;94;4;1;89;66;3;63
171300065;600;616;616;2;118;513;1;86;2;1;83;32;3;29
171300066;700;719;719;5;198;552;1;147;6;3;138;51;2;49
171300067;600;623;623;3;106;517;1;82;10;6;66;24;1;23
171300068;600;618;618;4;104;514;1;85;6;2;77;19;1;18
171300069;700;705;705;4;181;535;1;164;11;2;151;17;0;17
171300070;700;674;674;5;168;558;1;141;12;3;126;27;0;27
171300071;700;683;683;0;93;612;1;87;11;0;76;6;0;6
171300072;800;821;822;5;150;658;1;141;19;0;122;9;0;9
171300073;700;710;711;1;115;602;1;97;9;0;88;18;0;18
171300074;500;464;464;12;144;431;1;68;2;0;66;76;2;74
171300075;500;456;456;6;115;422;2;76;0;5;71;39;1;38
171300076;100;20;20;0;20;79;1;20;0;0;20;0;0;0
171300077;100;4;4;20;24;75;1;24;0;0;24;0;0;0
171300078;100;100;100;28;75;24;1;75;3;7;65;0;0;0
171500001;600;637;639;0;192;488;1;111;8;0;103;81;4;77
171500002;400;407;407;5;121;319;1;80;1;0;79;41;0;41
171500003;600;602;603;4;153;501;3;96;5;1;90;57;4;53
171500004;30;32;32;8;22;7;1;22;1;0;21;0;0;0
171500005;50;41;41;5;19;29;2;19;1;1;17;0;0;0
171500006;140;166;166;7;66;73;1;66;8;2;56;0;0;0
171500007;20;18;18;6;12;7;1;12;0;0;12;0;0;0
171500008;60;61;62;6;46;13;1;46;0;0;46;0;0;0
171500009;150;149;149;6;63;86;1;63;4;0;59;0;0;0
171500010;30;28;28;7;17;12;1;17;0;0;17;0;0;0
171500011;20;18;18;7;8;11;1;8;0;1;7;0;0;0
171700001;700;664;664;0;204;583;1;116;8;2;106;88;3;85
171700002;500;504;504;2;163;393;1;106;7;4;95;57;8;49
171700003;700;739;739;2;245;567;1;132;3;4;125;113;9;104
171700004;500;476;476;0;137;424;1;75;4;1;70;62;0;62
171700005;600;597;598;4;166;545;1;54;2;0;52;112;9;103
171700006;800;826;827;1;287;552;1;247;11;10;226;40;1;39
171700007;600;609;610;4;259;444;1;155;4;2;149;104;4;100
171700008;700;703;703;0;216;586;1;113;1;3;109;103;7;96
171700009;700;723;723;1;161;561;1;138;8;3;127;23;0;23
171700010;700;722;724;6;187;598;1;101;4;6;91;86;7;79
171700011;900;938;938;0;282;766;1;133;0;3;130;149;11;138
171700012;800;777;777;2;229;685;2;113;3;3;107;116;13;103
171700013;800;835;835;1;120;718;1;81;2;2;77;39;3;36
171700014;600;576;576;1;127;540;1;59;7;3;49;68;3;65
171700015;800;774;775;2;155;700;1;99;8;0;91;56;0;56
171700016;600;642;642;1;185;505;2;93;3;2;88;92;5;87
171700017;800;782;783;1;192;701;2;97;2;3;92;95;4;91
171700018;900;957;959;3;286;759;1;140;2;4;134;146;7;139
171700019;700;726;727;1;195;591;2;107;4;2;101;88;1;87
171700020;600;628;628;1;74;553;1;46;5;1;40;28;4;24
171700021;600;611;611;5;186;473;1;126;8;4;114;60;2;58
171700022;400;422;422;0;107;317;2;81;1;1;79;26;2;24
171700023;500;452;452;0;23;482;1;17;1;0;16;6;1;5
171700024;300;324;324;0;123;207;1;92;4;3;85;31;2;29
171700025;500;479;480;1;114;435;1;64;5;2;57;50;0;50
171700026;700;670;670;3;52;673;1;26;1;1;24;26;1;25
171700027;800;756;756;3;196;684;1;115;5;5;105;81;7;74
171700028;600;581;584;3;62;559;1;40;1;0;39;22;1;21
171700029;700;697;697;0;209;574;1;125;2;6;117;84;0;84
171700030;600;602;602;0;148;508;2;90;0;0;90;58;1;57
171700031;500;485;485;0;131;419;1;80;1;3;76;51;2;49
171700032;700;715;715;5;149;605;1;94;2;4;88;55;1;54
171700033;700;711;711;2;24;682;1;17;1;1;15;7;1;6
171700034;700;687;687;0;182;600;1;99;10;7;82;83;8;75
171700035;600;572;572;3;33;569;1;30;0;0;30;3;0;3
171700036;600;604;604;2;102;527;1;72;1;1;70;30;0;30
171700037;500;512;513;1;108;418;2;80;2;1;77;28;2;26
171700038;600;647;647;1;115;511;1;88;2;3;83;27;0;27
171700039;500;510;510;4;147;375;5;120;0;5;115;27;1;26
171700040;500;526;527;3;154;382;1;117;15;2;100;37;1;36
171700041;100;12;12;1;12;87;1;12;2;0;10;0;0;0
172300001;700;661;662;5;129;612;2;86;1;0;85;43;3;40
172300002;600;598;598;4;87;560;1;39;0;0;39;48;0;48
172300003;500;576;576;1;161;405;1;94;3;0;91;67;1;66
172300004;500;690;690;2;225;367;1;132;7;2;123;93;2;91
172300005;800;801;801;6;257;620;1;179;1;4;174;78;1;77
172300006;1000;946;949;5;132;895;2;103;6;1;96;29;1;28
172300007;600;660;660;1;211;477;1;122;2;3;117;89;3;86
172300008;600;695;695;2;219;475;1;124;3;2;119;95;6;89
172300009;500;534;536;8;155;413;1;86;0;0;86;69;4;65
172300010;400;479;479;6;187;315;2;83;0;5;78;104;4;100
172300011;500;595;596;1;189;390;1;109;1;3;105;80;2;78
172300012;600;613;613;7;186;474;1;125;4;5;116;61;4;57
172300013;500;512;513;4;193;405;5;90;4;8;78;103;6;97
172300014;700;927;927;5;51;664;1;35;4;1;30;16;1;15
172300015;500;585;585;2;70;448;1;51;4;1;46;19;2;17
172300016;700;696;696;5;183;544;1;155;8;2;145;28;1;27
172300017;800;802;802;2;119;713;5;82;4;4;74;37;3;34
172300018;800;836;836;6;169;664;1;135;6;2;127;34;1;33
172300019;700;684;684;1;94;619;1;80;6;1;73;14;1;13
172300020;500;532;532;2;123;407;1;92;1;3;88;31;0;32
172300021;400;525;526;0;162;264;1;135;3;3;129;27;2;25
172300022;600;646;647;3;186;443;1;156;5;5;146;30;1;29
172300023;100;36;36;7;23;76;1;23;0;0;23;0;0;0
172300024;400;416;416;1;64;345;1;54;3;0;51;10;2;8
172300025;400;477;477;1;91;322;1;77;6;2;69;14;0;14
172300026;500;585;586;4;118;413;1;86;2;4;80;32;0;32
172300027;400;418;418;0;111;288;1;111;3;0;108;0;0;0
172300028;600;560;560;6;155;462;1;137;5;2;130;18;1;17
172300029;600;611;611;5;184;428;1;171;5;3;163;13;1;12
172300030;200;218;218;5;111;88;1;111;13;4;94;0;0;0
172300031;400;404;404;2;104;334;1;65;2;0;63;39;0;39
172300032;300;335;336;8;105;218;1;81;1;0;80;24;0;24
172300033;400;417;418;4;134;278;1;121;3;3;115;13;2;11
172300034;600;604;604;9;131;482;2;116;11;1;104;15;0;15
172300035;500;466;466;1;78;426;1;73;5;0;68;5;0;5
172300036;500;469;469;0;139;388;1;111;1;5;105;28;0;28
172300037;200;113;113;3;58;141;1;58;1;0;57;0;0;0
172300038;400;404;405;4;116;298;1;101;4;0;97;15;2;13
172300039;1000;970;971;3;126;890;1;109;11;1;97;17;0;17
172500001;800;766;766;0;190;701;1;98;9;1;88;92;5;87
172500002;800;765;765;0;186;704;3;93;4;1;88;93;7;86
172500003;500;550;550;0;105;454;1;45;5;1;39;60;3;57
172500004;400;440;440;3;100;362;1;37;0;2;35;63;1;62
172500005;1000;965;965;0;197;907;2;91;5;4;82;106;2;104
172500006;700;721;722;0;147;621;1;78;5;0;73;69;2;67
172500007;800;773;773;0;172;706;2;92;3;2;87;80;5;75
172500008;500;456;456;0;108;450;3;47;2;0;45;61;1;60
172500009;600;569;570;1;128;551;1;48;4;0;44;80;3;77
172500010;700;714;715;1;147;623;1;76;2;5;69;71;2;69
172500011;600;640;640;1;143;510;1;89;5;3;81;54;0;54
172500012;700;742;742;0;164;611;1;88;9;0;79;76;0;76
172500013;700;745;745;1;170;600;1;99;4;5;90;71;5;66
172500014;500;540;546;0;105;437;1;62;2;2;58;43;2;41
172500015;700;650;651;0;8;692;1;7;1;0;6;1;0;1
172500016;1000;926;926;4;167;894;1;105;7;1;97;62;4;58
172500017;600;632;632;2;146;515;2;83;5;5;73;63;2;61
172500018;600;652;652;0;49;551;1;48;7;0;41;1;0;1
172500019;600;635;635;2;149;494;1;105;5;6;94;44;1;43
172500020;500;565;566;1;146;410;1;89;9;2;78;57;2;55
172500021;700;709;710;0;161;589;2;109;12;1;96;52;2;50
172500022;400;349;349;2;70;351;1;48;2;1;45;22;2;20
172500023;600;582;586;2;95;531;1;68;3;4;61;27;2;25
172500024;600;636;636;1;121;524;1;75;5;0;70;46;0;46
172500025;600;637;637;3;140;514;1;85;8;4;73;55;1;54
172500026;800;804;804;0;86;750;1;49;4;1;44;37;0;37
172500027;900;912;913;2;146;786;1;113;10;4;99;33;0;33
172500028;700;655;655;1;121;583;1;116;14;0;102;5;0;5
172500029;300;248;248;0;86;213;1;86;4;1;81;0;0;0
172500030;400;433;433;0;146;327;1;72;5;1;66;74;4;70
172500031;1000;1000;1000;0;108;933;1;66;7;1;58;42;3;39
172500032;700;703;703;0;161;561;1;138;7;6;125;23;0;23
172500033;800;791;791;5;221;643;1;156;14;5;137;65;10;55
172600001;600;607;607;6;241;473;3;124;0;1;123;117;2;115
172600002;600;597;597;4;207;482;1;117;9;7;101;90;5;85
172600003;600;645;645;2;232;485;2;113;4;2;107;119;4;115
172600004;100;109;109;7;71;28;1;71;2;2;67;0;0;0
172600005;800;768;770;3;157;696;1;103;6;8;89;54;2;52
172600006;400;464;464;1;110;342;1;57;1;2;54;53;5;48
172600007;600;668;668;1;133;514;1;85;4;5;76;48;3;45
172600008;700;745;745;2;184;596;2;102;7;2;93;82;2;80
172600009;500;491;491;0;139;418;1;81;5;1;75;58;2;56
172600010;500;528;528;1;151;415;1;84;5;5;74;67;6;61
172600011;600;597;597;2;153;513;1;86;4;4;78;67;3;64
172600012;400;473;473;1;108;331;1;68;3;1;64;40;2;38
172600013;600;671;671;1;142;492;1;107;6;0;101;28;0;28
172600014;600;579;579;0;191;488;1;111;4;8;99;80;10;70
172600015;600;640;640;4;242;435;1;164;3;5;156;78;2;76
172600016;400;387;387;6;121;339;1;60;0;1;59;61;3;58
172600017;100;59;59;4;40;59;1;40;1;2;37;0;0;0
172600018;500;539;539;2;171;398;1;101;2;7;92;70;1;69
172600019;500;570;570;3;196;388;1;111;7;1;103;85;6;79
172600020;100;66;66;5;49;50;1;49;1;1;47;0;0;0
172600021;500;455;455;0;118;445;1;54;1;0;53;64;2;62
172600022;400;425;425;2;99;355;1;44;1;1;42;55;4;51
172600023;600;161;607;6;161;493;1;106;1;3;102;55;0;55
172600024;600;614;625;2;203;471;1;128;4;8;116;75;3;72
172600025;700;681;689;3;220;574;1;125;3;4;118;95;5;90
172600026;500;485;483;2;132;425;1;74;2;3;69;58;3;55
172600027;100;21;21;6;20;79;1;20;0;1;19;0;0;0
172600028;600;554;554;2;184;510;1;89;2;4;83;95;4;91
172600029;600;564;564;5;187;508;2;90;3;4;83;97;4;93
172600030;500;504;504;1;176;415;1;84;0;3;81;92;1;91
172600031;900;869;869;4;358;729;1;170;1;3;166;188;9;179
172600032;300;310;310;0;125;174;1;125;5;4;116;0;0;0
172600033;800;768;768;3;236;672;1;127;0;4;123;109;1;108
172600034;500;514;518;2;186;377;1;122;1;2;119;64;2;62
172600035;600;618;625;5;202;483;1;116;6;2;108;86;2;84
172600036;700;682;682;5;87;655;1;44;0;2;42;43;0;43
172600037;500;500;500;2;169;410;1;89;2;1;86;80;0;80
172600038;100;12;12;6;7;92;1;7;0;0;7;0;0;0
172600039;100;53;53;3;33;66;1;33;2;2;29;0;0;0
172600040;600;606;606;1;90;523;2;75;6;0;69;15;3;12
172600041;400;402;402;0;54;352;1;47;2;1;44;7;1;6
172600042;800;747;747;2;127;696;1;103;2;4;97;24;0;24
172600043;600;577;577;4;226;483;1;116;4;3;109;110;4;106
172600044;400;361;362;2;74;344;1;55;2;3;50;19;0;19
172600045;400;416;416;0;80;357;1;42;1;0;41;38;1;37
172600046;400;382;382;11;85;353;1;46;5;0;41;39;0;39
172600047;600;603;603;5;116;502;1;97;6;0;91;19;2;17
172600048;400;427;427;0;91;337;1;62;1;3;58;29;0;29
172600049;500;551;551;2;132;416;1;83;0;0;83;49;3;46
172600050;400;449;449;1;107;332;1;67;3;3;61;40;0;40
172600051;500;563;563;3;173;358;1;141;4;5;132;32;3;29
172600052;500;524;524;2;176;393;1;106;3;3;100;70;3;67
172600053;500;553;553;2;34;480;1;19;2;0;17;15;0;15
172600054;600;589;589;3;91;536;2;62;0;1;61;29;2;27
172600055;500;547;547;4;162;432;1;67;3;7;57;95;6;89
172600056;500;512;512;2;56;454;1;45;3;2;40;11;0;11
172600057;100;19;19;0;19;80;1;19;2;0;17;0;0;0
172800001;700;686;685;5;160;623;1;76;2;3;71;84;3;81
172800002;700;688;688;2;162;603;1;96;5;2;89;66;2;64
172800003;700;710;710;2;105;630;1;69;1;2;66;36;5;31
172800004;700;734;735;2;123;632;1;67;2;0;65;56;1;55
172800005;700;696;698;0;92;634;1;65;2;2;61;27;1;26
172800006;600;633;635;0;162;473;1;126;10;1;115;36;1;35
172800007;600;568;574;2;145;499;1;100;4;3;93;45;1;44
172800008;500;499;499;2;91;441;1;58;3;1;54;33;1;32
172800009;200;221;221;4;111;88;1;111;11;2;98;0;0;0
172800010;300;349;350;3;83;250;1;49;2;0;47;34;2;32
172800011;400;481;481;2;69;354;2;44;1;0;43;25;0;25
172800012;600;581;586;5;127;502;1;97;7;4;86;30;2;28
172800013;800;798;801;5;131;691;1;108;11;1;96;23;0;23
172800014;800;806;808;6;85;715;1;84;2;0;82;1;0;1
172800015;400;404;410;0;79;326;1;73;4;0;69;6;0;6
172800016;400;429;430;4;123;320;2;78;6;0;72;45;1;44
172800017;800;833;833;5;119;718;1;81;3;3;75;38;3;35
172800018;600;615;617;0;133;495;1;104;2;3;99;28;1;27
172800019;700;693;693;0;191;567;6;127;5;3;119;64;4;60
172800020;600;615;615;2;157;522;1;77;4;1;72;80;1;79
172800021;50;15;15;0;13;36;1;13;0;0;13;0;0;0
172800022;50;16;16;0;14;35;1;14;0;0;14;0;0;0
173300001;680;696;696;1;179;567;1;112;2;4;106;67;5;62
173300002;549;579;579;3;171;450;1;98;3;4;91;73;6;67
173300003;500;525;525;1;124;435;1;64;3;3;58;60;1;59
173300004;431;434;435;1;110;372;1;58;1;1;56;52;4;48
173300005;420;428;428;4;132;338;2;80;7;0;73;52;2;50
173300006;600;584;584;5;223;466;1;133;6;2;125;90;5;85
173300007;900;907;907;1;86;845;1;54;6;2;46;32;1;31
173300008;430;437;437;2;151;342;1;87;2;3;82;64;1;63
173300009;100;73;73;7;33;66;1;33;4;2;27;0;0;0
173300010;300;302;302;2;90;209;1;90;3;4;83;0;0;0
173300011;500;512;512;3;116;415;1;84;4;0;80;32;2;30
173300012;270;299;299;0;84;185;1;84;5;1;78;0;0;0
173300013;300;327;328;4;96;227;1;72;5;4;63;24;1;23
173300014;200;226;226;1;81;118;1;81;4;0;77;0;0;0
173300015;351;360;361;1;72;300;1;50;2;0;48;22;1;21
173300016;269;279;279;2;78;190;1;78;2;0;76;0;0;0
173300017;400;412;412;4;78;345;1;54;2;1;51;24;0;24
173300018;200;201;201;3;82;117;1;82;4;3;75;0;0;0
173300019;200;197;197;3;65;134;1;65;5;1;59;0;0;0
173700001;700;746;747;9;254;578;2;120;6;4;110;134;6;128
173700002;800;846;847;3;264;640;1;159;6;6;147;105;2;103
173700003;800;800;801;5;214;677;1;122;6;6;110;92;6;86
173700004;700;675;675;4;219;571;1;128;7;3;118;91;3;88
173700005;650;664;664;2;180;545;1;104;5;0;99;76;1;75
173700006;500;505;505;6;120;418;1;81;8;0;73;39;1;38
173700007;700;740;740;3;158;593;1;106;1;5;100;52;2;50
173700008;800;815;815;3;232;666;1;133;7;4;122;99;5;94
173700009;500;479;479;4;105;437;1;62;1;2;59;43;0;43
173700010;130;133;133;4;56;73;1;56;4;1;51;0;0;0
173700011;250;267;267;0;70;179;1;70;5;3;62;0;0;0
173700012;300;352;353;4;115;202;1;97;3;1;93;18;0;18
173700013;120;152;152;6;64;55;1;64;6;0;58;0;0;0
173700014;700;690;692;3;176;551;1;148;7;2;139;28;0;28
173700015;50;61;61;6;35;14;1;35;1;3;31;0;0;0
173700016;750;748;755;4;169;648;1;101;9;3;89;68;2;66
173700017;40;22;22;3;21;17;2;21;1;1;19;0;0;0
173700018;520;552;553;3;126;419;1;100;10;0;90;26;2;24
173700019;220;220;251;4;90;129;1;90;9;1;80;0;0;0
173700020;200;198;202;2;73;126;1;73;4;1;68;0;0;0
173700021;50;77;78;5;21;28;1;21;0;2;19;0;0;0
173700022;250;39;39;80;119;130;1;119;1;4;114;0;0;0
173700023;100;30;30;28;55;44;1;55;1;1;53;0;0;0
173700024;100;36;36;8;43;56;1;43;1;0;42;0;0;0
173900001;600;564;564;2;154;535;1;64;0;2;62;90;1;85
173900002;700;658;658;0;144;637;1;62;0;1;61;82;6;76
173900003;700;760;760;2;200;597;1;102;3;1;98;98;8;90
173900004;1000;978;978;3;27;974;1;25;3;0;22;2;0;2
173900005;800;815;815;1;198;646;1;153;5;4;144;45;2;43
173900006;600;577;578;0;135;526;1;73;2;2;69;62;3;59
173900007;500;536;536;4;128;410;1;89;0;8;81;39;4;35
173900008;600;599;600;1;129;518;1;81;2;5;74;48;3;45
173900009;900;907;910;2;174;750;1;149;11;0;138;25;0;25
173900010;700;757;757;1;60;657;1;42;0;2;40;18;4;14
174000001;500;435;437;1;159;395;1;104;5;5;94;55;3;52
174000002;600;597;597;1;175;480;1;119;1;3;115;56;2;54
174000003;600;593;593;1;146;501;2;97;3;2;92;49;2;47
174000004;700;716;717;1;169;578;1;121;8;1;112;48;4;44
174000005;700;755;755;3;189;567;1;132;3;2;127;55;3;52
174000006;1000;1013;1013;0;106;893;1;106;19;0;87;0;0;0
174100001;800;741;741;0;258;665;1;134;2;2;130;124;4;120
174100002;1000;1015;1016;0;185;856;1;143;13;1;129;42;1;41
174100003;900;943;944;0;219;756;1;143;10;0;133;76;3;73
174100004;700;654;654;1;222;580;2;118;1;1;116;104;2;102
174100005;700;703;703;2;218;564;1;135;7;4;124;83;6;77
174100006;700;659;659;5;208;575;1;124;7;3;114;84;4;80
174100007;600;631;631;0;233;476;1;123;4;2;117;110;1;109
174100008;700;741;741;0;298;533;1;166;5;3;158;132;10;122
174100009;600;618;618;0;222;475;1;124;4;1;119;98;3;95
174100010;600;498;498;1;107;542;1;57;5;0;52;50;2;48
174100011;600;623;623;3;205;474;1;125;6;3;116;80;2;78
174100012;600;591;592;4;200;481;1;118;4;4;110;82;8;74
174100013;600;592;592;1;206;476;1;123;5;3;115;83;3;80
174100014;600;666;666;0;216;485;1;114;9;2;103;102;2;100
174100015;700;692;697;3;101;622;1;77;6;1;70;24;0;24
174100016;600;567;567;2;104;539;1;60;6;1;53;44;0;44
174100017;800;791;791;0;200;666;1;133;2;2;129;67;3;64
174100018;500;546;546;0;123;402;1;97;20;1;76;26;0;26
174100019;800;812;812;2;123;705;1;94;7;1;86;29;1;28
174100020;600;592;592;0;160;459;1;140;6;5;129;20;0;20
174100021;700;688;688;3;166;586;1;113;10;0;103;53;5;48
174100022;500;547;548;2;188;360;1;139;12;6;121;49;3;46
174100023;500;514;514;0;154;377;1;122;8;2;112;32;1;31
174100024;1000;1026;1028;2;66;941;1;58;12;0;46;8;0;8
174100025;600;536;537;1;146;468;1;131;5;1;125;15;1;14
174100026;600;567;567;3;51;549;1;50;5;0;45;1;0;1
174200001;700;728;729;1;162;596;1;103;10;4;89;59;4;55
174200002;550;559;560;0;128;460;1;89;6;0;83;39;4;35
174200003;850;852;855;1;200;714;2;134;4;6;124;66;0;66
174200004;850;870;873;1;161;721;1;128;2;2;124;33;0;33
174200005;750;772;773;1;147;649;1;100;4;2;94;47;1;46
174200006;550;500;555;2;122;494;1;55;3;1;51;67;1;66
174200007;680;670;678;2;191;543;1;136;3;2;131;55;0;55
174200008;800;814;814;2;124;732;1;67;3;2;62;57;4;53
174200009;160;157;157;3;98;61;1;98;5;4;89;0;0;0
174200010;50;50;50;5;26;22;2;26;0;3;23;0;0;0
174200011;110;113;113;4;64;45;1;64;2;2;60;0;0;0
174200012;70;65;65;5;49;20;1;49;1;0;48;0;0;0
174200013;50;40;40;5;35;13;2;35;2;2;31;0;0;0
174200014;30;22;22;0;20;9;1;20;0;0;20;0;0;0
174300001;700;686;687;3;174;599;4;97;1;3;93;77;5;72
174300002;800;749;751;0;239;665;1;134;8;3;123;105;5;100
174300003;800;845;852;1;253;663;1;136;4;4;128;117;5;112
174300004;800;839;839;0;242;646;1;153;4;7;142;89;5;84
174300005;800;784;784;0;230;670;1;129;9;6;114;101;4;97
174300006;600;585;588;0;189;500;1;99;2;2;95;90;6;84
174300007;800;762;763;0;236;659;1;140;3;3;134;96;4;92
174300008;900;859;861;1;212;736;1;163;4;3;156;49;4;45
174300009;800;805;805;0;244;668;1;131;6;5;120;113;8;105
174300010;800;816;817;2;245;616;1;183;2;7;174;62;3;59
174300011;400;438;438;0;118;313;1;86;3;2;81;32;0;32
174300012;500;504;505;3;112;428;1;71;1;1;69;41;4;37
174300013;100;14;14;0;13;86;1;13;0;0;13;0;0;0
181100001;900;890;904;5;235;674;1;225;6;2;217;10;0;10
181100002;900;888;898;8;272;642;1;257;13;2;242;15;1;14
181100003;900;891;898;5;207;703;1;196;8;0;188;11;0;11
181100004;1100;771;1118;3;353;753;1;346;17;7;322;7;0;7
181100005;700;712;715;4;213;562;1;137;0;9;128;76;2;74
181100006;800;812;822;7;261;598;1;201;8;8;185;60;1;59
181100007;700;727;738;9;252;488;1;211;9;10;192;41;1;40
181100008;700;714;721;2;202;529;1;170;18;2;150;32;3;29
181100009;400;421;415;6;155;249;1;150;8;4;138;5;0;5
181100010;800;825;834;10;217;622;1;177;2;4;171;40;0;40
181100011;700;716;721;9;205;540;1;159;5;3;151;46;1;45
181100012;800;769;779;10;208;623;2;175;4;1;170;33;1;32
181100013;1000;918;930;6;333;673;2;325;8;4;313;8;0;8
181100014;500;538;538;6;219;283;1;216;11;4;201;3;0;3
181100015;100;76;76;3;77;22;1;77;4;0;73;0;0;0
181100016;100;50;50;3;51;48;1;51;1;0;50;0;0;0
181400001;700;674;676;5;183;522;1;177;11;1;165;6;1;5
181400002;400;361;362;7;159;240;1;159;7;5;147;0;0;0
181400003;1000;1082;1082;5;359;646;3;351;25;0;326;8;0;8
181400004;700;762;763;7;251;471;1;228;21;0;207;23;1;22
181400005;900;962;962;9;262;636;2;262;10;4;248;0;0;0
181400006;500;542;543;9;275;224;1;275;4;1;270;0;0;0
181400007;1000;1066;1068;4;328;746;2;252;14;1;237;76;2;74
181400008;1000;1000;1001;6;269;808;1;191;6;10;175;78;7;71
181400009;800;809;810;9;250;629;1;170;2;4;164;79;2;77
181400010;900;934;936;7;266;718;2;180;9;4;167;86;3;83
181400011;900;931;932;10;295;680;1;219;8;8;203;76;3;73
181400012;1000;999;1001;6;304;756;1;243;9;4;230;61;2;59
181400013;1000;1046;1048;7;321;778;2;220;9;10;201;101;4;97
181400014;600;529;635;11;175;471;4;125;4;1;120;50;4;46
181400015;650;714;717;6;220;491;1;158;7;3;148;62;1;61
181400016;800;748;752;7;261;581;2;217;19;3;195;44;4;40
181400017;1000;989;1008;5;391;608;1;391;25;6;360;0;0;0
181400018;600;656;656;10;199;400;1;199;4;5;190;0;0;0
181400019;850;805;807;6;268;581;1;268;15;1;252;0;0;0
181400020;950;936;939;7;365;584;1;365;7;6;352;0;0;0
181400021;100;47;47;6;36;63;1;36;7;1;28;0;0;0
181400022;400;336;339;7;143;256;1;143;1;3;139;0;0;0
181400023;1000;1072;1084;6;368;635;1;364;9;15;340;4;0;4
181400024;650;632;632;9;213;456;3;191;7;4;180;22;2;20
181400025;800;750;774;7;279;535;1;264;16;3;245;15;0;15
181400026;400;333;333;4;133;269;1;130;12;3;115;3;1;2
181400027;400;306;306;5;170;229;1;170;1;3;166;0;0;0
181400028;1000;941;967;6;347;663;1;336;10;1;325;11;0;11
181400029;1000;944;953;7;361;656;1;343;19;2;322;18;1;17
181400030;400;387;387;5;138;261;1;138;3;4;131;0;0;0
181400031;400;365;368;6;114;285;1;114;4;3;107;0;0;0
181400032;1000;855;857;2;197;820;2;178;7;3;168;19;1;18
181400033;550;524;524;12;209;346;1;203;8;2;193;6;0;6
181400034;500;423;425;11;178;353;1;146;4;3;139;32;0;32
181400035;1000;412;1111;6;412;587;1;412;16;1;395;0;0;0
181400036;350;309;309;7;157;192;1;157;11;2;144;0;0;0
181400037;50;13;13;4;17;32;1;17;0;0;17;0;0;0
181400038;50;44;44;5;44;6;0;44;0;0;44;0;0;0
181400039;50;38;38;4;40;10;0;40;0;0;40;0;0;0
181400040;50;42;42;1;42;8;0;42;1;0;41;0;0;0
181400041;100;22;22;33;40;59;1;40;0;0;40;0;0;0
181600001;800;821;853;8;372;462;1;337;18;4;315;35;0;35
181600002;800;798;819;7;283;536;1;263;14;8;241;20;3;17
181600003;700;802;815;6;221;477;2;221;14;4;203;0;0;0
181600004;600;665;683;7;188;427;1;172;12;4;156;16;1;15
181600005;400;360;378;6;165;232;3;165;4;4;157;0;0;0
181600006;300;361;372;3;145;161;1;138;15;1;122;7;0;7
181600007;400;466;466;3;183;218;1;181;12;5;164;2;0;2
181600008;500;571;590;5;229;270;1;229;7;4;218;0;0;0
181600009;200;243;243;5;109;90;1;109;10;4;95;0;0;0
181600010;700;733;738;6;175;557;1;142;5;4;133;33;1;32
181600011;800;879;890;7;244;614;1;185;6;6;173;59;2;57
181600012;900;904;904;3;173;781;1;118;6;3;109;55;3;52
181600013;900;933;941;3;176;777;1;122;3;7;112;54;2;52
181600014;800;855;864;0;213;653;1;146;3;4;139;67;2;65
181600015;700;706;713;4;196;548;1;151;6;3;142;45;1;44
181600016;800;773;781;4;231;631;1;168;10;1;157;63;1;62
181600017;700;728;737;2;192;563;2;135;11;4;120;57;2;55
181600018;800;948;958;6;258;554;1;245;14;8;223;13;3;10
181600019;300;339;339;6;112;197;1;102;5;2;95;10;1;9
181600020;800;877;877;11;381;448;1;351;12;4;335;30;2;28
181600021;630;630;630;8;188;441;1;188;10;2;176;0;0;0
181600022;500;509;510;7;119;380;1;119;4;0;115;0;0;0
181600023;1000;1078;1093;5;328;698;3;299;15;8;276;29;2;27
181600024;700;754;754;6;256;485;1;214;2;3;209;42;3;39
181600025;700;708;711;6;224;478;2;220;14;1;205;4;0;4
181600026;200;147;147;5;92;107;1;92;6;8;78;0;0;0
181600027;300;344;344;0;148;157;1;142;4;3;135;6;0;6
181600028;300;287;289;3;94;205;1;94;2;5;87;0;0;0
181600029;100;42;42;21;33;66;1;33;3;0;30;0;0;0
181600030;100;31;31;7;28;71;1;28;3;0;25;0;0;0
181600031;100;43;43;1;43;56;1;43;2;0;41;0;0;0
181600032;100;26;26;4;29;70;1;29;0;0;29;0;0;0
181600033;100;14;14;1;15;84;1;15;1;0;14;0;0;0
181600034;100;11;11;1;12;87;1;12;1;1;10;0;0;0
181600035;100;14;14;0;14;85;1;14;1;0;13;0;0;0
181600036;200;43;43;4;45;153;2;45;2;0;43;0;0;0
181600037;100;64;64;0;63;36;1;63;2;1;60;0;0;0
181600038;200;41;41;1;41;157;2;41;0;0;41;0;0;0
181600039;100;10;10;3;13;86;1;13;4;1;8;0;0;0
181700001;1000;949;972;4;299;715;2;283;13;7;263;16;0;16
181700002;1000;1452;1476;3;414;597;2;401;17;5;379;13;1;12
181700003;400;365;366;2;125;276;1;123;9;1;113;2;0;2
181700004;400;440;444;7;207;192;1;207;7;1;199;0;0;0
181700005;500;514;515;2;241;259;1;240;9;4;227;1;0;1
181700006;200;205;205;7;75;124;1;75;1;1;73;0;0;0
181700007;800;700;847;1;270;556;1;243;9;7;227;27;2;25
181700008;600;565;567;4;217;437;1;162;5;6;151;55;1;54
181700009;700;718;722;3;267;489;1;210;3;3;204;57;1;56
181700010;700;678;691;5;287;432;1;267;9;3;255;20;1;19
181700011;200;207;208;2;128;71;1;128;3;1;124;0;0;0
181700012;300;258;258;8;97;202;1;97;3;0;94;0;0;0
181700013;500;466;466;4;229;329;0;171;14;2;155;58;0;58
181700014;900;957;965;5;379;557;1;342;20;5;317;37;0;37
181700015;400;359;359;9;134;265;1;134;7;0;127;0;0;0
181700016;700;651;651;3;136;580;1;119;5;2;112;17;0;17
181700017;200;162;163;7;90;109;1;90;2;1;87;0;0;0
181700018;400;426;428;4;167;244;1;155;11;1;143;12;0;12
181700019;100;11;11;4;14;85;1;14;0;1;13;0;0;0
181700020;50;12;12;7;18;31;1;18;0;1;17;0;0;0
181700021;100;19;19;1;20;79;1;20;1;0;19;0;0;0
181700022;100;22;22;6;28;71;1;28;1;0;27;0;0;0
181700023;100;22;22;6;28;72;0;28;0;0;28;0;0;0
181700024;100;17;17;1;18;82;0;18;0;0;18;0;0;0
182600001;200;154;154;3;67;132;1;67;3;2;62;0;0;0
182600002;400;421;422;4;166;259;1;140;9;1;130;26;2;24
182600003;700;726;727;4;203;579;1;120;2;4;114;83;4;79
182600004;700;716;717;5;206;592;1;107;2;4;101;99;7;92
182600005;600;600;628;3;241;400;1;199;19;7;173;42;0;42
182600006;1000;1076;1077;9;246;761;1;238;13;2;223;8;1;7
182600007;900;900;990;6;286;623;1;276;13;1;262;10;1;9
182600008;1000;1025;1033;7;243;771;1;228;7;2;219;15;1;14
182600009;800;844;846;7;164;661;1;138;2;1;135;26;1;25
182600010;500;541;541;9;160;359;1;140;8;4;128;20;2;18
182600011;1000;1425;1425;5;227;799;2;199;7;1;191;28;0;28
182600012;200;259;259;8;83;116;1;83;3;2;78;0;0;0
182600013;600;658;659;6;194;429;1;170;10;10;150;24;0;24
182600014;100;93;93;8;69;30;1;69;1;2;66;0;0;0
182600015;200;175;175;5;89;110;1;89;2;4;83;0;0;0
182600016;300;259;259;2;121;178;1;121;5;10;106;0;0;0
182600017;100;116;116;5;51;44;5;51;4;3;44;0;0;0
182600018;400;417;417;5;113;297;1;102;4;1;97;11;2;9
182600019;1000;1039;1042;8;250;785;1;214;21;4;189;36;1;35
182600020;800;875;877;7;187;632;0;168;8;1;159;19;1;18
182600021;900;952;952;4;192;729;1;170;7;0;163;22;2;20
182600022;900;978;979;4;169;784;1;115;4;6;105;54;5;49
182600023;1000;1123;1124;7;132;920;1;79;2;4;73;53;1;52
182600024;400;394;394;5;160;247;1;152;12;0;140;8;0;8
182600025;200;218;218;4;114;84;2;114;0;10;104;0;0;0
182600026;100;47;47;8;34;65;1;34;1;2;31;0;0;0
182600027;700;790;790;4;404;294;2;404;38;4;362;0;0;0
182600028;800;838;840;2;233;566;1;233;10;2;221;0;0;0
182600029;900;901;901;2;356;544;1;355;33;1;321;1;0;1
182600030;900;785;854;9;229;773;1;126;1;5;120;103;4;99
182600031;900;837;920;9;239;779;1;120;1;4;115;119;3;116
182600032;1000;1079;1080;6;295;841;4;155;10;3;142;140;4;136
182600033;800;870;870;7;301;634;1;165;2;1;162;136;1;135
182600034;800;809;813;8;263;669;1;130;4;1;125;133;6;127
182600035;900;924;924;7;296;758;1;141;7;2;132;155;9;146
182600036;800;853;855;10;293;654;2;144;5;7;132;149;4;145
182600037;800;857;861;6;315;631;2;167;3;4;160;148;4;144
182600038;800;828;831;7;287;660;2;138;1;3;134;149;4;145
182600039;900;924;927;5;248;762;2;136;2;4;130;112;5;107
182600040;900;949;950;7;279;744;1;155;4;7;144;124;3;121
182600041;800;862;862;9;232;679;1;120;2;4;114;112;0;112
182600042;800;798;800;8;226;668;1;131;3;3;125;95;8;87
182600043;800;785;790;6;260;658;1;141;0;2;139;119;4;115
182600044;800;259;792;6;263;685;1;114;1;2;111;149;5;144
182600045;800;765;769;7;247;676;1;123;4;5;114;124;5;119
182600046;800;784;786;6;265;652;1;147;3;5;139;118;11;107
182600047;900;900;904;10;256;774;1;125;6;6;113;131;4;127
182600048;900;910;911;7;228;765;1;134;1;3;130;94;2;92
182600049;900;971;976;7;278;752;1;147;7;5;135;131;8;123
182600050;900;988;988;6;233;768;1;131;3;5;123;102;3;99
182600051;900;917;919;9;288;735;2;163;3;5;155;125;11;114
182600052;900;964;964;8;232;767;1;132;2;0;130;100;4;96
182600053;1000;1051;1051;9;87;940;1;59;5;1;53;27;2;25
182600054;900;973;973;7;161;813;1;86;5;0;81;75;5;70
182600055;900;895;897;9;204;725;1;174;4;5;165;30;6;24
182600056;1000;1015;1016;9;167;859;1;140;12;2;126;27;0;27
182600057;900;893;894;8;153;804;1;95;1;3;91;58;2;56
182600058;800;817;817;5;187;687;1;112;0;2;110;75;3;72
182600059;900;916;916;5;200;774;3;123;3;4;116;77;2;75
182600060;800;858;858;7;202;677;1;122;0;0;122;80;3;77
182600061;900;891;897;5;218;771;1;128;7;7;114;90;7;83
182600062;800;785;788;7;140;711;1;88;3;4;81;52;2;50
182600063;900;915;916;5;159;808;1;91;2;0;89;68;5;63
182600064;800;854;855;7;211;682;1;117;6;3;108;94;4;90
182600065;800;869;872;6;212;681;1;118;4;2;112;94;4;90
182600066;100;89;89;5;27;72;1;27;1;1;25;0;0;0
182600067;100;63;35;10;47;52;1;47;10;1;36;0;0;0
182600068;100;46;37;9;25;74;1;25;0;0;25;0;0;0
182600069;100;32;32;7;39;60;1;39;0;0;39;0;0;0
182600070;200;12;12;8;20;179;1;20;1;1;18;0;0;0
182600071;200;10;10;24;24;175;1;24;1;2;21;0;0;0
182900001;500;541;559;6;225;276;1;223;5;6;212;2;0;2
182900002;500;419;437;11;147;352;1;147;7;1;139;0;0;0
182900003;1000;975;999;8;337;662;1;337;12;1;324;0;0;0
182900004;500;512;531;7;144;359;1;140;4;1;135;4;0;4
182900005;300;353;358;3;143;156;2;142;3;1;138;1;0;1
182900006;300;272;272;3;174;125;1;174;3;1;170;0;0;0
182900007;800;941;959;5;292;512;1;287;20;1;266;5;1;4
182900008;500;429;440;9;144;385;1;114;3;0;111;30;0;30
182900009;500;416;416;6;119;381;0;119;2;0;117;0;0;0
182900010;600;486;696;6;248;366;9;225;8;3;214;23;0;23
182900011;500;381;395;10;146;365;1;134;6;0;128;12;0;12
182900012;100;53;53;7;36;63;1;36;2;0;34;0;0;0
182900013;500;388;403;4;139;361;1;138;2;0;136;1;0;1
182900014;500;374;405;6;188;326;1;173;7;2;164;15;1;14
182900015;1000;1182;1182;9;367;632;1;367;12;4;351;0;0;0
182900016;1000;886;913;4;312;686;2;312;5;0;307;0;0;0
182900017;50;23;23;0;21;28;1;21;0;0;21;0;0;0
182900018;50;33;33;0;33;16;1;33;0;0;33;0;0;0
182900019;50;43;43;0;43;7;0;43;0;0;43;0;0;0
182900020;30;17;17;0;16;13;1;16;0;0;16;0;0;0
182900021;20;10;10;0;9;10;1;9;0;0;9;0;0;0
182900022;40;29;29;0;26;13;1;26;0;0;26;0;0;0
182900023;20;14;14;0;14;5;1;14;0;0;14;0;0;0
182900024;40;29;29;0;29;10;1;29;0;0;29;0;0;0
182900025;100;88;88;0;87;12;1;87;3;0;84;0;0;0
183600001;1000;901;927;9;243;779;1;220;4;1;215;23;0;23
183600002;600;684;689;5;183;425;1;174;9;0;165;9;1;8
183600003;700;463;747;7;174;543;1;156;3;1;152;17;0;17
183600004;200;162;162;4;52;147;1;52;2;0;50;0;0;0
183600005;400;460;473;1;138;286;1;113;3;6;104;25;0;25
183600006;600;640;661;0;206;403;1;196;7;5;184;10;0;10
183600007;600;656;690;3;231;381;1;218;7;6;205;13;0;13
183600008;800;872;892;2;263;550;1;249;5;7;237;14;1;13
183600009;800;807;822;5;304;528;1;271;10;12;249;33;1;32
183600010;200;99;99;0;98;101;1;98;2;0;96;0;0;0
183600011;100;45;45;1;45;55;0;45;0;0;45;0;0;0
190300001;600;570;571;1;186;481;1;118;6;4;108;68;5;63
190300002;600;552;553;1;216;465;1;134;5;7;122;82;4;78
190300003;700;691;692;1;181;575;1;124;11;4;109;57;3;54
190300004;100;101;101;0;30;69;1;30;0;3;27;0;0;0
190300005;200;164;164;2;106;93;1;106;3;1;102;0;0;0
190300006;700;686;686;3;134;567;1;132;9;2;121;2;0;2
190300007;500;451;451;4;113;387;0;113;7;0;106;0;0;0
190300008;400;357;357;4;145;286;1;113;12;5;96;32;0;32
190300009;700;704;707;4;170;537;1;162;8;3;151;8;1;7
190300010;500;464;466;5;198;311;1;188;21;0;167;10;0;10
190400001;300;386;386;1;107;226;1;73;3;0;70;34;1;33
190400002;600;627;627;1;162;527;3;70;2;0;68;92;4;88
190400003;600;557;574;6;135;508;1;91;3;2;86;44;0;44
190400004;800;757;758;5;227;681;1;118;3;2;113;109;3;106
190400005;800;794;803;7;249;675;1;124;6;1;117;125;3;122
190400006;900;964;968;4;95;819;1;80;7;0;73;15;0;15
190400007;900;869;882;6;233;758;5;137;5;4;128;96;2;94
190400008;600;616;617;4;180;510;2;88;5;1;82;92;0;92
190400009;500;494;494;5;128;424;1;75;2;0;73;53;4;49
190400010;600;588;594;6;161;519;1;80;2;1;77;81;3;78
190400011;500;577;577;3;124;435;1;64;2;0;62;60;2;58
190400012;200;11;11;40;40;159;1;40;1;2;37;0;0;0
190400013;200;100;4;11;64;135;1;64;17;0;47;0;0;0
190400014;200;229;229;1;89;110;1;89;9;1;79;0;0;0
190400015;200;175;175;5;72;127;1;72;2;1;69;0;0;0
190400016;100;33;33;5;28;71;1;28;1;2;25;0;0;0
190400017;700;686;686;1;218;484;1;215;8;0;207;3;0;3
190400018;500;542;542;2;183;337;1;162;8;3;151;21;0;21
190400019;300;282;282;4;99;200;1;99;4;1;94;0;0;0
190400020;400;415;416;2;145;297;1;102;5;2;95;43;0;43
190400021;200;174;174;4;51;148;1;51;3;1;47;0;0;0
190400022;300;299;299;2;86;213;1;86;2;2;82;0;0;0
190400023;300;292;292;3;96;203;1;96;4;5;87;0;0;0
190400024;500;462;462;3;151;381;1;118;13;1;104;33;0;33
190400025;200;185;192;6;52;147;1;52;5;4;43;0;0;0
190400026;100;20;20;0;19;80;1;19;1;0;18;0;0;0
190500001;600;510;583;3;141;496;1;103;6;0;97;38;1;37
190500002;700;663;664;3;212;541;1;158;13;1;144;54;2;52
190500003;800;732;762;2;176;666;1;133;19;1;113;43;1;42
190500004;700;626;626;7;159;578;1;121;7;2;112;38;1;37
190500005;800;735;819;3;199;605;1;194;7;2;185;5;0;5
190500006;1000;940;945;6;269;795;1;204;3;0;201;63;1;62
190500007;500;541;544;7;212;377;1;122;7;0;115;90;0;90
190500008;500;484;488;2;166;365;1;134;9;1;124;32;0;32
190500009;500;471;536;2;177;394;1;105;2;2;101;72;1;71
190500010;700;715;735;3;255;452;1;247;6;3;238;8;0;8
190500011;500;497;499;5;178;344;1;155;8;2;145;23;0;23
190500012;600;567;576;1;153;471;1;128;5;0;123;25;1;24
190500013;400;386;398;4;172;243;1;156;8;1;147;16;0;16
190500014;300;277;277;2;112;186;2;112;5;2;105;0;0;0
190500015;200;180;180;1;60;139;1;60;0;4;56;0;0;0
190500016;600;576;576;2;250;369;1;230;16;2;212;20;0;20
190500017;300;326;317;4;125;219;1;80;1;1;78;45;2;43
190500018;600;629;629;4;205;426;1;173;11;3;159;32;1;31
190500019;600;624;624;3;152;474;1;125;1;1;123;27;0;27
190500020;700;670;670;5;234;489;1;210;6;5;199;24;1;23
190500021;700;658;658;6;240;501;1;198;1;1;196;42;1;41
190500022;100;64;64;0;64;35;1;64;0;0;64;0;0;0
190500023;100;64;64;1;65;35;0;65;0;0;65;0;0;0
190800001;600;591;592;5;155;495;1;104;4;3;97;51;0;51
190800002;500;507;510;5;148;397;1;102;0;2;100;46;2;44
190800003;800;750;750;0;196;694;2;104;5;2;97;92;2;90
190800004;800;789;791;4;232;608;1;191;10;3;178;41;3;38
190800005;900;852;852;3;122;794;2;104;12;0;92;18;0;18
190800006;900;942;942;6;145;771;1;128;14;1;113;17;0;17
190800007;500;518;520;4;150;380;1;119;6;2;111;31;1;30
190800008;700;687;687;5;170;553;1;146;8;2;136;24;2;22
190800009;300;290;292;4;135;164;1;135;10;2;123;0;0;0
190800010;500;500;502;5;124;382;2;116;6;4;106;8;1;7
190800011;100;139;139;2;55;44;1;55;2;0;53;0;0;0
190800012;200;173;174;7;70;129;1;70;5;0;65;0;0;0
190800013;300;338;338;2;123;180;1;119;4;1;114;4;0;4
190800014;300;352;352;3;89;229;1;70;3;0;67;19;0;19
190800015;100;58;58;9;48;51;1;48;1;3;44;0;0;0
191300001;100;93;93;5;64;34;2;64;1;4;59;0;0;0
191300002;600;614;614;5;187;449;1;150;13;1;136;37;1;36
191300003;200;221;222;6;123;76;1;123;4;10;109;0;0;0
191300004;100;138;138;6;81;18;1;81;4;1;76;0;0;0
191300005;100;97;97;3;70;29;1;70;0;2;68;0;0;0
191300006;600;596;601;3;200;486;1;113;5;1;107;87;5;82
191300007;400;443;443;4;137;310;1;89;6;3;80;48;1;47
191300008;400;458;458;4;192;255;1;144;5;5;134;48;2;46
191300009;700;710;710;4;173;547;1;152;6;2;144;21;1;20
191300010;500;471;471;3;134;395;1;104;7;0;97;30;0;30
191300011;500;459;460;3;157;396;1;103;4;2;97;54;2;52
191300012;400;348;348;2;158;305;2;93;3;4;86;65;6;59
191300013;800;841;842;6;244;579;1;220;10;6;204;24;1;23
191300014;300;335;335;6;145;201;1;98;4;2;92;47;2;45
191300015;500;501;502;2;180;398;1;101;11;3;87;79;3;76
191300016;100;106;103;3;79;20;1;79;0;5;74;0;0;0
191300017;600;646;647;2;125;486;1;113;7;1;105;12;0;12
191300018;100;63;63;1;40;59;1;40;0;1;39;0;0;0
192700001;500;849;849;8;351;376;2;122;3;2;117;229;9;220
192700002;500;936;928;7;371;354;1;145;6;5;134;226;10;216
192700003;500;739;740;12;327;326;3;171;4;1;166;156;4;152
192700004;500;845;845;8;301;363;1;136;9;1;126;165;2;163
192700005;500;903;901;12;312;370;1;129;4;5;120;183;5;178
192700006;500;899;900;9;305;375;1;124;3;6;115;181;5;176
192700007;500;712;711;10;227;380;2;118;0;10;108;114;10;104
192700008;500;768;770;8;206;403;1;96;2;1;93;110;4;106
192700009;500;603;607;0;188;415;1;84;1;3;80;104;4;100
192700010;500;730;732;6;245;362;1;137;3;3;131;108;2;106
192700011;500;730;728;8;239;391;1;108;5;2;101;131;4;127
192700012;500;779;783;10;300;328;1;171;1;6;164;127;3;124
192700013;500;878;883;5;317;298;2;200;9;8;183;117;3;114
192700014;500;769;767;6;311;351;1;148;2;6;140;163;5;158
192700015;500;798;804;10;321;384;1;115;1;2;112;206;6;200
192700016;500;705;707;6;240;394;1;105;3;0;102;135;6;129
192700017;500;771;775;7;281;377;1;122;3;2;117;159;3;156
192700018;500;681;684;8;237;375;2;123;3;6;114;114;1;113
192700019;500;856;857;7;315;366;1;133;3;2;128;182;9;173
192700020;500;857;856;10;281;376;1;123;2;5;116;158;5;153
192700021;500;629;635;4;238;416;1;83;3;2;78;155;8;147
192700022;500;743;743;9;263;393;2;105;3;1;101;158;6;152
192700023;500;605;605;9;223;410;1;89;0;4;85;134;8;126
192700024;500;786;785;12;291;382;1;117;1;5;111;174;7;167
192700025;500;742;744;6;271;386;3;111;1;5;105;160;3;157
192700026;500;803;806;10;313;340;1;159;3;5;151;154;9;145
192700027;500;746;746;2;248;395;1;104;6;3;95;144;7;137
192700028;500;707;705;8;231;419;1;80;1;0;79;151;7;144
192700029;500;741;743;10;231;399;1;100;8;1;91;131;6;125
192700030;200;168;169;4;43;156;1;43;2;1;40;0;0;0
192700031;500;724;725;10;210;424;1;75;2;0;73;135;5;130
192700032;500;795;814;6;290;359;2;139;2;1;136;151;4;147
192700033;500;709;709;6;214;340;1;159;6;4;149;55;4;51
192700034;500;579;584;8;190;430;1;69;1;1;67;121;4;117
192700035;500;743;746;8;250;360;1;139;3;1;135;111;2;109
192700036;500;836;831;9;278;367;1;132;3;4;125;146;3;143
192700037;500;798;802;9;220;401;1;98;5;3;90;122;1;121
192700038;500;664;665;6;169;405;1;94;0;1;93;75;1;74
192700039;500;593;595;10;179;433;1;66;1;2;63;113;1;112
192700040;500;643;647;5;198;346;1;153;2;3;148;45;2;43
192700041;500;729;730;7;261;385;1;114;7;3;104;147;13;134
192700042;500;671;675;6;249;400;1;99;2;4;93;150;0;150
192700043;500;766;767;3;242;396;1;103;3;2;98;138;7;131
192700044;500;803;804;7;255;395;1;104;9;3;92;151;5;146
192700045;500;706;707;6;208;403;1;96;1;1;94;112;2;110
192700046;500;750;788;8;164;418;1;81;4;1;76;86;2;84
192700047;500;810;812;7;269;369;1;130;5;2;123;141;6;135
192700048;500;804;804;2;235;385;1;114;4;6;104;121;3;118
192700049;500;774;775;7;226;371;3;126;4;4;118;100;4;96
192700050;500;797;797;7;159;434;1;65;5;1;59;94;7;87
192700051;500;824;825;6;129;414;1;85;6;1;78;44;0;44
192700052;500;909;897;7;57;463;1;36;3;0;33;21;1;20
192700053;500;897;901;8;93;437;1;62;0;1;61;31;2;29
192700054;500;811;814;3;144;418;1;81;2;2;77;63;1;62
192700055;500;735;736;6;134;433;1;66;3;1;62;68;0;68
192700056;500;697;698;4;178;439;1;60;0;1;59;118;4;114
192700057;500;763;763;6;199;414;1;85;3;2;80;114;3;111
192700058;500;783;787;6;177;418;1;81;1;4;76;96;3;93
192700059;500;641;659;5;133;427;1;72;1;0;71;61;6;55
192700060;500;773;775;7;252;387;1;112;2;1;109;140;5;135
192700061;500;804;806;5;184;408;1;91;3;3;85;93;4;89
192700062;500;834;836;5;219;383;1;116;5;3;108;103;6;97
192700063;500;763;766;4;218;368;1;131;6;3;122;87;5;82
192700064;500;795;795;6;232;395;2;103;6;3;94;129;6;123
192700065;500;751;754;2;163;435;1;64;3;4;57;99;3;96
192700066;500;769;771;4;189;406;1;93;1;6;86;96;5;91
192700067;500;710;713;6;172;376;1;123;2;2;119;49;3;46
192700068;500;782;785;8;183;321;1;178;3;8;167;5;0;5
192700069;500;680;684;6;170;402;1;97;8;3;86;73;5;68
192700070;500;815;819;9;215;397;1;102;1;0;101;113;9;104
192700071;500;719;718;5;216;364;1;135;7;6;122;81;8;73
192700072;500;757;757;6;144;430;1;69;0;2;67;75;2;73
192700073;500;545;546;5;179;398;1;101;1;4;96;78;2;76
192700074;500;765;768;8;184;359;1;140;2;10;128;44;2;42
192700075;500;773;775;5;156;422;1;77;2;6;69;79;4;75
192700076;500;794;809;4;127;433;1;66;1;3;62;61;4;57
192700077;500;741;741;10;174;413;1;86;3;0;83;88;2;86
192700078;500;824;824;6;215;395;2;103;0;3;100;112;5;107
192700079;500;645;645;8;157;409;1;90;3;2;85;67;4;63
192700080;500;769;770;5;162;417;2;81;1;6;74;81;0;81
192700081;500;728;730;7;211;385;1;114;3;3;108;97;5;92
192700082;500;798;800;10;204;400;1;99;5;4;90;105;1;104
192700083;500;825;827;5;180;426;1;73;1;5;67;107;3;104
192700084;500;779;782;1;175;399;1;100;7;5;88;75;5;70
192700085;500;802;803;4;183;413;1;86;2;2;82;97;3;94
192700086;500;825;829;2;182;423;1;76;2;4;70;106;4;102
192700087;500;725;726;3;156;408;1;91;1;2;88;65;1;64
192700088;500;610;611;4;124;438;1;61;5;2;54;63;2;61
192700089;500;640;642;2;150;414;1;85;5;2;78;65;1;64
192700090;500;754;770;6;160;428;1;71;2;1;68;89;3;86
192700091;500;764;766;6;164;407;1;92;2;4;86;72;2;70
192700092;500;665;700;5;133;428;1;71;5;3;63;62;2;60
192700093;500;738;739;6;99;447;1;52;0;2;50;47;1;46
192700094;500;643;646;6;116;436;1;63;2;3;58;53;3;50
192700095;500;590;590;6;88;458;1;41;1;1;39;47;2;45
192700096;500;739;740;7;96;458;1;41;2;0;39;55;5;50
192700097;500;751;751;5;185;373;1;126;3;6;117;59;4;55
192700098;500;782;801;8;135;430;1;69;2;0;67;66;2;64
192700099;500;751;750;9;174;428;2;70;4;9;57;104;6;98
192700100;500;785;780;10;184;382;1;117;6;0;111;67;2;65
192700101;500;607;603;10;163;422;1;77;3;2;72;86;3;83
192700102;500;716;716;5;208;390;2;108;5;1;102;100;3;97
192700103;500;762;763;7;213;399;1;100;5;3;92;113;8;105
192700104;500;765;765;6;173;408;1;91;3;2;86;82;5;77
192700105;500;673;673;3;192;407;1;92;2;4;86;100;4;96
192700106;500;669;670;7;196;406;1;93;2;6;85;103;4;99
192700107;500;735;736;5;181;408;2;90;0;1;89;91;1;90
192700108;500;854;855;7;251;373;1;126;1;6;119;125;2;123
192700109;500;670;670;10;182;381;1;118;4;5;109;64;0;64
192700110;500;695;696;7;207;403;1;96;2;1;93;111;3;108
192700111;500;712;715;7;171;421;1;78;8;1;69;93;1;92
192700112;500;757;761;9;181;407;1;92;4;1;87;89;4;85
192700113;500;768;769;8;171;407;1;92;2;4;86;79;2;77
192700114;500;753;756;6;225;380;1;119;4;1;114;110;4;106
192700115;500;627;628;1;176;411;2;87;3;2;82;89;2;87
192700116;500;649;653;4;215;406;1;93;4;2;87;122;6;116
192700117;500;650;654;7;196;408;1;91;2;6;83;105;6;99
192700118;500;589;589;7;201;404;2;94;4;3;87;107;12;95
192700119;500;561;561;11;169;442;1;57;2;2;53;112;0;112
192700120;500;647;648;6;237;388;1;111;0;3;108;126;5;121
192700121;500;742;745;6;235;387;1;112;3;5;104;123;6;117
192700122;500;529;529;5;173;426;1;73;3;1;69;100;7;93
192700123;500;580;580;4;180;416;1;83;2;2;79;97;10;87
192700124;500;677;679;5;193;413;1;86;7;1;78;107;9;98
192700125;500;753;755;8;156;432;2;66;2;3;61;90;4;86
192700126;500;592;594;8;154;419;1;80;2;1;77;74;2;72
192700127;500;750;753;6;209;419;1;80;1;0;79;129;4;125
192700128;500;474;475;5;129;457;1;42;2;0;40;87;7;80
192700129;500;650;653;7;213;414;1;85;0;2;83;128;2;126
192700130;500;539;540;8;155;440;2;58;0;2;56;97;5;92
192700131;500;653;653;9;181;425;1;74;6;2;66;107;4;103
192700132;500;539;541;6;131;438;1;61;0;2;59;70;2;68
192700133;500;557;564;5;141;450;1;49;0;1;48;92;0;92
192700134;500;507;507;5;135;421;1;78;4;4;70;57;3;54
192700135;500;710;714;0;182;412;1;87;4;7;76;95;6;89
192700136;500;671;689;7;167;410;1;89;4;7;78;78;4;74
192700137;500;705;711;6;186;413;1;86;3;6;77;100;7;93
192700138;500;667;668;6;161;408;1;91;7;2;82;70;3;67
192700139;500;654;655;9;144;428;1;71;3;3;65;73;5;68
192700140;500;701;706;7;144;423;2;75;1;2;72;69;2;67
192700141;500;688;689;10;237;395;2;103;7;0;96;134;6;128
192700142;500;785;785;7;277;373;2;125;4;4;117;152;6;146
192700143;500;706;714;12;239;381;1;118;10;3;105;121;7;114
192700144;500;725;727;8;232;389;2;109;0;4;105;123;2;121
192700145;500;594;594;10;182;423;3;74;6;3;65;108;5;103
192700146;500;712;714;8;246;372;1;127;4;1;122;119;5;114
192700147;500;674;676;5;226;405;1;94;5;1;88;132;2;130
192700148;500;774;776;5;267;380;1;119;4;1;114;148;7;141
192700149;500;607;605;9;197;399;1;100;3;5;92;97;4;93
192700150;500;650;653;8;231;398;1;101;1;4;96;130;6;124
192700151;500;638;639;5;245;402;1;97;1;0;96;148;7;141
192700152;500;621;623;6;177;401;1;98;5;3;90;79;2;77
192700153;500;732;732;7;276;364;1;135;1;2;132;141;3;138
192700154;500;517;519;7;192;410;1;89;1;6;82;103;5;98
192700155;500;705;706;9;260;362;1;137;1;2;134;123;3;120
192700156;500;710;712;2;218;411;1;88;5;1;82;130;8;122
192700157;500;763;768;4;268;393;1;106;0;3;103;162;11;151
192700158;500;572;575;10;183;416;1;83;2;6;75;100;9;91
192700159;500;376;377;10;130;452;1;47;0;2;45;83;1;82
192700160;500;676;676;9;212;396;1;103;5;4;94;109;4;105
192700161;500;639;641;5;198;394;1;105;1;1;103;93;4;89
192700162;500;684;686;4;218;408;1;91;4;5;82;127;6;121
192700163;500;691;695;5;206;410;1;89;7;2;80;117;3;114
192700164;500;685;689;9;207;402;2;96;4;6;86;111;7;104
192700165;500;503;517;8;163;425;1;74;3;3;68;89;4;85
192700166;500;691;693;8;259;402;1;97;0;1;96;162;8;154
192700167;500;648;673;0;226;395;1;104;2;5;97;122;1;121
192700168;500;713;716;9;215;393;1;106;3;4;99;109;2;107
192700169;500;543;541;7;167;425;1;74;3;2;69;93;3;90
192700170;500;629;629;5;180;418;1;81;4;1;76;99;4;95
192700171;500;612;628;6;97;435;1;64;5;3;56;33;1;32
192700172;500;537;538;5;79;459;1;40;3;1;36;39;5;34
192700173;500;356;354;6;41;478;1;21;0;0;21;20;2;18
192700174;500;752;701;4;120;446;1;53;2;1;50;67;2;65
192700175;500;574;575;3;137;440;1;59;2;1;56;78;2;76
192700176;500;651;653;4;179;420;0;80;3;1;76;99;5;94
192700177;500;537;538;5;105;448;1;51;1;2;48;54;1;53
192700178;500;603;607;4;174;413;1;86;5;1;80;88;8;80
192700179;500;595;615;4;153;413;1;86;3;1;82;67;1;66
192700180;200;121;121;6;49;150;1;49;6;0;43;0;0;0
192700181;300;288;283;7;71;223;6;71;7;1;63;0;0;0
192700182;500;622;623;6;159;425;1;74;2;5;67;85;2;83
192700183;500;481;481;2;156;408;1;91;1;3;87;65;2;63
192700184;500;428;428;4;96;440;1;59;5;0;54;37;4;33
192700185;500;638;636;6;98;421;1;78;2;1;75;20;1;19
192700186;200;190;190;6;110;89;1;110;3;2;105;0;0;0
192700187;500;894;895;2;224;323;1;176;7;5;164;48;1;47
192700188;500;766;767;2;224;352;1;147;3;6;138;77;1;76
192700189;500;611;611;2;142;410;1;89;2;2;85;53;1;52
192700190;500;791;791;2;178;386;1;113;4;3;106;65;0;65
192700191;500;662;663;5;194;377;1;122;3;1;118;72;2;70
192700192;500;495;495;2;131;412;1;87;2;2;83;44;2;42
192700193;500;522;523;7;133;420;1;79;3;2;74;54;1;53
192700194;500;574;578;6;175;387;2;111;9;1;101;64;6;58
192700195;500;550;550;3;110;430;1;69;1;3;65;41;0;41
192700196;500;441;442;5;101;438;1;61;3;2;56;40;2;38
192700197;500;478;481;4;93;432;1;67;4;3;60;26;0;26
192700198;500;517;518;3;152;405;1;94;10;2;82;58;3;55
192700199;500;525;526;4;155;353;2;145;2;2;141;10;0;10
192700200;500;451;455;4;96;420;0;80;4;0;76;16;0;16
192700201;500;617;630;4;152;384;1;115;2;0;113;37;2;35
192700202;500;799;799;4;144;393;1;106;2;1;103;38;3;35
192700203;500;873;874;3;100;427;2;71;4;2;65;29;2;27
192700204;500;600;600;4;93;416;1;83;9;0;74;10;0;10
192700205;500;583;583;2;173;416;1;83;3;3;77;90;8;82
192700206;500;513;513;1;144;421;1;78;6;3;69;66;1;65
192700207;300;337;337;2;98;211;1;88;1;0;87;10;0;10
192700208;100;45;51;11;24;75;1;24;1;0;23;0;0;0
192700209;100;96;45;10;40;59;1;40;10;2;28;0;0;0
192700210;200;192;92;7;106;93;1;106;26;2;78;0;0;0
192700211;100;32;32;5;36;64;0;36;0;0;36;0;0;0
192700212;100;37;37;5;41;58;1;41;1;1;39;0;0;0
192700213;100;16;16;7;23;77;0;23;0;1;22;0;0;0
192700214;200;79;79;22;78;121;1;78;13;6;59;0;0;0
192700215;300;98;98;53;125;174;1;125;6;5;114;0;0;0
192700216;300;23;23;64;82;217;1;82;3;4;75;0;0;0
192700217;100;29;29;16;30;69;1;30;1;1;28;0;0;0
193300001;800;716;717;4;196;663;1;136;8;4;124;60;7;53
193300002;1000;997;998;3;218;832;1;167;8;1;158;51;2;49
193300003;700;718;718;5;142;574;1;125;7;4;114;17;0;17
193300004;700;696;696;0;98;600;2;98;10;0;88;0;0;0
193300005;700;670;672;5;213;550;1;149;3;3;143;64;3;61
193300006;800;797;799;1;238;570;1;229;9;5;215;9;1;8
193300007;500;499;499;6;191;315;1;184;26;1;157;7;0;7
193300008;700;687;687;1;217;490;1;209;10;0;199;8;0;8
193300009;700;715;718;5;141;585;1;114;3;2;109;27;0;27
193300010;800;873;874;5;120;681;1;118;4;3;111;2;0;2
193300011;800;756;822;3;255;550;1;249;14;5;230;6;0;6
193300012;400;341;343;6;143;298;2;100;4;4;92;43;0;43
193300013;300;262;262;4;129;170;1;129;3;2;124;0;0;0
193300014;300;371;372;0;128;206;1;93;4;7;82;35;2;33
193300015;400;424;424;5;140;291;1;108;2;8;98;32;0;32
193300016;300;99;332;4;99;231;1;68;8;3;57;31;1;30
193300017;100;51;45;6;39;60;1;39;1;0;38;0;0;0
193700001;500;561;563;2;230;315;2;183;4;3;176;47;2;45
193700002;500;737;740;2;187;349;1;150;6;1;143;37;2;35
193700003;300;318;318;1;94;223;1;76;2;0;74;18;1;17
193700004;500;619;626;0;282;259;1;240;19;4;217;42;1;41
193700005;500;719;722;2;324;211;1;288;19;7;262;36;3;33
193700006;500;269;274;2;120;379;1;120;10;4;106;0;0;0
193700007;500;138;139;1;81;418;1;81;6;4;71;0;0;0
193700008;100;67;67;5;32;67;1;32;1;1;30;0;0;0
193700009;500;577;582;3;201;316;1;183;9;5;169;18;0;18
193700010;500;215;215;4;80;418;2;80;2;3;75;0;0;0
193700011;100;16;16;0;15;85;0;15;3;0;12;0;0;0
200100201;450;498;522;1;239;270;1;179;4;7;168;60;1;59
200100202;450;448;485;0;202;304;1;145;1;3;141;57;2;55
200100203;250;253;272;1;114;135;1;114;5;4;105;0;0;0
200100204;350;349;349;5;132;237;1;112;11;0;101;20;0;20
200100205;400;380;380;5;115;284;1;115;9;3;103;0;0;0
200100206;50;40;41;2;26;23;1;26;2;0;24;0;0;0
200100207;50;31;32;7;29;20;1;29;3;1;25;0;0;0
200100208;50;42;42;8;32;17;1;32;1;1;30;0;0;0
200100209;350;351;353;5;122;242;1;107;9;0;98;15;1;14
200100210;50;39;39;1;40;9;1;40;1;1;38;0;0;0
200100211;50;41;41;3;43;6;1;43;4;1;38;0;0;0
200700301;700;740;740;4;244;500;1;199;10;1;188;45;0;45
200700302;700;793;803;1;299;438;1;261;5;2;254;38;2;36
200700303;200;154;163;7;87;112;1;87;0;1;86;0;0;0
200700304;600;587;605;5;226;385;1;214;6;2;206;12;0;12
200700305;400;364;368;8;186;217;1;182;3;1;178;4;0;4
200700306;500;557;557;8;242;259;2;239;18;6;215;3;0;3
200700307;300;304;316;5;89;219;1;80;7;0;73;9;0;9
200700308;300;349;362;4;163;159;1;140;4;3;133;23;1;22
200700309;300;336;336;4;115;213;1;86;4;4;78;29;1;28
200700310;400;404;417;4;155;269;1;130;5;1;124;25;1;24
200700311;700;632;674;8;312;388;1;311;12;4;295;1;0;1
200700312;400;426;440;6;176;279;1;120;1;2;117;56;1;55
200700313;600;575;575;10;276;358;1;241;16;3;222;35;1;34
200700314;400;334;407;5;171;235;1;164;4;5;155;7;1;6
200700315;200;191;195;4;84;115;1;84;2;2;80;0;0;0
200700316;600;553;573;5;236;377;2;221;10;3;208;15;0;15
200700317;200;164;159;5;68;131;1;68;4;3;61;0;0;0
200700318;600;560;560;3;271;330;1;269;4;2;263;2;0;2
200700319;100;61;61;6;31;68;1;31;1;0;30;0;0;0
200700320;300;353;367;5;184;116;1;183;6;3;174;1;0;1
200700321;100;125;125;4;56;43;1;56;2;0;54;0;0;0
200700322;300;303;320;4;150;159;1;140;6;1;133;10;0;10
200700323;800;830;830;5;201;621;1;178;8;2;168;23;0;23
200700324;700;767;781;5;293;439;2;259;14;12;233;34;1;33
200700325;300;345;345;2;152;156;1;143;3;0;140;9;0;9
200700326;150;100;100;1;99;50;1;99;0;0;99;0;0;0
200700327;150;127;127;7;123;27;0;123;1;0;122;0;0;0
201000401;700;695;697;1;222;545;4;151;4;5;142;71;2;69
201000402;400;383;383;3;138;297;1;102;0;1;101;36;1;36
201000403;1000;995;996;1;269;796;2;202;5;6;191;67;1;66
201000404;700;733;733;6;263;525;1;174;8;5;161;89;6;83
201000405;700;638;639;2;224;527;2;171;6;7;158;53;2;51
201000406;1200;1156;1157;0;303;924;1;275;13;4;258;28;0;28
201000407;800;742;745;0;249;614;1;185;9;8;168;64;1;63
201000408;1000;1007;1008;4;325;691;1;308;18;1;289;17;2;15
201000409;1000;913;1082;3;332;695;3;302;4;0;298;30;0;30
201000410;900;826;917;4;305;594;1;305;7;2;296;0;0;0
201000411;500;529;529;5;170;343;1;156;8;4;144;14;0;14
201000412;100;18;18;38;51;47;2;51;2;1;48;0;0;0
201000413;900;893;893;5;334;566;1;333;10;4;319;1;0;1
201000414;700;709;711;6;239;454;8;238;7;1;230;1;0;1
201000415;400;376;376;5;157;263;1;136;6;2;128;21;3;18
201000416;300;265;265;3;123;176;1;123;3;1;119;0;0;0
201000417;700;656;656;6;193;509;1;190;12;2;176;3;1;2
201000418;800;733;735;6;263;560;1;239;2;1;236;24;1;23
201000419;700;712;712;2;203;507;1;192;6;3;183;11;0;11
201000420;100;40;40;7;34;65;1;34;3;0;31;0;0;0
201000421;500;513;514;5;198;313;1;186;9;0;177;12;2;10
201000422;300;303;303;4;116;180;4;116;3;1;112;0;0;0
201000423;1200;1190;1194;7;463;753;2;445;4;3;438;18;1;17
201000424;800;587;750;3;194;631;1;168;6;3;159;26;2;24
201000425;800;820;823;6;284;517;1;282;25;4;253;2;0;2
201000426;200;186;186;4;74;126;0;74;5;0;69;0;0;0
201000427;800;653;741;9;298;532;1;267;4;2;261;31;0;31
201000428;700;649;649;8;268;450;1;249;7;0;242;19;0;19
201000429;1000;971;972;4;261;737;2;261;15;1;245;0;0;0
201000430;700;715;716;3;212;484;8;208;7;3;198;4;0;4
201000431;700;651;652;4;186;513;1;186;4;0;182;0;0;0
201000432;700;646;646;3;193;506;1;193;4;0;189;0;0;0
201000433;900;361;900;3;361;543;1;356;9;8;339;5;1;4
201000434;500;459;459;1;141;359;0;141;5;1;135;0;0;0
201000435;1000;937;937;7;283;719;1;280;15;1;264;3;0;3
201000436;400;371;377;2;144;283;2;115;4;1;110;29;0;29
201000437;1000;1011;1021;1;319;692;2;306;27;4;275;13;0;13
201000438;800;818;818;1;264;549;1;250;4;2;244;14;1;13
201000439;700;665;665;5;208;515;1;184;7;7;170;24;1;23
201000440;800;611;810;8;186;617;4;179;3;12;164;7;0;7
201000441;700;638;638;3;155;544;1;155;1;2;152;0;0;0
201000442;1100;1014;1029;5;327;767;6;327;5;2;320;0;0;0
201000443;100;42;42;0;42;57;1;42;0;0;42;0;0;0
201500501;100;75;75;6;36;63;1;36;0;1;35;0;0;0
201500502;600;548;548;4;124;476;1;123;11;1;111;1;0;1
201500503;600;585;585;3;176;423;1;176;21;2;153;0;0;0
201500504;200;147;147;6;65;134;1;65;9;2;54;0;0;0
201500505;120;102;103;7;46;73;1;46;3;1;42;0;0;0
201500506;400;427;427;5;171;234;1;165;1;1;163;6;0;6
201500507;500;544;547;3;226;358;1;141;8;11;122;85;4;81
201500508;100;63;63;6;40;59;1;40;0;2;38;0;0;0
201500509;200;181;181;4;90;109;1;90;8;2;80;0;0;0
201500510;350;325;326;6;54;295;1;54;3;1;50;0;0;0
201500511;100;66;66;5;40;59;1;40;5;0;35;0;0;0
201500512;600;596;602;8;120;496;1;103;10;2;91;17;1;16
201500513;600;560;631;4;168;440;1;159;22;0;137;9;1;8
201500514;30;12;12;0;12;18;0;12;1;0;11;0;0;0
203100101;500;490;493;5;182;404;1;95;0;5;90;87;4;83
203100102;500;443;447;4;189;388;1;111;2;0;109;78;3;75
203100103;500;500;500;7;182;400;1;99;1;2;96;83;5;78
203100104;500;552;559;9;196;384;1;115;5;1;109;81;2;79
203100105;400;446;446;4;150;295;2;103;4;2;97;47;0;47
203100106;400;445;445;0;155;318;1;81;3;4;74;74;5;69
203100107;400;418;418;5;156;310;1;89;2;0;87;67;1;66
203100108;600;632;633;4;206;481;1;118;3;3;112;88;6;82
203100109;500;472;473;3;184;395;1;104;3;2;99;80;2;78
203100110;600;606;606;7;222;473;1;126;3;2;121;96;4;92
203100111;600;597;597;4;195;496;1;103;1;5;97;92;0;92
203100112;700;701;703;8;200;573;2;125;2;4;119;75;6;69
203100113;500;489;491;7;152;407;1;92;1;1;90;60;3;57
203100114;600;554;555;4;163;515;1;84;0;1;83;79;4;75
203100115;900;837;841;7;282;745;1;154;11;3;140;128;3;125
203100116;500;496;496;6;155;406;1;93;2;7;84;62;3;59
203100117;600;621;627;8;180;487;1;112;3;8;101;68;2;66
203100118;900;849;852;8;249;753;1;146;8;5;133;103;2;101
203100119;600;650;650;10;236;484;1;115;3;6;106;121;1;120
203100120;500;492;495;7;165;419;1;80;3;6;71;85;4;81
203100121;500;468;468;6;126;421;1;78;1;1;76;48;2;46
203100122;500;518;518;6;119;432;1;67;2;2;63;52;3;49
203100123;900;917;919;4;183;779;2;119;6;3;110;64;1;63
203100124;500;559;560;10;174;410;1;89;6;2;81;85;2;83
203100125;500;490;492;5;130;440;1;59;1;1;57;71;3;68
203100126;600;570;572;3;175;503;1;96;4;1;91;79;1;78
203100127;700;625;659;6;194;588;1;111;2;1;108;83;2;81
203100128;500;469;478;4;148;403;1;96;5;5;86;52;2;50
203100129;600;621;625;3;209;483;1;116;9;3;104;93;4;89
203100130;700;651;651;8;238;546;1;153;8;1;144;85;3;82
203100131;700;673;676;6;234;559;1;140;1;5;134;94;4;90
203100132;800;785;790;10;260;667;1;132;6;1;125;128;4;124
203100133;800;817;821;5;296;650;2;148;6;3;139;148;6;142
203100134;400;433;435;3;146;321;1;78;3;2;73;68;3;65
203100135;500;511;516;7;135;405;5;90;5;2;83;45;2;43
203100136;500;523;524;9;149;429;1;70;5;0;65;79;6;73
203100137;700;671;673;7;136;598;1;101;10;3;88;35;2;33
203100138;700;722;722;7;194;582;1;117;1;1;115;77;2;75
203100139;700;685;686;6;126;573;1;126;19;1;106;0;0;0
203100140;600;585;588;5;115;512;1;87;10;0;77;28;1;27
203100141;600;600;600;8;162;509;2;89;2;2;85;73;4;69
203100142;500;475;475;7;109;423;1;76;4;0;72;33;0;33
203100143;800;714;716;7;265;638;1;161;7;2;152;104;1;103
203100144;800;794;796;5;332;619;2;179;3;3;173;153;10;143
203100145;800;773;814;6;254;674;1;125;3;4;118;129;4;125
203100146;800;798;805;4;247;663;1;136;5;4;127;111;5;106
203100147;700;689;689;6;253;579;2;119;4;2;113;134;4;130
203100148;500;444;445;3;149;417;1;82;5;1;76;67;1;66
203100149;500;524;528;0;152;434;1;65;1;2;62;87;3;84
203100150;500;483;483;4;176;413;1;86;2;6;78;90;4;86
203100151;700;663;664;6;222;588;1;111;4;6;101;111;9;102
203100152;500;452;453;4;164;410;1;89;5;2;82;75;2;73
203100153;600;555;555;5;186;498;1;101;7;4;90;85;4;81
203100154;600;590;594;9;149;507;1;92;8;4;80;57;2;55
203100155;700;673;674;8;250;586;1;113;9;5;99;137;9;128
203100156;100;16;16;32;38;61;1;38;3;1;34;0;0;0
203100157;100;153;75;8;72;27;1;72;16;0;56;0;0;0
203100158;500;453;459;6;141;406;1;93;2;3;88;48;3;45
203100159;500;501;505;2;149;396;1;103;2;5;96;46;3;43
203100160;600;633;633;5;189;484;1;115;3;3;109;74;4;70
203100161;500;498;498;3;107;418;1;81;1;1;79;26;1;25
203100162;500;520;520;2;119;420;1;79;3;1;75;40;0;40
203100163;700;658;658;7;167;591;2;107;4;1;102;60;2;58
203100164;700;691;694;3;213;568;1;131;2;5;124;82;1;81
203100165;500;482;482;3;160;404;1;95;7;2;86;65;2;63
203100166;400;426;427;5;130;315;1;84;8;0;76;46;3;43
203100167;400;442;444;5;136;310;2;88;6;2;80;48;1;47
203100168;100;106;92;2;59;40;1;59;7;1;51;0;0;0
203100169;300;344;344;2;160;174;1;125;8;1;116;35;3;32
203100170;100;62;62;7;56;43;1;56;1;0;55;0;0;0
203100171;500;492;492;3;137;370;1;129;2;1;126;8;0;8
203100172;500;501;502;0;158;355;2;143;1;2;140;15;0;15
203100173;100;63;63;8;41;58;1;41;5;3;33;0;0;0
203100174;100;141;141;4;78;21;1;78;3;4;71;0;0;0
203100175;100;35;46;5;40;59;1;40;0;3;37;0;0;0
203100176;500;550;550;4;199;305;1;194;11;1;182;5;1;4
203100177;600;600;601;2;209;453;1;146;5;5;136;63;3;60
203100178;700;653;655;3;205;583;1;116;4;2;110;89;2;87
203100179;500;479;479;5;153;402;2;96;2;3;91;57;4;53
203100180;500;544;544;9;194;351;1;148;6;3;139;46;5;41
203100181;500;627;630;4;75;430;1;69;15;0;54;6;0;6
203100182;500;504;506;7;128;418;2;80;6;1;73;48;2;46
203100183;100;76;76;5;52;47;1;52;3;2;47;0;0;0
203100184;100;34;34;7;33;66;1;33;2;1;30;0;0;0
203100185;100;63;63;5;36;62;2;36;0;1;35;0;0;0
203100186;500;537;537;3;163;366;1;133;6;2;125;30;3;27
203100187;500;506;508;3;219;319;1;180;8;2;170;39;0;39
203100188;100;32;32;3;27;72;1;27;2;2;23;0;0;0
203100189;200;281;282;6;160;39;1;160;8;3;149;0;0;0
203100190;100;130;131;3;74;25;1;74;4;4;66;0;0;0
203100191;400;451;464;4;152;290;1;109;5;4;100;43;1;42
203100192;100;27;27;7;20;79;1;20;0;0;20;0;0;0
203100193;100;29;29;0;29;71;0;29;2;0;27;0;0;0
203100194;100;29;29;0;27;73;0;27;1;0;26;0;0;0
203200601;600;622;623;4;194;460;1;139;5;3;131;55;1;54
203200602;400;462;465;8;144;275;1;124;3;3;118;20;0;20
203200603;200;207;207;6;76;123;1;76;5;0;71;0;0;0
203200604;300;308;308;5;113;206;1;93;6;1;86;20;1;19
203200605;100;43;43;4;32;67;1;32;1;0;31;0;0;0
203200606;600;572;580;10;200;423;2;175;11;1;163;25;0;25
203200607;500;716;716;10;273;256;1;243;5;3;235;30;0;30
203200608;800;802;805;7;251;567;1;232;5;1;226;19;0;19
203200609;600;550;575;10;275;367;1;232;17;5;210;43;1;42
203200610;100;62;62;8;31;68;1;31;0;1;30;0;0;0
203200611;100;81;81;7;43;56;1;43;0;0;43;0;0;0
203200612;300;373;373;4;100;223;1;76;1;0;75;24;1;23
203200613;100;64;64;6;29;70;1;29;1;1;27;0;0;0
203200614;100;40;40;2;40;59;1;40;4;0;36;0;0;0
203400701;500;516;523;8;167;382;1;117;5;6;106;50;1;49
203400702;700;718;722;8;242;540;1;159;3;1;155;83;2;81
203400703;800;914;914;9;280;547;1;252;17;7;228;28;1;27
203400704;800;844;852;4;256;617;1;182;8;4;170;74;2;72
203400705;700;773;780;4;231;531;1;168;7;9;152;63;0;63
203400706;800;838;839;7;295;576;1;223;8;6;209;72;1;71
203400707;700;726;738;8;225;526;1;173;11;7;155;52;0;52
203400708;800;792;800;5;234;637;1;162;5;1;156;72;4;68
203400709;800;807;810;5;255;645;1;154;10;0;144;101;4;97
203400710;1000;1004;1012;6;305;757;1;242;16;0;226;63;1;62
203400711;400;423;424;3;156;278;1;121;1;3;117;35;0;35
203400712;500;518;518;6;153;388;1;111;6;3;102;42;2;40
203400713;900;853;907;5;293;611;1;288;20;3;265;5;0;5
203400714;100;32;32;8;24;75;1;24;0;1;23;0;0;0
203400715;500;574;576;3;145;369;1;130;8;1;121;15;0;15
203400716;200;232;258;6;122;77;1;122;10;1;111;0;0;0
203400717;300;279;279;0;73;226;1;73;1;2;70;0;0;0
203400718;400;374;374;1;127;298;1;101;3;1;97;26;1;25
203400719;400;418;418;5;174;245;4;151;8;1;142;23;0;23
203400720;200;224;226;3;99;100;1;99;3;1;95;0;0;0
203400721;100;59;59;7;38;61;1;38;2;0;36;0;0;0
203400722;400;464;464;4;196;204;1;195;8;4;183;1;0;1
203400723;700;744;745;5;364;335;1;364;8;5;351;0;0;0
203400724;400;380;383;3;162;237;1;162;9;0;153;0;0;0
203400725;100;28;28;6;14;85;1;14;3;0;11;0;0;0
203400726;100;36;36;7;25;74;1;25;0;1;24;0;0;0
203400727;100;25;25;27;35;64;1;35;2;4;29;0;0;0
203400728;100;59;59;0;58;41;1;58;3;0;55;0;0;0
211100001;200;102;102;8;63;136;1;63;5;1;57;0;0;0
211100003;900;861;861;5;139;791;1;108;11;0;97;31;0;31
211100004;900;918;919;3;88;811;1;88;16;0;72;0;0;0
211100005;900;902;902;4;95;804;1;95;20;0;75;0;0;0
211100006;800;821;821;6;63;736;1;63;11;1;51;0;0;0
211100007;100;17;17;2;14;85;1;14;0;1;13;0;0;0
211100008;300;294;289;5;88;211;1;88;3;3;82;0;0;0
211100010;400;378;378;3;102;314;1;85;4;2;79;17;0;17
211100011;700;687;687;0;148;600;1;99;3;9;87;49;2;47
211100012;700;724;724;5;207;570;1;129;5;5;119;78;1;77
211100013;800;790;790;7;184;683;1;116;9;4;103;68;0;68
211100014;900;910;908;2;130;794;1;105;11;0;94;25;2;23
211100015;700;730;731;0;165;590;1;109;3;3;103;56;1;55
211100016;900;917;917;2;114;793;1;106;12;0;94;8;0;8
211100017;700;707;707;10;223;476;1;223;25;0;198;0;0;0
211100018;200;111;111;7;55;144;1;55;2;3;50;0;0;0
211100019;700;675;675;4;172;561;2;137;20;3;114;35;2;33
211100020;300;206;206;6;87;212;1;87;6;2;79;0;0;0
211100021;300;259;259;8;103;196;1;103;8;0;95;0;0;0
211100022;400;317;317;7;93;306;1;93;4;0;89;0;0;0
211100023;400;416;416;1;113;294;1;105;11;3;91;8;0;8
211100025;600;634;634;8;169;430;1;169;18;0;151;0;0;0
211100026;400;408;408;6;81;330;1;69;4;1;64;12;0;12
211100027;900;951;951;4;328;600;1;299;17;2;280;29;0;29
211100028;300;211;211;6;54;245;1;54;2;0;52;0;0;0
211100029;900;932;932;5;218;708;1;191;22;2;167;27;1;26
211100030;1000;984;984;10;205;811;1;188;6;4;178;17;2;15
211100031;900;929;930;15;179;729;1;170;12;1;157;9;0;9
211100032;900;938;938;17;232;683;1;216;9;5;202;16;0;16
211100033;900;920;920;12;203;707;1;192;9;5;178;11;0;11
211600001;400;407;414;2;126;346;1;53;0;3;50;73;4;69
211600002;700;767;771;5;235;572;3;125;2;2;121;110;2;108
211600003;700;742;742;3;243;581;1;118;3;2;113;125;6;119
211600004;700;815;815;2;257;564;6;130;4;3;123;127;2;125
211600005;600;646;649;4;178;519;1;80;2;0;78;98;0;98
211600006;600;649;651;7;171;468;1;131;1;1;129;40;2;38
211600007;500;491;492;7;89;455;1;44;3;1;40;45;2;43
211600008;600;712;713;3;92;539;2;59;3;1;55;33;2;31
211600009;600;754;754;6;46;561;1;38;6;0;32;8;0;8
211600010;700;959;959;4;66;664;1;35;5;0;30;31;0;31
211600011;700;1038;1038;5;81;622;0;78;6;1;71;3;0;3
211600012;600;731;732;5;40;599;1;0;0;0;0;40;0;40
211600013;500;596;597;7;51;446;4;50;3;1;46;1;0;1
211600014;700;899;899;6;54;699;1;0;0;0;0;54;0;54
211600015;700;940;942;8;62;699;1;0;0;0;0;62;0;62
211600016;700;929;929;7;50;699;1;0;0;0;0;50;0;50
211600017;500;570;571;5;124;421;1;78;1;3;74;46;0;46
211600018;600;678;680;4;190;483;1;116;4;0;112;74;3;71
211600019;400;376;376;4;110;343;1;56;1;3;52;54;2;52
211600020;400;391;391;3;93;355;1;44;1;3;40;49;4;45
211600021;600;615;618;8;193;500;1;99;2;5;92;94;5;89
211600022;500;510;511;0;151;418;1;81;1;0;80;70;0;70
211600023;500;651;652;3;180;405;1;94;4;1;89;86;3;83
211600024;500;517;517;5;175;403;1;96;2;3;91;79;2;77
211600025;700;789;790;4;205;598;1;101;3;0;98;104;5;99
211600026;500;573;573;6;154;418;1;81;5;3;73;73;2;71
211600027;600;707;707;7;211;493;1;106;1;3;102;105;4;101
211600028;600;707;708;7;258;469;1;130;4;4;122;128;3;125
211600029;500;559;559;7;140;426;3;71;3;0;68;69;2;67
211600030;700;683;686;4;134;633;1;66;6;2;58;68;2;66
211600031;700;736;737;7;220;571;1;128;3;8;117;92;4;88
211600032;500;464;465;3;144;400;1;99;4;3;92;45;2;43
211600033;300;251;253;4;67;232;1;67;8;1;58;0;0;0
211600034;700;655;656;10;148;574;1;125;3;1;121;23;0;23
211600035;100;50;50;7;54;45;1;54;1;0;53;0;0;0
211600036;600;701;701;0;139;460;1;139;16;0;123;0;0;0
211600037;600;583;587;13;103;522;1;77;7;0;70;26;0;26
211600038;700;652;655;5;153;581;1;118;9;0;109;35;2;33
211600039;200;159;159;7;95;103;2;95;11;1;83;0;0;0
211600040;300;321;322;5;182;117;1;182;14;0;168;0;0;0
211600041;200;93;93;6;38;161;1;38;3;2;33;0;0;0
211600042;400;405;405;5;69;340;1;59;0;0;59;10;1;9
211600043;700;650;651;6;146;585;1;114;6;4;104;32;0;32
211600044;400;336;336;5;128;310;1;89;7;0;82;39;2;37
211600045;300;299;299;5;75;224;1;75;3;3;69;0;0;0
211600046;300;228;230;6;79;220;1;79;3;0;76;0;0;0
211600047;200;198;198;5;95;104;1;95;5;4;86;0;0;0
211600048;200;88;88;6;59;140;1;59;0;1;58;0;0;0
211600049;400;330;332;4;112;321;1;78;5;2;71;34;1;33
211600050;200;108;108;6;53;145;2;53;3;0;50;0;0;0
211600051;200;135;135;7;73;125;2;73;3;5;65;0;0;0
211600052;500;459;464;2;174;377;1;122;4;1;117;52;1;51
211600053;200;101;102;3;53;146;1;53;1;3;49;0;0;0
211600054;300;212;212;6;71;228;1;71;2;0;69;0;0;0
211600055;300;236;238;5;71;228;1;71;5;1;65;0;0;0
211600056;300;280;282;4;129;170;1;129;10;0;119;0;0;0
211600057;500;481;485;6;93;439;1;60;4;1;55;33;1;32
211600058;400;360;360;5;61;350;1;49;4;1;44;12;1;11
211600059;300;248;248;2;73;226;1;73;4;3;66;0;0;0
211600060;600;580;581;5;159;496;1;103;6;5;92;56;1;55
211600061;300;301;301;4;91;208;1;91;8;2;81;0;0;0
211600062;300;226;226;3;95;204;1;95;5;3;87;0;0;0
211600063;300;273;274;3;85;214;1;85;4;0;81;0;0;0
212000001;400;528;533;7;150;338;1;61;2;2;57;89;4;85
212000002;600;756;757;7;180;508;1;91;11;1;79;89;1;88
212000003;500;566;568;8;143;425;1;74;4;1;69;69;2;67
212000004;500;643;643;5;178;415;1;84;0;2;82;94;2;92
212000005;500;620;620;5;154;435;1;64;3;0;61;90;1;89
212000006;700;816;818;3;190;611;1;88;2;2;84;102;5;97
212000007;500;651;653;0;167;413;1;86;4;0;82;81;3;78
212000008;500;625;625;3;148;419;1;80;5;2;73;68;3;65
212000009;500;675;677;6;171;396;2;102;3;3;96;69;7;62
212000010;400;436;439;6;103;362;1;37;0;0;37;66;2;64
212000011;400;496;497;3;133;320;1;79;2;0;77;54;0;54
212000012;500;664;667;3;138;430;1;69;2;1;66;69;2;67
212000013;300;391;391;6;84;255;1;44;1;0;43;40;1;39
212000014;400;513;516;9;139;300;1;99;2;4;93;40;2;38
212000015;300;366;366;6;94;251;1;48;2;1;45;46;1;45
212000016;400;551;551;6;110;339;2;59;2;0;57;51;1;50
212000017;600;725;725;8;220;503;1;96;3;3;90;124;6;118
212000018;400;527;527;10;174;304;1;95;3;3;89;79;2;77
212000019;300;434;435;6;104;234;1;65;7;1;57;39;2;37
212000020;500;688;688;8;114;399;1;100;12;2;86;14;3;11
212000021;700;915;918;8;107;595;1;104;14;2;88;3;0;3
212000022;500;655;655;9;106;444;1;55;5;0;50;51;0;51
212000023;500;673;676;5;140;416;1;83;4;1;78;57;0;57
212000024;500;598;598;6;202;376;2;122;1;8;113;80;4;76
212000025;400;505;505;8;154;344;1;55;1;1;53;99;3;96
212000026;600;695;696;9;240;493;3;104;1;0;103;136;7;129
212000027;400;503;505;7;181;326;1;73;1;4;68;108;5;103
212000028;400;479;481;5;134;274;1;125;6;2;117;9;1;8
212000029;700;856;856;6;316;569;1;130;4;2;124;186;10;176
212000030;500;601;602;3;201;417;1;82;6;1;75;119;6;113
212000031;500;651;652;9;238;402;1;97;3;2;92;141;8;133
212000032;500;614;615;7;222;420;1;79;1;1;77;143;0;143
212000033;700;837;906;3;296;552;1;147;4;6;137;149;2;147
212000034;400;522;523;9;224;307;1;92;3;1;88;132;5;127
212000035;400;469;472;6;186;322;1;77;2;1;74;109;1;108
212000036;600;696;698;8;257;499;1;100;3;0;97;157;7;150
212000037;400;499;501;8;189;308;1;91;3;0;88;98;2;96
212000038;400;480;482;4;167;348;1;51;3;1;47;116;4;112
212000039;500;570;571;5;216;402;3;95;1;1;93;121;2;119
212000040;500;552;553;6;204;408;2;90;4;0;86;114;4;110
212000041;500;567;569;8;192;405;1;94;0;2;92;98;4;94
212000042;400;522;523;8;76;348;1;51;4;1;46;25;0;25
212000043;500;611;612;6;172;419;1;80;7;1;72;92;13;79
212000044;400;429;430;6;127;346;1;53;1;3;49;74;4;70
212000045;400;524;524;8;143;337;1;62;3;1;58;81;4;77
212000046;400;437;438;5;125;321;2;77;1;3;73;48;5;43
212000047;600;719;722;6;201;498;1;101;4;2;95;100;6;94
212000048;400;540;540;3;144;322;2;76;2;3;71;68;2;66
212000049;500;640;641;7;174;399;1;100;5;1;94;74;4;70
212000050;600;764;765;8;170;498;1;101;3;2;96;69;1;68
212000051;500;632;633;7;183;391;2;107;5;2;100;76;4;72
212000052;400;460;458;5;113;343;1;56;1;0;55;57;6;51
212000053;600;716;717;6;259;486;1;113;2;2;109;146;2;144
212000054;400;521;523;3;178;311;1;88;3;2;83;90;2;88
212000055;500;571;573;6;126;430;1;69;2;1;66;57;1;56
212000056;600;712;712;8;159;503;1;96;4;4;88;63;0;63
212000057;800;959;1003;8;222;674;1;125;6;5;114;97;0;97
212000058;500;500;653;653;170;417;2;81;6;4;71;89;4;85
212000059;700;791;794;7;199;600;1;99;2;3;94;100;4;96
212000060;500;660;661;5;175;413;1;86;0;4;82;89;2;87
212000061;500;634;636;10;157;419;1;80;4;1;75;77;1;76
212000062;600;684;687;6;161;522;2;76;3;0;73;85;3;82
212000063;600;792;794;10;191;522;1;77;1;2;74;114;2;112
212000064;600;687;712;7;162;547;1;52;0;0;52;110;3;107
212000065;500;552;554;8;123;454;1;45;4;0;41;78;3;75
212000066;600;727;748;4;144;525;1;74;2;4;68;70;1;69
212000067;500;666;668;3;154;405;1;94;4;4;86;60;1;59
212000068;700;804;805;7;203;585;1;114;2;4;108;89;3;86
212000069;600;681;682;3;145;515;1;84;4;1;79;61;4;57
212000070;600;666;689;2;144;532;2;66;0;5;61;78;1;77
212000071;600;668;668;1;185;494;1;105;7;0;98;80;4;76
212000072;500;580;581;5;157;406;1;93;2;0;91;64;2;62
212000073;500;598;602;5;132;437;1;62;3;0;59;70;3;67
212000074;400;487;487;2;123;333;1;66;2;2;62;57;0;57
212000075;500;570;574;6;141;411;2;87;1;6;80;54;3;51
212000076;600;717;717;6;135;534;1;65;5;0;60;70;2;68
212000077;700;785;787;6;229;582;1;117;3;2;112;112;2;110
212000078;500;640;640;6;160;405;6;89;6;5;78;71;0;71
212000079;600;716;732;8;181;501;3;96;3;3;90;85;3;82
212000080;500;571;572;5;107;452;1;47;2;1;44;60;4;56
212000081;500;569;570;3;137;422;4;74;4;1;69;63;1;62
212000082;500;548;549;5;126;446;1;53;1;1;51;73;3;70
212000083;400;439;442;5;139;313;2;85;1;2;82;54;0;54
212000084;400;501;522;5;131;328;2;70;2;1;67;61;1;60
212000085;800;930;931;4;197;712;1;87;4;2;81;110;5;105
212000086;500;592;592;8;106;446;1;53;3;2;48;53;0;53
212000087;600;147;702;6;149;514;2;84;7;2;75;65;2;63
212000088;600;751;752;5;151;513;1;86;1;2;83;65;1;64
212000089;600;725;728;6;140;534;1;65;1;1;63;75;2;73
212000090;700;789;789;7;176;607;1;92;1;1;90;84;7;77
212000091;500;615;617;7;152;425;1;74;1;1;72;78;1;77
212000092;600;687;688;6;184;507;1;92;0;1;91;92;3;89
212000093;400;509;514;6;118;344;1;55;3;0;52;63;6;57
212000094;300;385;386;5;112;239;1;60;4;0;56;52;3;49
212000095;400;461;462;5;133;339;1;60;1;0;59;73;1;72
212000096;400;448;451;4;130;348;1;51;3;4;44;79;2;77
212000097;500;611;611;7;194;406;1;93;4;1;88;101;6;95
212000098;300;415;415;2;113;238;1;61;2;2;57;52;3;49
212000099;500;583;585;5;137;445;1;54;1;1;52;83;2;81
212000100;500;613;613;7;178;390;0;110;9;1;100;68;2;66
212000101;600;679;681;8;192;524;1;75;1;1;73;117;2;115
212000102;600;694;695;3;211;477;1;122;6;5;111;89;4;85
212000103;500;625;627;3;134;430;1;69;3;3;63;65;5;60
212000104;300;406;407;5;76;236;1;63;1;2;60;13;0;13
212000105;400;449;451;7;104;346;1;53;0;1;52;51;3;48
212000106;300;382;383;11;93;251;1;48;3;1;44;45;1;44
212000107;400;433;434;4;92;357;1;42;2;0;40;50;3;47
212000108;600;751;755;5;188;493;1;106;5;6;95;82;4;78
212000109;500;586;586;5;161;415;1;84;0;1;83;77;3;74
212000110;500;554;585;2;161;415;1;84;6;0;78;77;3;74
212000111;400;480;491;8;108;339;1;60;1;3;56;48;0;48
212000112;400;512;512;5;113;328;1;71;4;3;64;42;1;41
212000113;800;1040;1041;9;35;799;1;0;0;0;0;35;0;35
212000114;800;989;992;10;36;769;6;25;5;0;20;11;0;11
212000115;800;982;982;8;17;790;1;9;4;0;5;8;0;8
212000116;900;1103;1106;9;118;811;1;88;17;0;71;30;1;29
212000117;900;1115;1118;10;79;835;3;62;13;0;49;17;0;17
212000118;900;1091;1091;9;34;875;3;22;3;0;19;12;0;12
212000119;1100;1382;1382;7;196;925;1;174;28;0;146;22;0;22
212000120;1100;1361;1363;8;178;920;2;178;53;0;125;0;0;0
212000121;500;575;576;4;118;443;1;56;4;0;52;62;3;59
212000122;600;782;784;6;233;489;1;110;6;3;101;123;6;117
212000123;700;894;928;4;72;632;1;67;7;1;59;5;0;2
212000124;600;719;720;3;142;525;1;74;2;1;71;68;2;66
212000125;600;780;782;4;212;445;3;152;0;4;148;60;2;58
212000126;400;541;543;7;93;328;1;71;9;2;60;22;1;21
212000127;700;853;853;5;108;613;1;86;6;0;80;22;0;22
212000128;700;900;902;7;37;665;1;34;6;0;28;3;0;3
212000129;200;102;102;6;59;140;1;59;4;3;52;0;0;0
212000130;100;26;26;8;21;78;1;21;0;2;19;0;0;0
212000131;400;386;387;3;190;252;1;147;14;1;132;43;0;43
212000132;100;81;81;6;45;54;1;45;4;0;41;0;0;0
212000133;200;188;188;2;80;118;2;80;3;0;77;0;0;0
212000134;200;121;121;4;36;163;1;36;2;0;34;0;0;0
212000136;500;532;532;6;124;396;1;103;7;2;94;21;2;19
212000137;700;851;855;6;141;586;3;111;3;1;107;30;0;30
212000138;100;77;77;7;21;78;1;21;0;0;21;0;0;0
212000139;400;399;404;5;121;311;1;88;3;0;85;33;2;31
212000140;400;411;413;4;130;306;1;93;4;0;89;37;1;36
212000141;900;1011;1012;5;459;456;1;443;22;3;418;16;0;16
212000142;300;250;250;8;140;159;1;140;6;6;128;0;0;0
212000143;200;124;125;6;63;136;1;63;1;2;60;0;0;0
212000144;300;368;369;1;117;214;2;84;3;3;78;33;1;32
212000145;400;471;474;2;141;299;1;100;8;1;91;41;3;38
212000146;600;742;742;2;354;280;4;316;31;1;284;38;2;36
212000147;400;446;450;3;140;286;1;113;8;2;103;27;0;27
212000148;200;114;116;3;80;119;1;80;1;1;78;0;0;0
212000149;300;244;244;6;132;167;1;132;12;0;120;0;0;0
212000150;200;157;157;2;69;129;2;69;2;0;67;0;0;0
212000151;800;911;911;9;115;722;1;77;4;0;73;38;1;37
212000152;500;600;603;8;182;345;1;154;6;0;148;28;0;28
212000153;400;499;502;6;203;228;1;171;5;2;164;32;1;31
212000154;300;234;234;4;95;204;1;95;0;1;94;0;0;0
212000155;300;258;258;3;126;172;2;126;7;2;117;0;0;0
212000156;400;525;526;1;172;306;1;93;5;3;85;79;2;77
212000157;200;116;116;3;44;155;1;44;3;1;40;0;0;0
212000158;100;42;42;9;27;72;1;27;2;0;25;0;0;0
212000159;300;242;242;5;100;199;1;100;7;2;91;0;0;0
212000160;400;534;540;3;224;223;1;176;11;4;161;48;2;46
212000161;300;383;383;1;168;171;1;128;18;8;102;40;1;39
212000162;500;498;505;0;162;370;2;128;6;2;120;34;3;31
212000163;300;300;300;7;95;204;1;95;2;1;92;0;0;0
212000164;400;476;478;2;87;322;3;75;3;1;71;12;1;11
212000165;800;969;970;7;125;707;1;92;11;1;80;33;2;31
212000166;600;780;780;8;215;470;2;128;5;4;119;87;11;76
212000167;500;643;647;9;241;284;1;215;13;0;202;26;0;26
212000168;700;837;839;7;77;638;1;61;3;1;57;16;1;15
212000169;600;712;712;5;153;489;1;110;7;2;101;43;3;40
212000170;800;965;966;6;295;559;1;240;18;0;222;55;1;54
212000171;400;453;461;15;162;282;1;117;6;3;108;45;3;42
212000172;500;660;663;0;262;237;1;262;28;1;233;0;0;0
212000173;500;644;650;0;234;273;1;226;14;2;210;8;0;8
212000174;700;883;883;5;152;555;2;143;13;1;129;9;0;9
212000175;600;739;739;5;112;516;1;83;5;0;78;29;1;28
212000176;600;666;667;3;147;500;1;99;5;1;93;48;1;47
212000177;500;520;520;9;112;431;1;68;11;0;57;44;1;43
212000178;300;299;299;5;116;183;1;116;4;2;110;0;0;0
212000179;500;586;593;8;157;363;1;136;4;2;130;21;1;20
212000180;300;432;432;4;142;203;1;96;3;1;92;46;0;46
212000181;300;298;300;4;108;191;1;108;6;1;101;0;0;0
212000182;400;473;465;8;65;345;1;54;5;0;49;11;0;11
212000183;100;51;51;8;48;52;0;48;2;0;46;0;0;0
212000184;100;45;45;24;59;40;1;59;7;3;49;0;0;0
212000185;100;31;31;22;30;69;1;30;1;2;27;0;0;0
212000186;200;115;115;13;64;135;1;64;10;2;52;0;0;0
212000187;100;10;10;51;56;43;1;56;3;2;51;0;0;0
212400001;500;522;522;4;145;407;1;92;2;3;87;53;4;49
212400002;700;696;696;9;201;556;1;143;4;5;134;58;3;55
212400003;600;589;589;4;185;492;2;106;5;7;94;79;6;73
212400004;700;672;673;4;214;559;1;140;11;4;125;74;3;71
212400005;800;838;840;5;54;750;1;49;7;0;42;5;0;5
212400006;800;822;823;2;50;749;1;50;5;0;45;0;0;0
212400007;600;643;644;2;159;480;2;118;9;3;106;41;2;39
212400008;500;470;472;4;125;395;1;104;13;3;88;21;1;20
212400009;600;630;630;0;162;473;1;126;7;5;114;36;1;35
212400010;800;846;849;6;89;722;1;77;12;3;62;12;1;11
212400011;800;844;847;2;182;670;1;129;3;2;124;53;3;50
212400012;600;644;644;3;57;550;2;48;3;1;44;9;0;9
212400013;700;732;732;1;95;623;1;76;8;0;68;19;1;18
212400014;900;904;907;1;159;775;1;124;4;1;119;35;1;34
212400015;100;123;125;8;62;37;1;62;5;2;55;0;0;0
212400016;100;63;63;9;47;52;1;47;0;1;46;0;0;0
212400018;400;389;389;7;90;324;1;75;3;2;70;15;0;15
212400019;400;395;395;4;97;310;1;89;4;1;84;8;1;7
212400020;900;918;919;4;182;724;1;175;6;1;168;7;0;7
220200001;500;521;527;1;230;325;1;174;2;3;169;56;3;53
220200002;300;231;232;0;81;218;1;81;6;3;72;0;0;0
220200003;400;429;432;3;158;296;1;103;2;2;99;55;1;54
220200004;300;198;198;0;106;193;1;106;1;3;102;0;0;0
220200005;400;352;352;2;132;284;1;115;9;2;104;17;0;17
220200006;100;19;19;6;16;83;1;16;0;0;16;0;0;0
220200007;200;187;186;2;73;126;1;73;2;3;68;0;0;0
220200008;200;156;156;2;72;127;1;72;4;0;68;0;0;0
220200009;100;44;44;0;22;77;1;22;4;2;16;0;0;0
220200010;100;42;42;6;22;77;1;22;0;1;21;0;0;0
220200011;400;446;446;4;161;265;1;134;3;3;128;27;2;25
220200012;300;220;222;0;130;169;1;130;5;2;123;0;0;0
220200013;100;27;27;6;16;83;1;16;1;1;14;0;0;0
220200014;300;246;246;1;120;179;1;120;3;2;115;0;0;0
220200015;100;70;70;5;30;69;1;30;1;0;29;0;0;0
220200016;100;13;13;0;12;87;1;12;0;0;12;0;0;0
220200017;100;89;89;18;52;47;1;52;0;1;51;0;0;0
220500001;700;722;745;3;312;445;2;253;11;2;240;59;1;58
220500002;800;751;769;1;379;459;2;339;11;7;321;40;1;39
220500003;800;746;765;1;315;526;1;273;13;6;254;42;3;39
220500004;200;115;119;1;87;112;1;87;1;0;86;0;0;0
220500005;400;352;358;1;175;252;1;147;3;0;144;28;0;28
220500006;300;255;280;1;170;129;1;170;0;1;169;0;0;0
220500007;100;73;77;0;52;47;1;52;1;0;51;0;0;0
220500008;100;62;62;0;62;38;0;62;1;0;61;0;0;0
220500009;100;35;35;0;34;65;1;34;0;0;34;0;0;0
220900001;800;771;775;5;240;640;2;158;6;6;146;82;7;75
220900002;500;499;501;6;177;389;1;110;2;3;105;67;4;63
220900003;600;579;582;9;224;455;1;144;2;3;139;80;1;79
220900004;800;774;777;2;222;641;2;157;9;4;154;65;0;65
220900005;400;436;437;4;147;309;2;89;2;0;87;58;3;55
220900006;500;479;479;8;183;373;1;126;7;2;117;57;1;56
220900007;900;919;931;1;297;684;1;215;12;6;197;82;5;77
220900008;500;483;483;0;159;388;1;111;4;6;101;48;3;45
220900009;600;586;588;2;212;423;1;176;8;3;165;36;0;36
220900010;300;286;287;3;134;165;1;134;8;1;125;0;0;0
220900011;400;342;342;4;106;296;2;102;4;0;98;4;0;4
220900012;800;767;769;3;254;548;1;251;13;4;234;3;0;3
220900013;800;766;775;1;318;496;2;302;14;7;281;16;1;15
220900014;500;534;534;0;205;330;1;169;4;2;163;36;1;35
220900015;100;71;71;1;39;60;1;39;2;0;37;0;0;0
220900016;100;60;60;60;40;59;1;40;5;0;35;0;0;0
220900017;500;543;546;1;205;326;2;172;9;3;160;33;0;33
220900018;300;209;209;0;99;200;1;99;1;4;94;0;0;0
220900019;500;472;473;1;126;391;2;107;6;0;101;19;0;19
220900020;300;217;222;3;73;226;1;73;1;0;72;0;0;0
220900021;300;255;255;1;131;168;1;131;5;2;124;0;0;0
220900022;100;35;35;7;31;68;1;31;3;0;28;0;0;0
220900023;100;14;14;15;19;80;1;19;1;0;18;0;0;0
220900024;200;90;90;26;58;141;1;58;0;1;57;0;0;0
220900025;200;23;23;3;24;175;1;24;1;0;23;0;0;0
220900026;100;19;19;3;21;78;1;21;0;0;21;0;0;0
221000001;600;318;577;5;317;328;5;267;3;1;263;50;1;49
221000002;800;820;820;4;457;369;1;430;16;2;412;27;1;26
221000003;500;534;536;4;328;204;1;295;13;2;280;33;0;33
221000004;600;630;630;4;290;431;1;168;3;3;162;122;2;122
221000005;700;731;732;2;276;499;1;200;4;1;195;76;0;76
221000006;700;696;697;2;261;485;1;214;8;4;202;47;0;47
221000007;500;479;460;479;216;299;1;200;6;4;190;16;2;14
221000008;700;726;728;4;217;532;1;167;13;0;154;50;1;49
221000009;300;239;235;0;125;174;1;125;3;1;121;0;0;0
221000010;600;586;597;2;235;421;1;178;5;0;173;57;1;56
221000011;600;555;557;0;207;443;1;156;4;4;148;51;1;50
221000012;700;745;694;2;344;393;2;305;13;7;285;39;1;38
221000013;100;42;42;0;41;59;0;41;2;1;38;0;0;0
221100001;900;827;841;1;241;715;1;184;7;11;166;57;1;56
221100002;500;470;471;0;165;392;1;107;4;3;100;58;0;58
221100003;500;454;454;5;149;406;1;93;5;1;87;56;2;54
221100004;700;733;733;0;280;485;1;214;6;6;202;66;2;64
221100005;800;769;789;4;274;578;2;220;6;5;209;54;0;54
221100006;500;515;515;1;194;359;1;140;9;2;129;54;1;53
221100007;800;769;769;2;282;559;1;240;15;8;217;42;3;39
221100008;800;762;762;1;253;605;1;194;2;2;190;59;2;57
221100009;900;871;871;0;290;703;2;195;8;6;181;95;4;91
221100010;300;232;234;6;104;195;1;104;7;2;95;0;0;0
221100011;400;398;398;6;132;289;1;110;1;1;108;22;2;20
221100012;300;319;320;5;86;235;1;64;1;5;58;22;0;22
221100013;100;29;29;8;27;72;1;27;1;0;26;0;0;0
221100014;900;860;860;860;179;735;1;164;7;2;155;15;1;14
221100015;100;91;91;6;30;69;1;30;0;0;30;0;0;0
221100016;100;52;53;0;27;71;2;27;2;0;25;0;0;0
221100017;100;87;87;8;45;54;1;45;0;0;45;0;0;0
221100018;100;36;36;7;25;74;1;25;0;1;24;0;0;0
221100019;800;744;745;3;292;584;1;215;7;3;205;77;0;77
221100020;600;626;626;2;211;438;0;162;7;4;151;49;1;48
221100021;600;550;550;7;220;427;1;172;7;8;157;48;2;46
221600001;600;886;886;5;375;317;2;281;8;11;262;94;5;89
221600002;400;517;518;5;245;2;222;176;6;7;163;69;6;63
221600003;400;572;575;8;215;254;3;143;4;9;130;72;5;67
221600004;300;360;360;3;184;165;1;134;7;4;123;50;1;49
221600005;300;409;409;5;163;197;1;102;3;3;96;61;1;60
221600006;500;636;641;3;248;392;1;107;5;1;101;141;1;140
221600007;500;757;758;5;280;286;1;213;5;9;199;67;3;64
221600008;200;197;198;2;94;105;1;94;4;7;83;0;0;0
221600009;200;330;332;2;140;111;1;88;0;5;83;52;1;51
221600010;300;264;267;4;121;178;1;121;7;5;109;0;0;0
221600011;200;146;154;4;116;83;1;116;1;0;115;0;0;0
221600012;200;116;118;4;86;113;1;86;0;3;83;0;0;0
221600013;200;168;168;3;123;76;1;123;8;4;111;0;0;0
221600014;100;69;71;7;48;51;1;48;1;1;46;0;0;0
221600015;200;172;177;3;122;77;1;122;6;2;114;0;0;0
221600016;300;217;220;3;123;176;1;123;0;3;120;0;0;0
221600017;200;178;178;4;107;92;1;107;3;5;99;0;0;0
221600018;500;745;750;6;387;163;2;335;10;9;316;52;4;48
221600019;200;167;171;3;102;97;1;102;1;1;100;0;0;0
221600020;300;232;241;4;163;135;2;163;5;10;148;0;0;0
221600021;300;319;331;4;227;86;1;213;4;3;206;14;0;14
221600022;200;107;107;5;56;143;1;56;4;0;52;0;0;0
221600023;300;286;286;1;160;139;1;160;4;5;151;0;0;0
221600024;200;154;159;3;107;92;1;107;2;0;105;0;0;0
221600025;100;60;60;5;51;49;0;51;2;1;48;0;0;0
221600026;300;380;388;5;156;174;5;121;4;2;115;35;0;35
221600027;300;447;457;3;204;165;1;134;5;4;125;70;1;69
221600028;100;94;100;2;72;27;1;72;2;0;70;0;0;0
221600029;100;87;92;4;64;35;1;64;4;0;60;0;0;0
221600030;300;345;357;3;195;129;1;170;3;2;165;25;1;24
221600031;300;198;212;3;133;165;2;133;1;0;132;0;0;0
221600032;200;149;151;6;114;85;1;114;2;0;112;0;0;0
221600033;100;52;52;4;39;60;1;39;2;1;36;0;0;0
221600034;100;92;92;2;61;38;1;61;4;3;54;0;0;0
221600035;100;77;77;0;77;22;1;77;0;0;77;0;0;0
221600036;100;54;54;0;54;45;1;54;0;0;54;0;0;0
221600037;100;34;34;12;42;57;1;42;3;0;39;0;0;0
221800001;600;575;575;4;154;474;2;124;5;2;117;30;2;28
221800002;600;610;612;4;162;472;1;127;10;1;116;35;0;35
221800003;700;643;643;8;176;571;1;128;5;3;120;48;2;46
221800004;500;507;511;3;131;399;1;100;7;1;92;31;0;31
221800005;500;506;509;6;113;412;1;87;4;1;82;26;0;26
221800006;600;600;600;2;173;466;2;132;7;0;125;41;0;41
221800007;100;37;37;2;20;79;1;20;1;0;19;0;0;0
221800008;100;92;93;6;39;59;2;39;1;0;38;0;0;0
221800009;100;92;92;6;38;61;1;38;4;0;34;0;0;0
221800010;100;64;64;6;27;72;1;27;1;0;26;0;0;0
221800011;200;125;125;8;37;162;1;37;1;0;36;0;0;0
221800012;100;96;96;4;50;49;1;50;2;1;47;0;0;0
221800013;100;93;93;5;35;64;1;35;1;1;33;0;0;0
221800014;200;176;176;3;66;133;1;66;2;1;63;0;0;0
221800015;100;56;56;4;29;70;1;29;1;1;27;0;0;0
221800016;300;276;276;5;74;224;2;74;7;0;67;0;0;0
221800017;200;156;156;5;73;126;1;73;1;4;68;0;0;0
221800018;200;171;172;4;66;133;1;66;8;0;58;0;0;0
221800019;200;135;135;2;59;140;1;59;3;0;56;0;0;0
221800020;100;53;53;6;33;66;1;33;2;0;31;0;0;0
221800021;100;46;47;6;37;62;1;37;2;0;35;0;0;0
221800022;100;30;30;7;20;79;1;20;2;0;18;0;0;0
222700001;600;532;543;4;292;381;1;218;8;5;205;74;2;72
222700002;700;679;694;5;295;469;1;230;7;5;218;65;1;64
222700003;400;388;391;5;149;280;1;119;4;4;111;30;3;27
222700004;500;459;460;3;191;350;1;149;5;3;141;42;2;40
222700005;500;439;442;3;220;344;1;155;5;4;146;65;5;60
222700006;700;673;688;3;275;525;1;174;2;3;169;101;2;99
222700007;300;220;223;5;111;187;2;111;0;1;110;0;0;0
222700008;300;290;291;3;141;157;2;141;7;5;129;0;0;0
222700009;300;262;264;5;158;141;1;158;2;5;151;0;0;0
222700010;200;129;132;5;84;115;1;84;3;2;79;0;0;0
222700011;1000;933;938;2;464;561;1;438;19;23;396;26;4;22
222700012;800;815;826;1;389;505;1;294;13;4;277;95;3;92
222700013;600;548;556;6;261;432;1;167;6;5;156;94;5;89
222700014;200;121;123;5;69;130;1;69;3;1;65;0;0;0
222700015;100;63;64;5;41;58;1;41;4;1;36;0;0;0
222700016;100;22;22;7;25;74;1;25;0;0;25;0;0;0
222700017;200;187;188;7;103;96;1;103;1;1;101;0;0;0
222700018;200;156;160;4;81;118;1;81;6;1;74;0;0;0
222700019;100;40;40;7;28;71;1;28;0;0;28;0;0;0
222700020;200;192;192;5;156;43;1;156;2;8;146;0;0;0
222700021;200;119;119;7;81;117;2;81;1;2;78;0;0;0
222700022;300;278;284;6;189;110;1;189;13;8;168;0;0;0
222700023;400;340;346;5;170;283;1;116;10;2;104;54;1;53
222700024;200;164;165;7;96;103;1;96;1;1;94;0;0;0
222700025;200;132;133;5;96;103;1;96;3;4;89;0;0;0
222700026;100;93;93;1;93;7;0;93;0;0;93;0;0;0
223100001;600;804;804;4;202;480;1;119;6;6;107;83;3;80
223100002;400;613;613;6;195;209;1;190;1;4;185;5;0;5
223100003;600;907;910;7;280;437;2;161;6;5;150;119;10;109
223100004;200;119;119;7;46;153;1;46;0;0;46;0;0;0
223100005;500;702;703;10;216;374;3;123;5;6;112;93;2;91
223100006;400;627;628;9;226;294;2;104;2;0;102;122;8;114
223100007;300;435;435;8;178;207;1;92;4;2;86;86;5;81
223100008;400;584;584;6;216;297;2;101;1;5;95;115;6;109
223100009;400;504;506;9;209;313;1;86;1;5;80;123;2;121
223100010;400;609;618;9;185;303;1;96;5;3;88;89;3;86
223100011;600;867;867;9;251;416;4;180;11;3;166;71;0;71
223100012;400;538;540;7;209;268;2;130;1;9;120;79;1;78
223100013;300;491;491;9;188;202;1;97;0;1;96;91;4;87
223100014;600;869;870;8;285;453;1;146;2;2;142;139;8;131
223100015;400;620;621;8;162;318;1;81;0;1;80;81;7;74
223100016;500;669;669;8;246;331;1;168;5;2;161;78;3;75
223100017;500;709;711;8;228;395;1;104;5;1;98;124;5;119
223100018;500;753;754;8;249;358;2;140;4;6;130;109;5;104
223100019;500;666;666;9;204;386;1;113;0;3;110;91;3;88
223100020;400;624;626;9;215;290;1;109;4;5;100;106;6;100
223100021;600;770;772;9;242;475;1;124;5;3;116;118;2;116
223100022;500;679;682;6;247;362;2;136;4;1;131;111;7;104
223100023;600;903;903;5;246;466;1;133;2;5;126;113;6;107
223100024;600;796;798;8;245;448;1;151;3;10;138;94;5;89
223100025;400;619;622;9;214;275;1;124;3;3;118;90;2;88
223100026;400;612;614;1;229;237;1;162;1;5;156;67;2;65
223100027;500;683;689;9;243;367;1;132;1;6;125;111;9;102
223100028;500;686;688;7;226;370;1;129;3;5;121;97;8;89
223100029;400;528;528;6;208;282;1;117;3;4;110;91;6;85
223100030;500;630;630;4;211;316;1;183;4;5;174;28;0;28
223100031;400;533;534;9;161;274;1;125;3;6;116;36;0;36
223100032;500;660;661;5;193;365;1;134;8;5;121;59;1;58
223100033;500;674;675;9;231;281;2;217;2;10;205;14;0;14
223100034;400;551;553;5;172;283;1;116;6;4;106;56;4;52
223100035;400;502;503;6;139;271;1;128;5;1;122;11;0;11
223100036;200;306;306;7;75;162;1;37;5;2;30;38;1;37
223100037;500;638;640;9;182;405;2;93;3;1;89;89;5;84
223100038;300;366;366;3;107;229;1;70;2;3;65;37;1;36
223100039;400;510;511;8;183;304;1;95;2;5;88;88;6;82
223100040;400;626;626;9;224;302;1;97;2;1;94;127;2;125
223100041;300;275;275;2;117;182;1;117;10;4;103;0;0;0
223100042;100;100;100;4;60;39;1;60;1;4;55;0;0;0
223100043;100;86;86;8;48;51;1;48;1;2;45;0;0;0
223100044;100;93;93;5;54;45;1;54;0;3;51;0;0;0
223100045;100;99;99;7;56;43;1;56;3;2;51;0;0;0
223100046;300;473;473;3;171;183;1;116;3;9;104;55;1;54
223100047;300;454;457;3;171;209;2;89;0;2;87;82;4;78
223100048;300;256;256;2;124;175;1;124;5;3;116;0;0;0
223100049;200;300;301;4;80;141;1;58;4;2;52;22;0;22
223100050;100;77;77;4;32;68;0;32;2;5;25;0;0;0
223100051;200;161;161;4;76;122;2;76;12;1;63;0;0;0
223100052;100;62;62;3;33;65;2;33;1;1;31;0;0;0
223100053;200;172;172;1;89;110;1;89;5;1;83;0;0;0
223100054;100;101;101;5;47;52;1;47;2;1;44;0;0;0
223100055;100;94;94;3;60;39;1;60;2;0;58;0;0;0
223100056;200;165;165;1;81;118;1;81;2;2;77;0;0;0
223100057;100;65;65;3;26;73;1;26;2;2;22;0;0;0
223100058;100;94;94;4;55;44;1;55;0;0;55;0;0;0
223100059;400;570;570;2;257;199;1;200;4;6;190;57;0;57
223100060;100;74;74;4;49;50;1;49;1;2;46;0;0;0
223100061;100;96;96;5;53;46;1;53;2;2;49;0;0;0
223100062;100;71;71;2;36;63;1;36;3;2;31;0;0;0
223100063;100;85;86;6;35;64;1;35;0;0;35;0;0;0
223100064;100;41;41;5;16;83;1;16;0;1;15;0;0;0
223100065;100;33;33;5;7;92;1;7;0;1;6;0;0;0
223100066;100;92;92;7;44;55;1;44;2;2;40;0;0;0
223100067;200;173;173;5;71;128;1;71;0;3;68;0;0;0
223100068;100;48;48;7;26;73;1;26;0;0;26;0;0;0
223100069;500;668;668;5;185;386;1;113;1;2;110;72;2;70
223100070;600;788;790;7;164;480;1;119;10;2;107;45;2;43
223100071;100;59;59;7;18;80;2;18;1;0;17;0;0;0
223100072;100;41;34;7;16;83;1;16;0;0;16;0;0;0
223100073;100;39;39;7;28;71;1;28;0;1;27;0;0;0
223100074;100;19;20;6;10;89;1;10;1;0;9;0;0;0
223100075;100;72;72;5;24;75;1;24;0;0;24;0;0;0
223100076;200;131;131;5;82;117;1;82;2;3;77;0;0;0
223100077;200;110;110;5;56;143;1;56;0;1;55;0;0;0
223100078;300;277;277;3;97;202;1;97;4;1;92;0;0;0
223100079;100;25;25;0;10;89;1;10;1;1;8;0;0;0
223100080;300;270;271;4;124;175;1;124;3;1;120;0;0;0
223100081;100;44;44;3;28;71;1;28;0;0;28;0;0;0
223100082;100;38;38;8;19;80;1;19;0;0;19;0;0;0
223100083;100;32;32;6;25;74;1;25;1;0;24;0;0;0
223100084;200;135;135;4;49;150;1;49;2;3;44;0;0;0
223100085;100;41;41;8;28;71;1;28;1;0;27;0;0;0
223100086;100;48;48;7;29;70;1;29;0;1;28;0;0;0
223100087;300;369;369;6;171;176;1;123;3;4;116;48;2;46
223100088;100;66;66;7;29;70;1;29;6;0;23;0;0;0
223100089;100;14;14;27;40;59;1;40;2;0;38;0;0;0
223800001;800;828;828;8;311;534;1;265;8;7;250;46;3;43
223800002;700;732;732;1;247;531;1;168;3;3;162;79;1;78
223800003;800;741;743;2;264;654;1;145;4;1;140;119;2;117
223800004;600;633;633;2;203;455;1;144;4;2;138;59;0;59
223800005;700;697;699;1;217;569;1;130;2;1;127;87;10;77
223800006;500;510;510;2;209;323;1;176;18;3;155;33;1;32
223800007;400;421;421;4;117;308;1;91;2;1;88;26;0;26
223800008;100;74;74;2;36;63;1;36;0;2;34;0;0;0
223800009;300;305;305;2;95;204;1;95;6;2;87;0;0;0
223800010;100;85;85;6;45;54;1;45;1;4;40;0;0;0
223800011;100;96;96;5;58;41;1;58;2;1;55;0;0;0
223800012;200;131;131;4;50;149;1;50;0;0;50;0;0;0
223800013;300;292;290;2;130;169;1;130;1;0;129;0;0;0
223800014;100;32;32;5;18;81;1;18;0;0;18;0;0;0
223800015;100;34;34;8;26;73;1;26;1;0;25;0;0;0
223800016;100;17;17;8;13;86;1;13;0;0;13;0;0;0
234602001;500;723;723;16;302;386;1;113;1;1;111;189;3;186
234602002;500;857;858;11;361;351;1;148;1;1;146;213;10;203
234602003;500;760;760;6;319;373;2;125;1;3;121;194;5;189
234602004;500;682;682;21;355;377;1;122;2;4;116;233;6;227
234602005;500;699;699;7;323;365;1;134;3;6;125;189;8;181
234602006;500;579;581;6;244;420;1;79;0;2;77;165;1;164
234602007;500;680;680;11;248;409;1;90;0;2;88;158;9;149
234602008;500;838;838;5;339;359;1;140;0;3;137;191;7;191
234602009;500;824;824;8;338;339;1;160;4;4;152;178;8;170
234602010;500;776;776;15;298;411;2;87;1;0;86;211;9;202
234602011;500;817;818;5;314;410;1;89;5;1;83;225;6;219
234602012;500;731;731;8;283;397;2;103;1;4;96;180;8;172
234602013;500;807;807;10;377;337;4;159;2;8;149;218;13;205
234602014;500;762;762;6;356;371;1;128;3;2;123;228;6;222
234602015;500;703;703;6;295;371;4;125;3;2;120;170;3;167
234602016;500;784;784;5;385;341;1;158;6;6;146;227;8;219
234602017;500;790;790;9;360;348;1;151;2;4;145;209;7;202
234602018;500;903;905;4;404;363;2;135;0;3;132;269;7;262
234602019;500;762;762;11;334;354;2;144;3;3;138;190;10;180
234602020;500;907;907;11;424;360;1;139;6;3;130;285;6;279
234602021;500;697;710;47;344;334;3;163;5;5;153;181;7;174
234602022;500;747;748;5;370;371;1;128;4;6;118;242;16;226
234602023;500;805;806;7;305;389;2;109;0;0;109;196;6;190
234602024;500;727;727;5;297;395;1;104;1;2;101;193;5;188
234602025;500;758;758;4;298;394;1;105;0;2;103;193;4;189
234602026;500;823;824;5;381;324;4;172;3;5;164;209;13;196
234602027;500;848;848;7;358;348;6;146;6;3;137;212;8;204
234602028;500;795;796;9;331;369;2;129;0;2;127;202;8;194
234602029;500;968;968;7;397;357;1;142;2;2;138;255;10;245
234602030;500;910;910;14;418;363;1;136;5;3;128;282;11;271
234602031;500;865;867;14;370;367;2;131;3;8;120;239;14;225
234602032;500;896;896;11;373;350;1;149;3;7;139;224;7;217
234602033;500;747;747;8;282;365;1;134;3;1;130;148;9;139
234602034;500;812;812;5;344;327;2;171;2;6;163;173;7;166
234602035;500;785;785;19;261;391;1;108;0;5;103;153;3;150
234602036;500;741;741;11;320;368;3;129;2;6;121;191;10;181
234602037;500;725;725;6;274;382;2;116;5;2;109;158;1;157
234602038;500;751;751;14;308;390;9;101;8;2;91;207;11;196
234602039;500;809;809;4;292;386;3;111;3;5;103;181;9;172
234602040;500;736;737;9;272;392;1;107;2;2;103;165;2;163
234602041;500;896;896;7;339;365;2;133;4;5;124;206;8;198
234602042;500;731;731;6;286;372;2;126;2;5;119;160;3;157
234602043;500;898;900;6;422;369;1;130;2;4;124;292;6;286
234602044;500;678;680;10;250;392;1;107;2;7;98;143;8;135
234602045;500;785;785;5;326;357;1;142;3;6;133;184;9;175
234602046;500;756;756;4;299;377;1;122;3;2;117;177;4;173
234602047;500;747;747;7;287;378;1;121;4;1;116;166;4;162
234602048;500;849;849;5;391;360;1;139;1;2;136;250;13;236
234602049;500;877;878;3;377;380;1;119;2;6;111;258;10;248
234602050;500;738;755;6;257;408;7;85;2;1;82;172;8;164
234602051;500;691;691;11;282;409;0;91;0;6;85;191;9;182
234602052;500;712;712;5;262;387;1;112;0;5;107;150;9;141
234602053;500;566;566;5;234;409;1;90;4;5;81;144;6;138
234602054;500;652;652;8;271;402;1;97;4;1;92;174;11;163
234602055;500;949;949;6;488;267;2;231;14;89;128;257;12;245
234602056;500;900;901;10;364;323;1;176;3;2;171;188;3;185
234602057;500;789;789;9;345;379;1;120;0;1;119;225;11;214
234602058;500;737;737;16;303;355;1;144;3;5;136;159;7;152
234602059;500;808;808;7;338;344;2;154;4;3;147;184;5;179
234602060;500;781;781;6;324;368;1;131;2;2;127;193;9;184
234602061;500;817;818;5;330;396;1;103;1;3;99;227;8;219
234602062;500;962;962;6;412;324;1;175;2;5;168;235;13;222
234602063;500;803;803;7;327;355;1;144;3;2;139;183;11;172
234602064;500;784;785;7;282;388;5;107;5;2;100;175;11;164
234602065;500;843;844;11;329;372;1;127;5;5;117;202;3;199
234602066;500;798;798;13;330;348;1;151;1;5;145;179;7;172
234602067;500;795;796;7;336;368;1;131;1;3;127;205;6;199
234602068;500;731;731;6;298;380;4;116;7;2;107;182;2;180
234602069;500;881;882;6;376;357;2;141;1;7;133;235;7;228
234602070;500;699;702;7;311;384;2;114;2;2;110;197;4;193
234602071;500;723;723;8;290;375;5;120;1;2;117;170;9;161
234602072;500;831;839;7;363;192;1;307;5;11;291;56;2;54
234602073;500;954;954;4;422;354;1;145;0;3;142;277;10;267
234602074;500;827;828;7;338;363;1;136;1;1;134;202;12;190
234602075;500;826;826;8;366;356;1;143;0;5;138;223;9;214
234602076;500;843;846;5;321;399;1;100;2;3;95;221;7;214
234602077;500;769;769;5;299;399;2;99;0;4;95;200;10;190
234602078;500;601;602;5;221;399;1;100;3;5;92;121;1;120
234602079;500;761;761;6;257;398;2;100;2;1;97;157;8;149
234602080;500;936;937;4;363;332;1;167;3;4;160;196;9;187
234602081;500;766;767;6;281;398;1;101;1;3;97;180;5;175
234602082;500;740;741;8;290;407;1;92;1;3;88;198;8;190
234602083;500;769;770;10;427;263;2;235;1;116;118;192;12;180
234602084;500;817;818;8;365;375;2;123;1;4;118;242;9;233
234602085;500;888;888;9;368;366;5;129;3;5;121;239;11;228
234602086;500;653;653;7;230;411;1;88;4;3;81;142;3;139
234602087;500;746;746;4;298;392;1;107;0;0;107;191;2;189
234602088;500;820;823;5;363;373;1;126;1;4;121;237;3;234
234602089;500;300;725;10;310;381;1;118;6;3;109;192;7;185
234602090;500;930;931;11;412;349;2;149;1;9;139;263;12;251
234602091;500;758;759;5;316;395;0;105;4;6;95;211;6;205
234602092;500;841;843;6;379;361;4;135;1;4;130;244;8;236
234602093;505;49;49;130;179;319;7;179;5;8;166;0;0;0
234602094;200;110;110;36;78;121;1;78;1;1;76;0;0;0
234602095;100;51;51;10;58;42;0;58;0;0;58;0;0;0
234608001;500;618;620;7;282;376;2;122;0;4;118;160;2;158
234608002;500;514;514;6;220;446;1;54;4;2;48;166;3;163
234608003;500;674;675;8;290;400;2;98;2;3;93;192;3;189
234608004;500;889;890;6;431;384;1;115;0;5;110;316;8;308
234608005;500;722;722;4;351;398;1;101;0;3;98;250;7;243
234608006;500;758;758;8;401;384;1;115;2;9;104;286;6;280
234608007;500;879;879;7;401;350;1;149;2;4;143;252;15;237
234608008;500;747;747;7;310;391;2;107;0;7;100;203;12;191
234608009;500;685;686;6;346;376;3;121;4;2;115;225;9;216
234608010;500;629;629;8;266;427;3;70;1;1;68;196;12;184
234608011;500;626;626;5;302;202;1;297;3;12;282;5;0;5
234608012;500;669;669;5;274;387;1;112;5;2;105;162;9;153
234608013;500;668;672;6;239;421;4;75;0;2;73;164;7;157
234608014;500;579;581;8;244;423;1;76;2;2;72;168;8;160
234608015;500;520;521;16;179;437;2;61;1;2;58;118;0;118
234608016;500;752;756;14;221;404;1;95;2;3;90;126;9;117
234608017;500;512;512;11;237;444;1;55;2;1;52;182;3;179
234608018;500;723;723;5;289;399;2;99;2;5;92;190;7;183
234608019;500;730;730;3;252;402;3;95;2;0;93;157;4;153
234608020;500;541;607;3;214;348;2;150;1;5;144;64;1;63
234608021;500;588;588;6;232;385;2;113;1;2;110;119;3;116
234608022;500;656;657;6;192;443;1;56;0;0;56;136;8;128
234608023;500;732;732;6;228;360;1;139;2;12;125;89;1;88
234608024;500;679;679;5;224;358;6;136;5;4;127;88;8;80
234608025;500;517;519;23;179;432;1;67;1;1;65;112;6;106
234608026;500;470;470;6;229;407;2;91;1;2;88;138;10;128
234608027;500;368;839;3;371;345;4;155;4;5;146;217;5;212
234608028;500;651;651;8;309;380;3;117;3;7;107;192;8;184
234608029;500;632;632;6;284;403;2;95;1;6;88;189;6;183
234608030;500;632;633;5;264;403;2;95;1;1;93;169;7;162
234608031;500;457;457;12;161;453;1;46;2;0;44;115;4;111
234608032;500;145;543;8;152;449;1;50;0;0;50;102;5;97
234608033;500;659;660;6;283;400;1;99;1;4;94;184;7;177
234608034;500;585;585;18;275;418;2;80;1;3;76;195;8;187
234608035;500;817;818;10;331;343;1;156;4;3;149;175;7;168
234608036;500;567;567;4;230;414;1;85;0;3;82;145;3;142
234608037;500;734;735;6;281;397;2;101;0;2;99;180;7;173
234608038;500;967;970;5;364;370;1;129;5;4;120;235;12;223
234608039;500;747;750;5;331;381;4;115;4;2;109;216;7;209
234608040;500;737;739;8;345;372;1;127;2;3;122;218;6;212
234608041;500;651;651;6;294;416;1;83;3;1;79;211;11;200
234608042;500;814;814;8;366;350;1;149;0;5;144;217;6;211
234608043;500;746;747;16;199;425;1;74;0;1;73;125;2;123
234608044;500;711;712;6;324;376;1;123;9;5;109;201;12;189
234608045;500;521;521;10;243;441;1;58;1;3;54;185;7;178
234608046;500;59;59;72;91;407;2;91;2;9;80;0;0;0
234608047;400;62;62;25;58;341;1;58;1;2;55;0;0;0
234608048;500;182;182;39;198;301;1;198;12;12;174;0;0;0
234608049;100;27;27;4;29;70;1;29;0;0;29;0;0;0
234609001;500;713;714;20;335;386;1;113;5;1;107;222;22;200
234609002;500;616;616;6;259;421;1;78;3;1;74;181;7;174
234609003;0;619;619;7;264;418;1;81;0;3;78;183;5;178
234609004;500;551;553;8;239;426;1;73;0;0;73;166;7;159
234609005;500;640;659;15;314;406;1;93;1;1;91;221;10;211
234609006;500;646;646;8;299;381;1;118;3;0;115;181;2;179
234609007;500;651;651;7;281;400;1;99;1;3;95;181;10;180
234609008;500;690;690;13;350;371;2;127;8;1;118;223;12;211
234609009;500;719;720;6;346;387;3;110;1;2;107;236;3;233
234609010;500;688;688;11;330;378;1;121;3;4;114;209;1;208
234609011;500;605;605;7;260;416;1;83;1;0;82;177;4;173
234609012;500;652;652;7;349;171;7;322;3;11;309;27;0;27
234609013;500;675;697;12;326;404;2;94;1;4;89;232;7;225
234609014;500;701;701;7;314;392;1;107;2;2;103;207;4;203
234609015;500;550;550;4;258;414;1;85;2;1;82;173;4;169
234609016;500;712;712;5;343;391;1;108;1;3;104;235;8;227
234609017;500;716;716;10;316;407;4;89;1;2;86;227;7;220
234609018;500;706;706;6;326;399;1;100;0;1;99;226;13;213
234609019;500;533;533;7;235;409;1;90;4;3;83;145;0;145
234609020;500;541;541;13;250;408;1;91;2;4;85;159;2;157
234609021;500;555;555;11;250;411;1;88;3;4;81;162;7;155
234609022;500;572;572;10;264;407;1;92;1;3;88;172;4;168
234609023;500;672;673;6;321;393;1;106;0;2;104;215;10;205
234609024;500;687;687;10;293;404;0;96;4;3;89;197;6;191
234609025;500;628;628;10;287;397;7;96;1;2;93;191;3;188
234609026;500;646;646;18;330;401;1;98;1;3;94;232;5;227
234609027;500;657;657;5;283;407;2;91;3;0;88;192;5;187
234609028;500;771;771;8;325;393;1;106;2;3;101;219;11;208
234609029;500;726;726;8;344;361;1;138;0;2;136;206;6;200
234609030;500;551;551;6;243;432;2;66;1;2;63;177;4;173
234609031;500;619;619;6;275;411;4;85;2;3;80;190;8;182
234609032;500;556;556;8;232;423;2;75;1;0;74;157;7;150
234609033;500;446;446;5;179;430;1;69;0;2;67;110;2;108
234609034;500;694;694;6;278;414;5;81;0;2;79;197;5;192
234609035;500;548;548;8;254;417;2;81;0;2;79;173;3;170
234609036;500;613;613;9;281;402;1;97;1;4;92;184;11;173
234609037;500;451;451;6;205;454;1;45;0;1;44;160;10;150
234609038;500;534;534;8;261;374;2;124;2;5;117;137;5;132
234609039;500;559;559;8;241;397;1;102;2;6;94;139;8;131
234609040;500;606;606;6;266;416;2;82;0;1;81;184;7;177
234609041;500;688;689;9;331;374;1;125;1;4;120;206;4;202
234609042;500;586;586;19;264;411;1;88;4;0;84;176;6;170
234609043;500;486;486;7;223;416;3;81;2;0;79;142;7;135
234609044;500;707;707;5;335;366;1;133;0;4;129;202;10;192
234609045;500;717;717;23;362;381;1;118;3;4;111;244;10;234
234609046;500;727;727;10;338;389;1;110;0;2;108;228;8;220
234609047;500;546;547;12;235;407;5;88;5;1;82;147;7;140
234609048;500;635;635;5;249;418;1;81;0;1;80;168;7;161
234609049;500;653;654;8;289;385;1;114;1;4;109;175;1;174
234609050;500;635;635;8;276;391;1;108;1;6;101;168;9;159
234609051;500;650;650;5;310;389;1;110;2;3;105;200;9;191
234609052;500;465;465;15;216;381;1;118;0;7;111;98;5;93
234609053;500;643;657;7;251;363;2;135;1;5;129;116;6;110
234609054;500;665;681;7;280;407;0;93;2;3;88;187;8;179
234609055;500;609;609;10;269;419;1;80;1;2;77;189;6;183
234609056;500;619;620;6;300;388;2;110;1;4;105;190;7;183
234609057;500;540;540;6;224;442;2;56;1;3;52;168;8;160
234609058;500;622;622;10;310;427;1;72;0;3;69;238;9;229
234609059;500;552;562;5;256;432;1;67;0;5;62;189;10;179
234609060;800;1116;1116;6;514;675;2;123;1;0;122;391;10;381
234609061;500;775;775;5;306;430;1;69;2;2;65;237;11;226
234609062;500;692;692;5;339;421;1;78;1;1;76;261;11;250
234609063;500;748;748;12;370;293;1;206;1;12;193;164;4;160
234609064;500;758;758;8;306;441;4;55;1;1;53;251;10;241
234609065;600;913;913;8;405;509;2;89;0;0;89;316;22;294
234609066;700;1014;1014;5;384;598;1;101;1;2;98;283;15;268
234609067;500;554;554;5;233;412;1;87;1;0;86;146;5;141
234609068;500;766;766;4;330;410;3;87;2;1;84;243;6;237
234609069;500;628;628;5;296;413;1;86;7;5;74;210;9;201
234609070;500;524;525;9;220;356;1;143;2;5;136;77;4;73
234609071;500;526;526;8;249;404;3;93;0;2;91;156;4;152
234609072;500;700;700;5;312;399;3;98;0;3;95;214;9;205
234609073;500;570;570;4;268;427;1;72;0;4;68;196;10;186
234609074;600;986;986;14;418;515;1;84;3;1;80;334;15;319
234609075;700;1030;1030;7;480;584;1;115;0;4;111;365;16;349
234609076;500;621;622;7;280;418;1;81;0;4;77;199;12;187
234609077;700;1068;1068;6;429;629;2;69;0;2;67;360;9;351
234609078;500;508;508;8;224;409;3;88;1;0;87;136;3;133
234609079;500;355;355;6;160;458;2;40;1;2;37;120;5;115
234609080;500;464;464;92;113;386;1;113;1;3;109;0;0;0
234609081;500;31;31;23;43;456;1;43;3;3;37;0;0;0
234610001;500;486;486;54;251;380;2;118;3;2;113;133;3;130
234610002;500;443;443;11;174;435;1;64;0;1;63;110;0;110
234610003;500;670;670;5;246;402;4;94;4;1;89;152;6;146
234610004;500;475;475;6;171;451;1;48;0;2;46;123;4;119
234610005;500;459;459;5;158;462;1;37;2;1;34;121;2;119
234610006;500;468;468;7;182;429;1;70;1;1;68;112;2;110
234610007;500;567;567;7;210;430;1;69;1;1;67;141;3;138
234610008;500;568;568;5;215;303;2;195;0;3;192;20;0;20
234610009;500;396;396;6;143;368;1;131;2;7;122;12;0;12
234610010;500;547;547;6;232;266;4;230;1;13;216;2;0;2
234610011;500;394;394;6;160;455;1;44;0;0;44;116;2;114
234610012;500;368;368;7;156;443;1;56;0;2;54;100;2;98
234610013;500;577;577;7;230;417;1;82;0;6;76;148;2;146
234610014;500;511;511;6;183;447;1;52;0;0;52;131;5;126
234610015;500;387;388;4;148;441;1;58;2;3;53;90;4;86
234610016;500;519;521;8;235;427;1;72;1;2;69;163;5;158
234610017;500;481;481;6;199;417;1;82;3;4;75;117;4;113
234610018;500;594;594;8;229;402;2;96;2;0;94;133;5;128
234610019;500;752;753;8;269;415;2;83;0;2;81;186;4;182
234610020;500;529;529;4;219;441;1;58;0;2;56;161;2;159
234610021;500;458;458;4;177;351;2;147;1;3;143;30;2;28
234610022;500;587;588;6;231;407;1;91;1;2;88;140;3;137
234610023;500;610;610;19;298;396;4;100;3;4;93;198;13;185
234610024;500;647;648;4;251;406;1;93;2;2;89;158;6;152
234610025;500;565;566;4;232;421;1;78;0;1;77;154;4;150
234610026;500;496;497;10;203;430;1;69;2;2;65;134;7;127
234610027;500;658;659;5;247;407;2;91;1;0;90;156;5;151
234610028;500;741;741;4;321;380;1;119;0;8;111;202;7;195
234610029;500;516;516;7;219;414;1;85;0;1;84;134;6;128
234610030;500;629;629;4;311;381;2;117;6;5;106;194;6;188
234610031;500;422;452;5;204;434;1;65;0;1;64;139;6;133
234610032;500;285;603;5;290;384;2;114;4;4;106;176;6;170
234610033;500;651;651;10;279;390;1;109;2;1;106;170;4;166
234610034;500;724;724;9;289;423;1;76;2;0;74;213;5;208
234610035;500;613;614;6;300;389;3;108;3;2;103;192;9;183
234610036;500;743;743;4;320;383;1;116;2;8;106;204;16;188
234610037;500;504;504;8;212;426;3;71;1;2;68;141;16;125
234610038;500;694;587;7;266;237;2;261;3;11;247;5;0;5
234610039;500;631;633;10;251;408;1;91;0;3;88;160;4;156
234610040;500;657;657;3;301;395;1;104;3;1;100;197;1;196
234610041;500;518;519;4;235;421;1;78;0;2;76;157;4;153
234610042;500;485;485;9;221;420;1;79;2;5;72;142;1;141
234610043;500;693;696;5;332;359;1;141;3;11;127;196;12;182
234610044;731;731;731;9;398;544;7;180;6;7;167;218;18;200
234610045;500;725;725;8;325;392;2;106;1;1;104;219;7;212
234610046;500;697;698;6;336;380;2;118;2;7;109;218;8;210
234610047;500;468;468;10;201;439;1;60;0;0;60;141;7;134
234610048;500;596;596;6;254;385;1;114;4;3;107;140;2;138
234610049;500;229;498;16;227;403;4;93;4;3;86;134;7;127
234610050;500;672;672;7;311;360;1;139;5;2;132;172;7;165
234610051;500;644;645;4;293;360;1;139;2;6;131;154;6;148
234610052;500;543;543;14;268;400;7;93;7;4;82;175;10;165
234610053;500;844;824;20;414;345;2;153;1;9;143;261;7;254
234610054;500;719;720;6;356;380;1;119;1;12;106;237;12;225
234610055;500;753;754;5;308;378;1;121;3;3;115;187;6;181
234610056;500;816;816;11;313;376;1;123;6;5;112;190;8;182
234610057;500;876;876;7;368;318;1;181;0;11;170;187;16;171
234610058;500;655;655;7;236;406;1;93;0;0;93;143;9;134
234610059;500;759;759;7;305;371;1;128;2;3;123;177;5;172
234610060;500;765;769;8;313;391;2;107;3;2;102;206;9;197
234610061;500;578;579;5;220;419;1;80;2;2;76;140;5;135
234610062;500;594;596;10;244;405;4;91;3;4;84;153;13;140
234610063;500;661;662;4;307;405;6;89;5;3;81;218;8;210
234610064;500;534;534;7;227;371;2;127;1;6;120;100;3;97
234610065;500;525;525;11;218;335;1;164;1;3;160;54;3;51
234610066;500;418;418;7;228;423;1;76;0;5;71;152;6;146
234610067;500;560;560;7;206;428;2;70;0;2;68;136;5;131
234610068;500;590;590;16;253;405;1;96;6;4;86;165;3;162
234610069;500;608;609;5;251;409;0;91;2;1;88;160;15;145
234610070;500;583;583;9;254;408;2;90;1;1;88;164;9;155
234610071;500;754;754;7;307;413;1;86;0;1;85;221;6;215
234610072;500;650;650;7;291;383;3;114;1;3;110;177;10;167
234610073;500;583;584;7;249;416;1;83;0;3;80;166;7;159
234610074;500;747;747;3;293;403;1;96;1;2;93;197;7;190
234610075;500;555;555;4;272;400;1;99;4;1;94;173;8;165
234610076;500;780;780;7;285;392;2;106;0;3;103;179;4;175
234610077;500;896;896;4;287;368;1;131;1;12;118;156;3;148
234610078;500;614;614;16;235;400;2;98;3;2;93;137;9;128
234610079;500;552;552;7;218;427;2;71;1;3;67;147;6;141
234610080;500;538;538;8;233;419;1;80;2;1;77;153;6;147
234610081;500;538;538;9;233;425;0;75;3;5;67;158;6;152
234610082;500;654;654;9;288;412;1;87;2;0;85;201;4;197
234610083;500;629;629;7;322;382;0;118;2;6;110;204;7;197
234610084;500;456;456;8;193;432;2;66;1;1;64;127;10;117
234610085;500;771;771;5;329;394;1;105;2;0;103;224;9;215
234610086;500;709;709;6;263;418;1;81;2;7;72;182;3;179
234610087;500;493;493;6;188;441;1;58;0;0;58;130;11;119
234610088;500;735;737;9;288;413;1;86;1;0;85;202;5;197
234610089;500;468;468;7;148;434;1;65;1;0;64;83;2;81
234610090;500;544;544;4;240;422;1;77;0;1;76;163;8;155
234610091;500;793;793;3;340;442;1;57;0;0;57;283;7;276
234610092;500;801;801;10;357;439;0;61;1;2;58;296;12;284
234610093;500;639;639;3;297;432;1;67;0;3;64;230;10;220
234610094;500;815;815;6;338;431;3;66;2;3;61;272;5;267
234610095;500;504;504;5;171;435;1;64;3;2;59;107;3;104
234610096;500;699;699;6;304;409;1;90;5;2;83;214;13;201
234610097;500;749;749;4;344;425;1;74;0;3;71;270;15;255
234610098;500;625;625;6;265;423;1;76;2;3;71;189;6;183
234610099;500;911;911;7;355;144;1;355;1;13;341;0;0;0
234610100;500;962;962;10;329;407;1;92;3;2;87;237;8;229
234610101;500;944;944;5;394;436;1;63;2;2;59;331;11;320
234610102;500;648;648;7;311;409;2;89;2;4;83;222;9;213
234610103;500;917;917;5;356;394;2;104;2;7;95;252;12;240
234610104;100;24;24;23;26;73;1;26;0;0;26;0;0;0
234610105;100;25;25;33;45;54;1;45;1;5;39;0;0;0
234610106;200;79;79;19;40;159;1;40;6;1;33;0;0;0
234610107;100;36;36;46;55;42;3;55;0;3;52;0;0;0
234610109;200;148;148;58;66;133;1;66;1;6;59;0;0;0
234610111;200;70;70;37;43;155;2;43;1;5;37;0;0;0
234610112;600;454;454;56;60;536;4;60;2;4;54;0;0;0
234610113;1000;736;736;155;195;804;1;195;3;9;183;0;0;0
234610115;100;13;13;69;68;30;2;68;2;2;64;0;0;0
234610116;100;14;14;21;25;74;1;25;2;0;23;0;0;0
234610117;100;17;17;32;49;51;0;49;2;1;46;0;0;0
234610118;100;41;41;9;49;48;3;49;3;2;44;0;0;0
234615001;500;652;652;47;286;391;1;108;2;0;106;178;10;168
234615002;500;681;681;5;251;412;1;87;1;1;85;164;13;151
234615003;500;811;811;5;382;384;1;115;1;2;112;267;6;261
234615004;500;729;730;5;273;398;1;101;1;4;96;172;15;157
234615005;500;618;619;6;221;420;1;79;2;4;73;142;2;140
234615006;500;673;673;5;234;419;4;77;3;1;73;157;5;152
234615007;500;513;514;5;183;447;1;52;1;5;46;131;7;124
234615008;500;783;783;8;296;386;1;113;5;3;105;183;4;179
234615009;500;811;811;7;331;389;2;109;1;4;104;222;6;216
234615010;500;770;770;5;310;406;1;93;4;4;85;217;6;211
234615011;500;803;803;6;283;385;1;114;0;5;109;169;6;163
234615012;500;760;761;5;313;389;5;106;3;4;99;207;10;197
234615013;500;921;923;7;424;384;1;115;2;6;107;309;11;298
234615014;500;567;568;4;191;436;2;62;2;4;56;129;8;121
234615015;500;591;591;11;250;388;5;107;0;3;104;143;5;138
234615016;500;658;658;10;239;305;1;194;2;7;185;45;2;43
234615017;500;750;754;8;289;266;2;232;2;8;222;57;3;54
234615018;500;705;708;5;261;402;5;93;0;1;92;168;0;168
234615019;500;640;642;8;264;415;2;83;2;1;80;181;5;176
234615020;500;610;610;4;285;359;1;140;1;6;133;145;4;141
234615021;500;828;828;7;378;362;6;132;5;4;123;246;8;238
234615022;500;703;704;9;276;406;1;93;3;4;86;183;12;171
234615023;500;847;850;1;349;287;1;212;0;7;205;137;34;103
234615024;500;733;734;9;269;408;2;90;1;2;87;179;12;167
234615025;500;771;771;7;308;378;2;120;6;9;105;188;7;181
234615026;500;870;870;10;298;381;2;117;2;6;109;181;10;171
234615027;500;563;564;11;222;419;1;80;2;0;78;142;2;140
234615028;500;564;565;15;236;421;1;78;1;2;75;158;6;152
234615029;500;619;620;9;240;420;1;79;0;7;72;161;11;150
234615030;500;550;552;3;246;392;1;107;0;2;105;139;13;126
234615031;500;781;783;6;327;365;2;133;5;6;122;194;8;186
234615032;500;619;619;5;257;382;5;113;5;2;106;144;7;137
234615033;500;584;584;6;200;431;1;68;3;3;62;132;6;126
234615034;500;697;698;4;309;356;1;143;4;4;135;166;13;153
234615035;500;622;623;5;255;403;1;96;2;1;93;159;4;155
234615036;500;556;557;5;152;445;1;54;2;2;50;98;5;93
234615037;500;819;819;9;349;393;1;106;0;3;103;243;10;233
234615038;500;925;927;4;331;348;1;151;2;0;149;180;10;170
234615039;500;837;816;7;350;150;1;349;5;9;158;166;8;158
234615040;500;680;680;6;242;414;1;85;4;1;80;157;7;150
234615041;500;821;823;821;360;350;1;149;3;7;146;212;6;206
234615042;500;795;796;9;322;380;1;119;0;4;115;203;6;197
234615043;500;718;718;4;256;405;4;91;5;4;82;165;6;159
234615044;500;603;603;16;295;403;1;96;0;2;94;199;6;193
234615045;500;823;824;6;318;350;4;146;4;0;142;172;12;160
234615046;500;926;927;5;386;351;1;148;3;6;139;238;10;228
234615047;500;840;840;3;403;431;1;68;1;3;64;335;17;318
234615048;500;890;891;5;366;349;1;150;1;3;146;216;9;207
234615049;500;863;864;31;374;337;1;162;7;4;151;212;12;200
234615050;500;814;815;2;324;359;2;139;3;2;134;185;5;180
234615051;500;762;792;6;292;364;9;127;11;2;114;165;3;162
234615052;800;968;968;5;412;386;2;412;3;13;396;0;0;0
234615053;500;856;856;9;337;372;1;127;3;3;121;210;13;197
234615054;500;810;810;6;307;341;1;158;3;3;152;149;5;144
234615055;500;786;786;2;352;395;2;103;1;6;96;249;9;240
234615056;500;878;879;4;335;367;1;132;5;4;123;203;5;198
234615057;500;692;692;6;266;370;1;129;1;3;125;137;4;133
234615058;500;912;912;4;390;376;1;123;3;3;117;267;8;259
234615059;500;686;686;10;282;409;3;88;2;2;84;194;6;188
234615060;500;740;741;4;265;388;0;112;4;6;102;153;6;147
234615061;500;775;790;6;372;382;1;117;5;4;108;255;8;247
234615062;500;671;673;4;241;400;1;99;2;1;96;142;10;132
234615063;500;536;536;14;216;423;1;76;1;6;69;140;5;135
234615064;500;639;640;6;254;385;1;114;1;6;107;140;9;131
234615065;500;672;673;5;264;402;1;97;1;5;91;167;9;158
234615066;500;643;645;4;229;418;2;80;0;0;80;149;2;147
234615067;500;703;704;4;250;383;1;116;1;5;110;134;8;126
234615068;500;637;637;5;268;397;1;102;2;2;98;166;8;158
234615069;500;767;768;7;337;363;1;136;8;6;122;201;6;195
234615070;500;752;753;2;292;249;1;250;1;13;236;42;1;41
234615071;500;753;753;4;334;352;2;146;1;5;140;188;5;183
234615072;500;785;785;3;311;364;1;135;3;2;130;176;15;161
234615073;500;623;624;5;169;434;2;64;0;2;62;105;2;103
234615074;500;556;556;5;205;422;1;77;3;6;68;128;3;125
234615075;500;587;568;19;204;413;2;85;5;2;78;119;4;115
234615076;500;759;763;8;238;371;1;128;3;2;123;110;3;107
234615077;500;767;768;5;270;384;1;115;5;2;108;155;6;149
234615078;500;626;627;6;232;411;1;88;4;4;80;144;4;140
234615079;500;646;646;4;198;406;1;93;0;1;92;105;5;100
234615080;500;607;608;6;211;423;2;75;1;4;70;136;5;131
234615081;500;632;632;5;208;374;2;124;2;3;119;84;2;82
234615082;500;882;885;5;370;387;1;112;2;2;108;258;9;249
234615083;500;776;776;5;295;383;3;114;1;2;111;181;16;165
234615084;500;684;684;5;252;392;1;107;1;1;105;145;11;134
234615085;500;712;713;5;282;346;1;153;0;4;149;129;7;122
234615086;500;855;883;7;378;348;1;151;1;4;146;227;15;212
234615087;500;700;702;8;307;381;1;118;3;3;112;189;11;178
234615088;500;788;790;5;358;383;0;117;2;3;112;241;12;229
234615089;500;611;613;4;221;408;1;91;4;2;85;130;4;126
234615090;500;575;575;11;227;406;1;93;4;2;87;134;8;126
234615091;500;582;582;7;246;398;1;101;0;4;97;145;5;140
234615092;500;987;987;5;417;313;1;186;4;6;176;231;9;222
234615093;500;640;641;11;224;405;1;94;0;2;92;130;8;122
234615094;500;527;527;46;231;397;2;101;5;1;95;130;6;124
234615095;500;752;752;7;298;334;2;164;0;5;159;134;9;125
234615096;500;582;582;6;230;429;1;70;0;1;69;160;5;155
234615097;500;705;705;7;227;401;1;98;2;6;90;129;0;129
234615098;500;405;887;5;405;341;1;158;2;6;150;247;8;239
234615099;500;759;759;3;296;401;1;98;2;1;95;198;3;195
234615100;500;914;914;6;371;335;1;164;1;8;155;207;13;194
234615101;500;840;841;7;349;403;1;96;2;2;92;253;6;247
234615102;500;904;905;4;357;217;1;282;0;9;273;75;4;71
234615103;500;670;670;4;225;441;2;57;3;1;53;168;1;167
234615104;500;653;655;8;186;431;3;66;2;2;62;120;4;116
234615105;500;741;744;2;213;424;1;75;1;0;74;138;2;136
234615106;500;677;677;7;247;390;1;109;0;0;109;138;4;134
234615107;500;609;609;5;193;421;1;78;1;2;75;115;11;104
234615108;500;537;537;3;178;424;1;75;2;1;72;103;4;99
234615109;500;623;624;6;197;421;1;78;3;4;71;119;7;112
234615110;500;848;871;5;326;261;0;239;10;15;214;87;4;83
234615111;500;741;741;4;234;268;3;229;3;12;214;5;1;4
234615112;500;876;876;7;297;409;1;90;1;0;89;207;9;198
234615113;500;943;944;6;351;424;1;75;1;1;73;276;11;265
234615114;500;815;816;5;214;415;4;81;0;2;79;133;10;123
234615115;500;735;736;7;219;348;1;151;0;6;145;68;4;64
234615116;500;984;985;4;381;355;2;143;3;11;129;238;10;228
234615117;500;924;925;2;360;393;4;103;3;1;99;257;11;246
234615118;500;580;581;7;215;422;2;76;4;0;72;139;2;137
234615119;500;760;761;6;260;385;2;113;2;4;107;147;9;138
234615120;500;806;807;3;272;386;1;113;3;6;104;159;10;149
234615121;500;736;745;4;219;405;1;94;4;2;88;125;2;123
234615122;500;938;938;4;253;373;3;124;3;5;116;129;9;120
234615123;500;863;864;3;269;398;1;101;5;5;91;168;6;162
234615124;500;725;726;3;175;406;1;93;0;1;92;82;5;77
234615125;500;579;579;3;155;411;11;78;3;3;72;77;3;74
234615126;400;97;97;99;116;283;1;116;5;5;106;0;0;0
234615127;100;32;32;7;39;60;1;39;1;0;38;0;0;0
234616001;500;573;574;27;245;434;1;65;1;1;63;180;13;167
234616002;500;433;433;151;355;333;2;165;2;13;150;190;11;179
234616003;500;540;540;126;414;427;1;72;0;6;66;342;21;321
234616004;500;695;695;80;408;367;6;127;4;3;120;281;9;272
234616005;500;601;601;149;429;421;1;78;1;3;74;351;18;333
234616006;500;610;610;149;410;421;2;77;0;7;70;333;23;310
234616007;500;793;794;65;408;391;1;108;3;0;105;300;8;292
234616008;500;545;545;48;325;390;1;109;1;5;103;216;3;213
234616009;500;787;787;72;392;409;1;90;2;1;87;302;20;282
234616010;500;442;442;8;213;428;2;70;1;0;69;143;5;138
234616011;500;330;330;12;130;440;2;58;2;0;56;72;0;72
234616012;500;513;514;4;173;436;1;63;1;0;62;110;4;106
234616013;500;518;521;7;191;424;2;74;0;3;71;117;10;107
234616014;500;449;449;7;187;439;1;60;1;0;59;127;11;116
234616015;500;350;350;10;161;416;2;82;0;3;79;79;3;76
234616016;500;615;616;5;254;393;5;102;4;4;94;152;7;145
234616017;500;504;504;22;193;435;1;64;2;1;61;129;5;124
234616018;500;728;728;7;332;404;5;91;2;1;88;241;12;229
234616019;500;617;618;7;299;402;1;97;1;1;95;202;9;193
234616020;500;454;454;6;185;426;1;73;2;0;71;112;1;111
234616021;500;823;824;5;390;397;1;102;1;4;97;288;7;281
234616022;500;496;512;6;223;438;2;60;0;2;58;163;6;157
234616023;500;735;735;6;277;406;2;92;2;5;85;185;6;179
234616024;500;395;395;5;170;444;1;55;2;1;52;115;5;110
234616025;500;480;481;4;195;415;1;84;4;2;78;111;3;108
234616026;500;510;512;5;178;428;8;64;1;5;58;114;2;112
234616027;500;623;623;6;208;428;1;71;3;0;68;137;5;132
234616028;500;477;477;3;186;410;1;89;2;2;85;97;4;93
234616029;500;532;534;6;253;426;1;73;1;2;70;180;12;168
234616030;500;431;432;5;160;447;4;49;2;2;45;111;3;108
234616031;500;476;477;10;205;423;2;75;1;6;68;130;8;122
234616032;500;435;435;32;244;408;3;89;5;3;81;155;9;146
234616033;500;374;374;6;161;447;1;52;1;1;50;109;9;100
234616034;500;584;585;5;231;416;1;83;1;5;77;148;7;141
234616035;500;466;467;7;195;412;2;86;1;1;84;109;1;108
234616036;500;364;364;7;159;433;1;66;1;3;62;93;5;88
234616037;500;339;340;4;154;450;2;48;0;3;45;106;6;100
234616038;500;433;435;8;190;427;2;71;1;4;66;119;4;115
234616039;500;490;490;9;171;442;2;56;0;1;55;115;4;111
234616040;500;596;596;5;224;416;1;83;0;3;80;141;6;140
234616041;500;416;417;6;159;440;1;59;2;2;55;100;3;97
234616042;500;601;601;7;242;413;1;86;4;6;76;156;3;153
234616043;500;444;445;4;179;428;2;70;1;1;68;109;1;108
234616044;500;451;451;6;177;434;1;65;2;3;60;112;9;103
234616045;500;629;630;7;250;396;2;102;3;2;97;148;8;140
234616046;1000;862;862;14;472;895;1;104;2;5;97;368;9;359
234616047;500;717;717;13;323;420;1;79;1;2;76;244;13;231
234616048;500;668;668;77;376;417;1;82;2;9;71;294;21;273
234616049;500;528;528;176;371;374;2;124;1;11;112;247;16;231
234616050;500;300;709;38;338;423;1;76;0;3;73;262;12;250
234616051;500;631;631;58;392;411;3;86;0;3;83;306;18;288
234616052;500;662;664;52;380;442;1;57;1;2;54;323;21;302
234616053;1000;820;822;32;404;764;5;231;2;9;220;173;5;168
234616054;500;208;39;16;105;394;1;105;2;6;97;0;0;0
234616055;700;568;568;27;306;647;1;52;0;1;51;254;6;248
234616056;800;696;696;23;331;722;1;77;0;3;74;254;9;245
234616058;500;17;17;31;33;466;1;33;0;3;30;0;0;0
234617001;600;905;905;3;279;473;0;127;5;3;119;152;5;147
234617002;600;913;913;6;380;444;1;155;2;5;148;225;4;221
234617003;600;961;961;3;392;402;1;197;2;3;192;195;4;191
234617004;600;985;985;6;366;470;2;128;3;7;118;238;9;229
234617005;600;966;967;6;392;454;1;145;3;4;138;247;11;236
234617006;500;847;847;8;441;389;2;109;3;2;104;332;8;324
234617007;600;1009;1009;5;401;444;1;155;1;8;146;246;2;244
234617008;600;968;969;4;425;442;1;157;2;4;151;268;7;261
234617009;600;893;893;8;381;412;1;187;2;10;175;194;7;187
234617010;600;921;921;4;389;399;2;199;3;11;185;190;11;179
234617011;600;877;877;8;393;444;1;155;1;3;151;238;4;234
234617012;600;860;864;5;313;455;1;144;1;7;136;169;10;159
234617013;600;1000;1000;6;394;484;4;112;5;5;102;282;12;270
234617014;400;577;577;3;170;295;0;105;6;3;96;65;2;63
234617015;300;372;373;1;114;231;1;68;2;1;65;46;2;44
234617016;500;772;772;2;234;335;3;162;5;5;152;72;5;67
234617017;500;833;833;3;290;353;2;145;3;10;132;145;14;131
234617018;500;752;753;6;193;392;2;106;1;3;102;87;7;80
234617019;400;639;639;4;175;301;1;98;1;5;92;77;3;74
234617020;600;910;911;7;349;422;1;177;3;8;166;172;11;161
234617021;500;740;742;9;330;379;1;120;1;1;118;210;5;205
234617022;500;704;704;8;279;399;2;99;2;5;92;180;5;175
234617023;500;670;670;3;287;385;1;114;1;5;108;173;8;165
234617024;600;931;931;5;368;457;1;143;143;1;141;224;7;216
234617025;600;928;928;4;396;385;1;214;2;6;206;182;10;172
234617026;400;610;610;6;231;311;1;88;0;11;77;143;12;131
234617027;600;1033;1033;4;388;456;1;143;4;4;135;245;7;238
234617028;600;922;924;7;347;500;1;99;6;2;91;248;11;237
234617029;500;736;737;5;301;383;2;115;2;2;111;186;10;176
234617030;500;836;836;7;289;353;1;146;5;12;129;143;5;138
234617031;400;613;615;7;227;301;1;98;2;5;91;129;9;120
234617032;500;837;837;7;270;377;2;121;1;5;115;149;4;145
234617033;300;505;505;4;162;242;1;57;2;2;53;105;5;100
234617034;600;974;975;3;384;443;4;153;4;7;142;231;14;217
234617035;500;818;819;7;308;375;3;122;2;1;119;194;9;178
234617036;400;671;671;2;275;300;1;99;6;1;92;176;6;170
234617037;600;948;949;4;375;457;2;141;3;2;136;234;7;227
234617038;500;732;733;3;258;386;1;113;1;4;108;145;5;140
234617039;500;740;740;7;281;384;2;114;4;7;103;167;11;156
234617040;600;961;961;4;414;365;1;234;1;6;227;180;7;173
234617041;500;774;774;6;132;436;1;63;3;5;55;69;2;67
234617042;500;776;776;9;246;394;2;104;2;3;99;142;2;140
234617043;600;937;937;8;404;462;1;137;2;4;131;267;11;256
234617044;600;947;947;11;445;450;2;148;2;5;141;297;6;291
234617045;500;826;827;19;369;412;3;85;1;1;83;284;13;271
234617046;600;957;958;9;408;451;2;147;0;1;146;261;9;252
234617047;500;842;842;8;397;363;2;135;4;2;129;262;13;249
234617048;600;929;929;6;468;433;1;166;2;8;156;302;10;292
234617049;500;703;703;9;342;371;1;128;1;5;122;214;5;209
234617050;500;790;790;9;352;386;1;113;2;1;110;239;9;230
234617051;600;905;905;4;400;445;2;153;2;4;147;247;4;243
234617052;600;923;923;6;373;469;2;129;5;2;122;244;11;233
234617053;600;995;995;6;423;406;1;193;0;5;188;230;6;224
234617054;500;852;852;7;351;319;1;180;3;7;170;171;13;158
234617055;600;900;901;5;370;418;3;179;3;3;173;191;5;186
234617056;500;804;804;5;347;372;2;126;0;7;119;221;10;211
234617057;300;388;388;9;201;222;2;76;3;1;72;125;2;123
234617058;500;667;667;6;267;403;1;96;0;2;94;171;9;162
234617059;400;542;543;7;216;310;2;88;1;2;85;128;3;125
234617060;400;588;591;7;236;270;1;129;3;1;125;107;2;105
234617061;500;802;802;7;340;382;1;117;2;0;115;223;4;219
234617062;500;841;841;6;352;392;1;107;0;7;100;245;15;230
234617063;500;663;663;17;261;397;1;102;1;5;96;158;6;152
234617064;500;707;709;7;300;396;1;103;0;2;101;197;5;192
234617065;500;783;784;6;305;380;2;118;1;2;115;187;8;179
234617066;400;653;653;7;193;298;1;101;3;3;95;92;2;90
234617067;500;784;784;6;312;393;2;105;0;1;104;212;6;206
234617068;600;920;920;5;392;482;3;115;1;6;108;277;17;260
234617069;600;967;967;6;423;459;2;139;0;3;136;284;8;276
234617070;600;875;875;7;373;514;2;84;1;2;81;289;12;277
234617071;600;964;964;8;394;502;2;96;1;1;94;298;7;291
234617072;500;857;857;8;353;407;2;91;0;3;88;262;15;247
234617073;500;773;775;6;301;357;1;142;0;2;140;159;6;153
234617074;300;445;445;9;195;218;0;82;4;3;75;113;5;108
234617075;300;504;504;7;201;233;1;66;0;1;65;135;5;130
234617076;100;58;58;55;57;42;1;57;4;1;52;0;0;0
234617077;100;20;20;5;25;75;0;25;0;0;25;0;0;0
234623001;400;633;637;5;176;322;1;77;3;2;72;99;6;93
234623002;300;483;483;4;136;238;1;61;0;1;60;75;8;67
234623003;600;834;834;2;238;496;1;103;4;5;94;135;12;123
234623004;500;747;747;2;219;378;1;121;4;0;117;98;5;93
234623005;500;731;731;4;206;408;1;91;3;4;84;115;4;111
234623006;500;787;787;3;223;400;1;99;2;4;93;124;5;119
234623007;400;612;612;5;108;355;1;44;1;2;41;64;1;63
234623008;400;611;611;4;175;278;2;120;4;1;115;55;3;52
234623009;500;700;700;3;223;401;1;98;6;4;88;125;9;116
234623010;800;1023;1023;3;412;624;3;173;4;11;158;239;13;226
234623011;400;652;652;5;204;289;1;110;4;2;104;94;4;90
234623012;400;655;655;7;216;295;1;104;1;7;96;112;7;105
234623013;400;670;670;3;259;286;3;111;2;1;108;148;5;143
234623014;400;601;600;3;220;299;1;100;2;1;97;120;6;114
234623015;500;733;734;4;253;397;2;101;2;2;97;152;7;145
234623016;400;569;571;4;228;274;3;123;1;5;117;105;4;101
234623017;600;876;876;2;314;463;2;135;3;5;127;179;11;168
234623018;700;915;915;11;346;555;3;142;1;4;137;204;4;200
234623019;500;787;787;5;265;393;2;105;8;4;93;160;4;156
234623020;500;700;701;5;261;381;1;118;2;4;112;143;4;139
234623021;600;897;897;5;354;406;1;193;4;9;180;161;8;153
234623022;400;642;643;5;231;290;2;108;3;4;101;123;8;115
234623023;300;489;489;3;151;214;1;85;4;3;78;66;5;61
234623024;300;493;494;4;156;209;1;90;7;1;82;66;4;62
234623025;400;657;657;2;220;288;1;111;2;6;103;109;10;99
234623026;600;881;881;6;347;440;2;158;8;5;145;189;11;178
234623027;700;959;959;2;375;514;1;185;6;7;172;190;5;185
234623028;700;947;948;2;371;507;1;192;7;5;180;179;4;175
234623029;700;950;950;6;428;538;1;161;3;1;157;267;4;263
234623030;500;753;753;2;262;302;1;197;7;13;177;65;2;63
234623031;300;560;561;3;162;201;1;98;4;1;93;64;4;60
234623032;100;62;62;9;36;63;1;36;1;2;33;0;0;0
244601001;500;659;659;34;201;439;1;60;0;1;59;141;4;137
244601002;500;706;706;14;310;377;2;121;3;3;115;189;18;171
244601003;500;718;718;8;259;394;1;105;2;5;98;154;7;147
244601004;500;711;711;20;277;433;1;66;0;0;66;211;4;207
244601005;500;786;786;7;298;403;1;96;0;3;93;202;6;196
244601006;500;661;662;12;270;415;1;84;0;2;82;186;5;181
244601007;500;768;768;5;286;376;3;121;2;2;117;165;8;157
244601008;500;634;634;8;243;410;2;88;0;1;87;155;0;155
244601009;500;824;824;5;342;360;1;139;4;5;130;203;10;193
244601010;500;781;781;0;291;379;0;121;2;3;116;170;3;167
244601011;500;797;787;10;307;388;1;111;0;1;110;196;8;188
244601012;500;749;749;9;296;378;1;121;3;4;114;175;6;169
244601013;500;852;852;8;330;330;2;168;2;4;162;162;3;159
244601014;500;784;788;5;331;375;0;125;3;7;115;206;6;200
244601015;500;533;534;7;243;400;2;98;0;2;96;145;7;138
244601016;500;690;690;5;275;418;1;81;0;3;78;194;1;193
244601017;500;515;515;18;248;390;1;109;2;0;107;139;6;133
244601018;500;704;705;14;290;383;1;116;0;2;114;174;3;171
244601019;500;734;735;14;309;414;2;84;2;2;80;225;9;216
244601020;500;676;676;7;262;423;2;75;1;1;73;187;5;182
244601021;500;758;758;22;330;401;3;96;1;2;93;234;11;223
244601022;500;810;810;5;345;375;3;122;1;5;116;223;3;220
244601023;500;633;633;7;261;415;1;84;0;4;80;177;6;171
244601024;500;668;668;14;289;412;1;87;1;3;83;202;8;194
244601025;500;596;596;13;240;412;1;87;1;1;85;153;2;151
244601026;500;731;731;8;300;393;0;107;0;4;103;193;3;190
244601027;500;636;636;6;241;425;1;74;1;0;73;167;3;164
244601028;500;841;842;4;264;420;2;78;0;2;76;186;10;176
244601029;500;910;911;3;379;385;3;112;5;0;107;267;13;254
244601030;500;689;690;5;276;402;1;97;0;3;94;179;5;174
244601031;500;515;558;8;227;425;1;74;3;2;69;153;3;150
244601032;500;783;783;6;349;374;2;124;6;3;115;225;3;222
244601033;500;714;714;7;317;420;1;79;1;1;77;238;9;229
244601034;500;674;674;10;286;401;2;97;1;0;96;189;6;183
244601035;500;712;712;8;306;395;1;104;0;2;102;202;3;199
244601036;500;818;818;8;316;399;3;98;2;0;96;218;11;207
244601037;500;864;864;5;414;338;2;160;1;7;152;254;12;242
244601038;500;850;850;5;367;413;1;86;0;1;85;281;5;276
244601039;500;846;847;8;362;371;1;128;2;5;121;234;6;228
244601040;500;692;692;9;322;355;1;144;0;3;141;178;9;169
244601041;500;865;865;10;391;351;6;143;1;6;136;248;9;239
244601042;500;703;704;6;327;401;3;96;1;0;95;231;4;227
244601043;200;28;28;37;42;157;1;42;0;2;40;0;0;0
244601044;200;29;29;27;41;158;1;41;1;2;38;0;0;0
244601045;200;83401;83401;20;67;148;3;49;6;0;43;18;1;17
244601046;100;21;21;3;23;77;0;23;1;0;22;0;0;0
244603001;500;429;429;18;150;445;1;54;0;0;54;96;3;93
244603002;500;609;610;6;194;431;2;67;0;4;63;127;3;125
244603003;500;723;724;9;220;410;1;89;0;4;85;131;4;127
244603004;500;526;733;9;194;421;4;75;2;2;71;119;1;118
244603006;1000;881;881;9;191;940;1;59;1;2;56;132;0;132
244603007;1000;945;945;6;286;759;5;236;11;5;220;50;1;49
244603008;1000;900;901;6;167;933;1;66;0;2;64;101;3;98
244603009;500;734;735;11;158;452;1;47;0;2;45;111;4;107
244603011;1000;995;995;7;306;912;2;86;0;6;80;220;3;217
244603012;500;467;468;12;127;447;1;52;1;0;51;75;3;72
244603013;500;557;557;8;144;451;1;48;0;0;48;96;1;95
244603014;1000;842;842;7;217;931;1;68;1;0;67;149;4;145
244603016;500;370;370;38;144;431;2;67;0;0;67;77;4;73
244603017;500;537;537;7;122;443;1;56;3;0;53;66;1;65
244603018;500;893;893;4;234;391;1;108;5;2;101;126;3;123
244603020;500;775;775;10;241;396;1;103;0;2;101;138;6;132
244603021;500;745;745;2;158;443;1;56;0;0;56;102;2;100
244603022;1000;867;867;6;264;883;1;116;1;1;114;148;8;140
244603024;1000;896;897;10;341;883;3;114;3;5;106;227;5;219
244603025;1000;984;985;7;391;867;1;132;3;2;127;259;10;249
244603026;1000;861;861;8;332;889;5;106;3;4;99;226;6;220
244603027;1000;779;779;14;333;895;1;104;2;0;102;229;8;221
244603028;1000;798;799;9;335;909;4;87;0;3;84;248;9;239
244603031;1000;855;855;7;303;870;2;128;4;2;122;175;4;171
244603032;902;1019;1019;11;370;782;4;116;3;4;109;254;11;243
244603034;500;571;573;13;212;435;1;64;1;3;60;148;4;144
244603035;500;588;627;5;223;407;1;92;0;2;90;131;4;127
244603036;1000;783;784;10;312;859;1;140;3;7;130;172;3;169
244603037;1000;876;876;6;257;894;1;105;0;2;103;152;6;146
244603038;1000;805;806;6;301;852;2;146;0;4;142;155;6;149
244603039;500;338;338;45;192;403;2;95;0;2;93;97;4;93
244603040;500;546;546;9;213;442;1;57;0;1;56;156;4;152
244603041;500;676;678;8;219;411;1;88;1;7;80;131;6;125
244603042;1000;836;836;5;288;902;2;96;4;2;90;192;17;175
244603043;1000;979;979;4;373;868;2;130;5;0;125;243;8;235
244603044;1000;919;920;7;342;873;4;123;0;2;121;219;5;214
244603045;1000;930;930;10;303;861;2;137;6;2;129;166;7;159
244603046;1000;876;876;6;325;873;2;125;7;3;115;200;6;194
244603047;500;766;766;25;289;396;1;103;0;5;98;186;8;178
244603048;1000;986;986;9;391;706;2;292;2;14;276;99;4;95
244603050;1000;911;911;7;351;840;4;156;4;2;150;195;10;185
244603052;500;731;731;15;318;361;4;135;4;6;125;183;9;174
244603053;1000;923;923;6;335;841;1;158;2;3;153;177;2;175
244603054;1000;871;871;6;328;890;1;109;0;2;107;219;6;213
244603055;1000;818;820;15;296;877;2;121;4;4;113;175;11;164
244603056;500;561;561;7;181;425;1;74;2;4;68;107;5;102
244603057;500;703;703;8;257;380;1;119;2;2;115;138;4;134
244603058;500;505;505;10;179;422;1;77;1;3;73;102;5;97
244603059;500;544;544;8;202;424;1;75;3;3;69;127;9;118
244603060;500;581;581;9;219;412;1;87;2;3;82;132;5;127
244603061;500;506;506;3;157;435;1;64;3;1;60;93;8;85
244603062;500;639;641;5;227;418;2;80;3;2;75;147;2;145
244603063;500;625;625;6;198;443;3;54;3;1;50;144;10;134
244603064;1000;873;873;9;338;866;2;132;6;3;123;206;13;193
244604001;200;443;443;9;190;134;1;65;1;0;64;125;1;124
244604002;300;756;756;9;267;216;4;80;1;5;74;187;12;175
244604003;400;750;750;8;321;297;2;101;3;2;96;220;6;214
244604004;200;463;464;7;178;136;2;62;0;1;61;116;5;111
244604005;300;554;555;6;232;198;3;99;0;0;99;133;12;121
244604006;300;566;566;2;252;221;2;77;1;3;73;175;5;170
244604007;200;363;364;7;147;155;1;44;1;1;42;103;6;97
244604008;200;405;405;6;156;141;2;57;2;0;55;99;5;94
244604009;200;423;423;4;143;82;4;114;3;6;105;29;2;27
244604010;300;643;638;5;206;201;1;98;4;6;88;108;1;107
244604011;300;570;570;7;199;232;1;67;3;1;63;132;4;128
244604012;300;679;679;8;269;206;1;93;1;2;90;176;8;168
244604013;300;549;537;5;227;219;7;74;0;0;74;153;13;140
244604014;400;674;691;4;275;312;1;87;1;1;85;188;8;180
244604015;400;717;720;6;310;259;2;139;0;2;137;171;8;163
244604016;300;590;590;15;279;205;5;90;1;5;84;189;12;177
244604017;400;663;663;11;301;313;1;86;0;4;82;215;7;208
244604018;400;835;835;12;378;235;3;162;0;6;156;216;0;216
244604019;500;836;837;7;395;104;3;393;4;14;375;2;0;2
244604020;200;462;462;8;188;138;2;60;1;3;56;128;4;124
244604021;200;323;323;9;130;152;1;47;1;2;44;83;8;75
244604022;200;434;434;6;175;147;1;52;0;4;48;123;4;119
244604023;200;395;395;3;145;155;2;43;2;0;41;102;1;101
244604024;200;452;453;6;204;145;2;53;0;3;50;151;8;143
244604025;300;667;667;7;334;161;3;136;4;3;126;201;1;200
244604026;300;609;609;9;281;198;3;99;2;6;91;182;10;172
244604027;200;343;343;10;161;146;1;53;4;1;48;108;2;106
244604028;300;530;530;8;246;211;1;88;2;2;84;158;1;157
244604029;400;728;728;8;344;286;1;113;1;6;106;231;9;222
244604030;200;381;381;9;185;149;2;49;2;2;45;136;3;133
244604031;200;457;486;8;211;138;2;60;1;1;58;151;4;147
244604032;300;657;657;6;253;216;1;83;2;2;79;170;4;166
244604033;200;419;419;16;216;134;1;65;0;2;63;151;5;146
244604034;300;521;521;6;195;247;1;52;0;2;50;143;3;140
244604035;300;552;553;11;245;234;2;64;3;0;61;181;11;170
244604036;200;430;431;11;186;143;1;56;1;1;54;130;9;121
244604037;300;594;594;5;232;240;1;59;0;2;57;173;7;166
244604038;300;523;523;8;239;224;1;75;2;1;72;164;5;159
244604039;300;630;630;5;277;217;3;80;5;4;71;197;8;189
244604040;400;763;764;4;309;288;1;111;0;0;111;198;10;188
244604041;300;557;557;7;270;193;2;105;0;3;102;165;6;159
244604042;300;218;456;13;217;216;3;81;1;0;80;136;6;130
244604043;300;459;460;2;228;77;3;220;4;4;212;8;1;7
244604044;300;496;497;30;244;221;1;78;1;0;77;166;8;158
244604045;300;482;484;10;221;227;1;72;3;1;68;149;9;140
244604046;300;613;614;5;222;209;5;86;5;1;80;136;5;131
244604047;300;524;526;6;248;170;2;128;0;2;126;120;1;119
244604048;300;642;644;5;278;217;1;82;2;2;78;196;6;190
244604049;300;657;657;5;255;219;1;80;2;1;77;178;8;170
244604050;300;507;508;8;256;201;1;98;2;4;92;158;6;152
244604051;300;578;578;6;258;184;7;109;2;4;103;149;6;143
244604052;200;359;359;6;154;158;1;41;1;0;40;113;6;107
244604053;400;742;742;9;300;287;4;109;2;4;103;191;2;189
244604054;400;792;792;8;345;297;3;100;2;1;97;245;10;235
244604055;200;24;24;87;93;106;1;93;0;10;83;0;0;0
244604056;100;21;21;6;26;74;0;26;0;0;26;0;0;0
244605001;400;419;419;13;169;322;1;77;2;1;74;92;4;88
244605002;500;532;532;8;201;422;1;77;2;1;74;124;4;120
244605003;600;631;631;11;229;491;3;106;0;4;102;123;10;113
244605004;500;484;484;12;184;437;1;62;0;2;60;122;7;115
244605005;800;778;803;8;322;672;1;127;1;7;119;195;9;186
244605006;600;562;562;8;236;511;1;88;0;2;86;148;9;139
244605007;700;697;698;6;260;580;1;119;1;10;108;147;0;147
244605008;800;840;841;8;329;683;1;116;5;3;108;213;7;206
244605009;800;847;847;9;348;683;1;116;1;2;113;232;13;219
244605010;800;772;774;5;312;705;1;94;1;4;89;218;7;211
244605011;700;756;756;4;305;595;1;104;4;1;99;201;9;192
244605012;700;763;764;4;324;546;1;153;2;5;146;171;14;157
244605013;500;503;504;6;206;411;1;88;2;2;84;118;6;112
244605014;500;680;680;7;276;362;1;137;2;1;134;139;5;134
244605015;500;567;568;10;227;403;1;96;0;2;94;131;1;130
244605016;800;833;834;3;324;641;2;157;5;5;147;167;3;164
244605017;600;622;622;5;297;523;1;76;2;2;72;221;16;205
244605018;900;990;990;6;403;763;1;136;0;4;132;267;10;257
244605019;800;884;884;5;361;662;1;137;3;9;125;224;9;215
244605020;600;572;572;5;203;519;1;80;2;3;75;123;4;119
244605021;500;541;541;4;175;417;1;82;1;2;79;93;1;92
244605022;400;384;386;20;140;336;1;63;1;0;62;77;5;72
244605023;500;502;502;5;193;423;2;75;3;5;67;118;3;115
244605024;700;748;766;5;223;621;2;77;0;1;76;146;9;137
244605025;600;639;640;4;231;492;1;107;0;7;100;124;2;122
244605026;500;452;452;19;176;444;1;55;0;1;54;121;8;113
244605027;700;690;690;6;272;563;2;135;5;7;123;137;5;132
244605028;700;686;687;4;225;595;1;104;0;2;102;121;6;115
244605029;600;591;591;8;208;499;2;99;2;1;96;109;6;103
244605030;700;693;693;9;259;562;1;137;6;9;122;122;2;120
244605031;500;548;548;6;157;425;1;74;3;2;69;83;7;76
244605032;500;492;492;4;139;430;1;69;3;3;63;70;7;63
244605033;500;512;512;4;169;446;1;53;1;0;52;116;6;110
244605034;600;605;635;9;219;522;1;77;3;1;73;142;9;133
244605035;300;296;297;7;103;196;1;103;0;9;94;0;0;0
244605036;500;516;518;7;146;438;1;61;0;2;59;85;1;84
244605037;400;400;400;10;151;324;2;74;3;4;67;77;3;74
244605038;700;685;686;8;240;589;6;105;5;8;92;135;6;129
244605039;500;509;510;1;136;443;0;57;2;2;53;79;2;77
244605040;500;482;482;8;161;429;1;70;3;2;65;91;3;88
244605041;700;728;723;5;240;570;7;123;6;4;113;117;6;111
244605042;500;523;523;5;156;406;1;93;2;1;90;63;6;57
244605043;700;725;725;6;203;567;1;132;20;4;108;71;2;69
244605044;700;725;725;4;193;614;1;85;3;4;78;108;6;102
244605045;800;844;845;6;195;682;1;117;16;6;95;78;3;75
244605046;600;562;562;7;182;510;1;89;1;0;88;93;4;89
244605047;500;541;541;3;177;413;1;86;0;1;85;91;7;84
244605048;500;561;565;1;136;438;1;61;0;4;57;75;1;74
244605049;600;679;681;5;186;515;1;84;6;3;75;102;2;100
244605050;700;682;684;5;195;576;1;123;0;5;116;72;10;62
244605051;600;607;607;6;191;512;1;87;0;4;83;104;1;103
244605052;400;372;372;4;82;360;2;38;0;0;38;44;1;43
244605053;500;483;493;5;157;438;0;62;0;2;60;95;4;91
244605054;900;904;904;7;335;776;1;123;4;4;115;212;11;201
244605055;500;554;554;6;193;417;1;82;4;3;75;111;0;111
244605056;500;529;529;9;201;422;1;77;2;6;69;124;7;117
244605057;600;623;623;6;205;502;1;97;0;1;96;108;3;105
244605058;800;844;846;6;258;692;1;107;3;5;99;151;7;144
244605059;800;797;797;7;264;692;1;107;4;5;98;157;4;153
244605060;900;899;899;2;248;785;1;114;3;2;109;134;11;123
244605061;900;918;927;5;285;771;1;128;0;3;125;157;14;143
244605062;300;142;142;7;39;260;1;39;1;1;37;0;0;0
244605063;300;30;30;21;36;263;1;36;1;2;33;0;0;0
244605064;300;13;13;32;43;256;1;43;1;4;38;0;0;0
244605065;300;105;105;39;116;182;2;116;15;5;96;0;0;0
244605066;300;64;64;15;69;230;1;69;14;2;53;0;0;0
244606001;500;818;818;9;243;398;1;101;0;6;95;142;2;158
244606002;500;770;770;6;218;400;1;99;1;6;92;119;9;110
244606003;500;784;785;4;266;401;1;98;4;5;89;168;8;160
244606004;500;867;868;4;330;346;1;153;5;5;143;177;7;170
244606005;500;811;811;7;300;373;6;121;4;2;115;179;8;171
244606006;500;808;810;8;266;416;1;83;1;0;82;183;8;175
244606007;500;921;921;5;226;423;1;76;3;1;72;150;8;142
244606008;500;796;796;4;233;406;1;93;6;6;81;140;9;131
244606009;500;732;733;5;199;424;1;75;3;5;67;124;11;113
244606010;500;784;784;2;245;361;1;138;2;3;133;107;6;101
244606011;500;813;813;5;262;391;2;107;6;5;96;155;13;142
244606012;500;729;730;6;223;378;1;121;4;3;114;102;10;92
244606013;500;719;720;4;198;404;1;95;0;3;92;103;6;97
244606014;500;738;741;3;195;405;1;94;1;3;90;101;2;99
244606015;500;709;699;10;202;428;1;71;1;2;68;131;7;124
244606016;500;760;760;4;237;378;8;114;3;2;109;123;1;124
244606017;500;784;784;7;285;389;1;110;5;3;102;175;7;168
244606018;500;776;776;5;275;381;1;118;2;5;111;157;7;150
244606019;500;811;811;6;277;397;1;102;3;9;90;175;12;163
244606020;500;762;763;12;251;414;1;85;1;3;81;166;9;157
244606021;500;824;826;7;311;191;3;306;4;17;285;5;1;4
244606022;500;730;730;5;243;395;1;104;0;3;101;139;9;130
244606023;500;919;919;8;362;358;1;141;1;5;135;221;13;208
244606024;500;876;876;6;312;380;1;119;0;2;117;193;7;186
244606025;500;1000;1000;6;370;365;2;133;2;4;127;237;14;223
244606026;500;888;889;11;302;382;1;117;3;3;111;185;9;176
244606027;500;795;795;7;263;385;2;113;7;3;103;150;7;143
244606028;500;834;836;4;294;383;1;116;0;2;114;178;6;172
244606029;500;720;720;9;260;357;1;142;5;9;128;118;9;109
244606030;500;781;781;9;259;384;1;115;3;4;108;144;6;138
244606031;500;791;792;4;264;393;1;106;3;1;102;158;11;147
244606032;500;712;712;9;302;371;1;128;0;0;128;174;1;173
244606033;500;744;744;3;205;406;1;93;2;3;88;112;0;112
244606034;500;739;740;5;240;381;2;117;2;7;108;123;4;119
244606035;500;829;829;4;297;365;2;133;2;5;126;164;8;156
244606036;500;690;707;4;244;398;1;101;4;3;94;143;8;135
244606037;500;707;708;7;232;402;1;97;1;5;91;135;6;129
244606038;500;666;666;7;217;420;1;79;1;3;75;138;8;130
244606039;500;765;765;2;282;403;1;96;4;2;90;186;7;179
244606040;500;967;967;7;382;361;2;137;4;4;129;245;16;229
244606041;500;803;806;7;254;417;2;81;2;2;77;173;9;164
244606042;500;794;795;6;240;381;4;115;1;6;108;125;1;124
244606043;500;823;823;6;258;384;1;115;2;5;108;143;7;136
244606044;500;782;784;10;284;349;2;149;0;3;146;135;12;123
244606045;500;681;681;8;249;318;3;179;2;16;161;70;5;65
244606046;500;930;930;6;312;372;3;125;3;2;120;187;9;178
244606047;500;755;755;13;283;388;1;111;3;4;104;172;5;167
244606048;500;732;733;4;239;398;1;101;0;2;99;138;5;133
244606049;500;783;783;4;273;385;2;113;4;3;106;160;9;151
244606050;500;782;782;8;254;244;2;254;3;17;234;0;0;0
244606051;500;753;753;11;57;470;2;28;1;2;25;29;0;29
244606052;500;779;780;4;228;388;1;111;2;5;104;117;2;115
244606053;500;853;854;6;296;386;5;109;4;5;100;187;9;178
244606054;500;755;756;7;247;394;1;105;14;1;90;142;13;129
244606055;500;753;753;4;234;402;2;96;2;2;92;138;10;128
244606056;500;763;763;5;235;384;1;115;1;5;109;120;2;118
244606057;500;743;743;6;227;378;1;121;2;4;115;106;3;103
244606058;500;831;832;8;274;372;1;127;1;2;124;147;14;133
244606059;500;889;889;5;272;391;1;108;8;5;95;164;7;157
244606060;500;856;856;6;257;390;1;109;7;0;102;148;4;144
244606061;500;774;774;8;206;411;1;88;1;1;86;118;8;110
244606062;500;773;773;2;212;415;1;84;2;0;82;128;4;124
244606063;500;823;823;4;231;398;1;101;1;2;98;130;2;128
244606064;500;796;796;3;276;376;2;122;2;3;117;154;8;146
244606065;500;831;831;6;235;391;1;108;4;3;101;127;3;124
244606066;500;807;807;6;236;411;1;88;3;2;83;148;8;140
244606067;500;846;846;1;197;423;1;76;3;3;70;121;6;115
244606068;500;828;828;7;233;414;1;85;0;2;83;148;5;143
244606069;500;915;915;2;309;378;5;117;3;3;111;192;11;181
244606070;500;630;630;6;176;416;2;82;0;2;80;94;5;89
244606071;500;982;982;6;360;338;2;160;6;6;148;200;11;189
244606072;500;856;856;4;268;398;1;101;1;7;93;167;5;162
244606073;500;811;811;5;202;403;1;96;2;4;90;106;4;102
244606074;500;859;859;6;226;385;3;112;4;0;108;114;3;111
244606075;500;719;721;6;216;401;1;98;2;2;94;118;4;114
244606076;500;853;853;8;254;405;2;93;2;3;88;161;9;152
244606077;500;755;756;5;246;384;1;115;1;0;114;131;3;128
244606078;500;778;778;7;255;387;6;107;5;2;100;148;10;138
244606079;500;667;667;12;256;385;1;114;0;4;110;142;10;132
244606080;500;623;627;7;215;423;1;76;1;3;72;139;11;128
244606081;500;798;798;5;308;355;1;144;3;3;138;164;11;153
244606082;500;771;771;4;236;431;1;68;0;1;67;168;11;157
244606083;500;628;628;4;189;409;2;89;2;0;87;100;3;97
244606084;100;29;29;1;29;71;0;29;1;0;28;0;0;0
244607001;400;512;512;7;222;335;2;63;2;1;60;159;8;151
244607002;300;414;415;4;184;241;1;58;0;1;57;126;1;125
244607003;300;476;476;10;226;241;1;58;0;3;55;168;5;163
244607004;500;697;697;6;306;364;1;135;5;1;129;171;5;166
244607005;600;947;948;6;387;391;2;207;4;9;194;180;6;174
244607006;500;661;662;6;268;412;1;87;2;2;83;181;4;177
244607007;600;946;946;5;421;440;2;158;2;2;154;263;5;258
244607008;500;701;702;6;298;393;1;106;0;3;103;192;9;183
244607009;500;689;690;19;295;377;3;120;2;8;110;175;8;167
244607010;400;650;650;16;315;301;2;97;2;3;92;218;9;209
244607011;300;505;505;16;237;222;1;77;0;1;76;160;8;152
244607012;400;578;578;9;248;310;3;87;3;7;77;161;10;151
244607013;300;435;435;14;204;215;1;84;2;1;81;120;5;115
244607014;500;770;770;13;325;399;1;100;0;5;95;225;3;222
244607015;400;572;572;12;245;318;1;81;1;2;78;164;4;160
244607016;500;721;722;9;327;351;1;148;3;4;141;179;4;175
244607017;600;857;857;8;385;455;1;144;3;3;138;241;8;233
244607018;400;598;598;6;264;150;2;248;5;4;239;16;0;16
244607019;500;715;715;7;319;386;2;112;4;3;105;207;6;201
244607020;400;616;616;12;263;311;1;88;3;1;84;175;10;165
244607021;600;862;864;5;325;488;1;111;2;2;107;214;4;210
244607022;300;480;482;6;129;248;1;51;0;1;50;78;4;74
244607023;400;537;537;5;227;320;2;78;1;1;76;149;4;145
244607024;500;717;717;10;301;390;2;108;1;5;102;193;7;186
244607025;500;787;787;6;323;372;1;127;8;4;115;196;9;187
244607026;400;619;621;8;312;303;1;96;0;2;94;216;7;209
244607027;300;409;409;6;174;230;1;69;0;3;66;105;6;99
244607028;600;819;820;11;350;397;1;202;4;10;188;148;8;140
244607029;500;663;663;17;335;379;2;119;1;5;113;216;10;206
244607030;400;576;576;2;258;308;1;91;2;1;88;167;7;160
244607031;300;465;466;6;204;218;2;80;2;1;77;124;8;116
244607032;500;663;663;11;295;376;2;122;1;1;120;173;5;168
244607033;400;576;576;5;254;324;1;75;1;3;71;179;9;170
244607034;400;593;593;8;265;167;1;232;4;8;220;33;0;33
244607035;400;524;526;3;244;309;1;90;2;3;85;154;7;147
244607036;700;950;950;5;416;551;9;140;4;9;127;276;3;273
244607037;500;775;775;5;347;359;3;138;3;1;134;209;15;194
244607038;400;639;639;9;308;320;1;79;1;1;77;229;13;216
244607039;600;837;837;6;405;447;1;152;1;3;148;253;11;242
244607040;600;894;894;6;383;456;3;141;0;2;139;242;10;232
244607041;400;635;635;287;286;315;0;85;0;6;79;201;5;196
244607042;700;936;937;7;384;559;2;139;1;4;134;245;16;229
244607043;700;983;983;2;426;588;1;111;2;3;106;315;11;304
244607044;600;871;873;7;409;461;2;137;0;2;135;272;7;265
244607045;500;793;795;6;309;370;1;128;1;0;127;181;8;173
244607046;500;787;787;7;304;387;2;111;5;1;105;193;10;183
244607047;600;851;853;9;338;466;5;129;5;5;119;209;15;194
244607048;600;820;820;8;337;411;1;188;3;13;172;149;8;141
244607049;500;689;690;11;266;393;1;106;2;4;100;160;4;156
244607050;500;669;669;9;236;404;4;92;4;1;88;144;12;132
244607051;400;554;554;7;206;322;1;77;1;1;75;129;10;119
244607052;500;740;740;7;291;355;1;144;4;3;137;147;9;138
244607053;300;448;449;4;162;257;1;42;2;3;37;120;5;115
244607054;300;476;476;5;153;235;1;64;1;3;60;89;11;78
244607055;700;957;957;2;327;578;15;107;15;2;90;220;18;202
244607056;400;490;490;9;191;284;1;115;1;5;109;76;3;73
244607057;400;581;581;581;216;300;1;99;2;1;96;117;3;114
244607058;400;600;600;9;227;326;1;73;1;2;70;154;8;146
244607059;700;968;969;3;386;577;1;122;2;4;116;264;16;248
244607060;600;891;892;5;355;474;1;125;5;5;115;230;7;223
244607061;300;439;439;8;126;246;1;53;1;0;52;73;1;72
244607062;600;808;808;5;280;511;2;87;2;0;85;193;8;185
244607063;300;459;459;9;189;221;1;78;1;0;77;111;5;106
244607064;300;452;453;7;147;242;2;56;0;0;56;91;1;90
244607065;400;550;550;5;178;318;1;81;0;2;79;97;3;94
244607066;400;571;576;7;175;347;1;52;1;2;49;123;8;115
244607067;400;489;498;7;226;253;2;145;0;0;145;81;4;77
244607068;400;614;614;4;167;327;2;71;5;1;66;96;3;93
244607069;500;654;654;6;204;416;2;82;3;4;75;122;3;119
244607070;400;530;530;6;52;358;2;40;3;2;35;12;0;12
244607071;600;830;830;5;54;559;2;39;7;1;31;15;1;14
244607072;300;494;494;6;68;241;1;58;4;2;52;10;1;9
244607073;600;889;889;5;88;530;3;67;3;1;63;21;2;19
244607074;500;788;788;7;60;465;1;34;1;2;31;26;0;26
244607075;500;777;777;7;97;434;4;62;5;2;55;35;2;33
244607076;400;640;640;8;77;346;1;53;3;7;49;24;1;23
244607077;700;947;947;5;75;651;1;48;10;0;38;27;1;26
244607078;200;224;312;23;105;152;1;47;4;1;42;58;2;56
244607079;300;486;487;8;178;229;1;70;3;1;66;108;4;104
244607080;700;975;974;9;486;542;1;157;0;7;150;329;13;316
244607081;500;754;755;10;319;392;3;105;5;0;100;214;5;209
244607082;400;544;547;12;237;164;1;235;4;9;222;2;0;2
244607083;400;601;601;7;310;255;1;144;4;6;134;166;5;161
244607084;500;772;772;6;369;392;2;106;1;2;103;263;10;253
244607085;500;643;643;13;277;413;2;85;0;1;84;192;4;188
244607086;100;18;18;3;20;80;0;20;1;1;18;0;0;0
244614001;500;697;697;7;285;382;1;117;2;3;112;168;8;160
244614002;500;725;726;4;262;390;1;109;4;2;103;153;10;143
244614003;500;718;718;4;242;394;1;105;0;5;100;137;6;131
244614004;500;786;788;3;265;389;3;108;6;2;100;157;5;152
244614005;500;815;816;0;247;397;1;102;6;0;96;145;9;136
244614006;500;791;792;3;224;396;1;103;5;0;98;121;2;119
244614007;500;751;754;4;197;411;2;87;2;2;83;110;7;103
244614008;500;704;704;8;273;322;4;174;2;6;166;99;6;93
244614009;500;672;672;5;215;393;1;106;6;3;97;109;3;106
244614010;500;742;744;7;242;392;2;106;4;2;100;136;3;133
244614011;500;622;625;12;223;399;2;99;1;5;93;124;11;113
244614012;500;725;726;6;228;387;1;112;1;4;107;116;9;107
244614013;500;699;701;9;219;405;1;94;4;2;88;125;5;120
244614014;500;827;827;5;235;403;1;96;1;5;90;139;9;130
244614015;500;778;780;5;230;394;1;105;5;5;95;125;6;119
244614016;500;831;832;4;276;372;1;127;7;6;114;149;4;145
244614017;500;678;679;5;244;409;1;90;1;5;84;154;11;143
244614018;500;679;679;4;192;411;1;88;4;7;77;104;5;99
244614019;500;973;974;7;178;429;1;70;2;2;66;108;3;105
244614021;500;609;610;19;236;402;1;97;2;0;95;139;7;132
244614022;500;733;734;6;206;416;2;82;1;1;80;124;6;118
244614023;500;673;674;7;245;389;2;109;4;6;99;136;4;132
244614024;500;898;898;6;209;423;1;76;1;4;71;133;8;125
244614025;500;642;642;3;192;411;1;88;1;3;84;104;9;95
244614026;500;751;751;6;348;398;3;99;2;3;94;249;128;121
244614027;500;752;753;3;239;381;1;118;0;5;113;121;10;111
244614028;500;621;623;4;194;420;0;80;2;3;75;114;2;112
244614029;500;700;700;4;196;358;1;141;3;8;130;54;3;51
244614030;500;775;780;2;213;412;1;87;4;3;80;126;3;123
244614031;500;903;903;20;338;375;1;124;1;5;118;214;12;202
244614032;500;738;738;4;298;362;2;136;2;3;131;162;4;158
244614033;500;664;664;8;210;403;1;96;4;3;89;114;6;108
244614034;500;670;670;5;254;375;1;124;5;7;112;130;9;121
244614035;500;758;759;6;252;394;1;105;2;4;99;147;12;135
244614036;500;682;682;6;233;404;2;94;4;6;84;139;8;131
244614037;500;747;747;8;219;413;1;86;2;4;80;132;7;125
244614038;500;666;667;6;227;409;2;89;3;2;84;138;3;135
244614039;500;637;639;8;215;394;1;105;4;1;100;110;5;105
244614040;500;859;859;2;327;404;2;94;2;2;90;233;8;225
244614041;500;746;746;4;227;396;1;103;1;2;100;124;6;120
244614042;500;794;794;4;237;403;1;96;2;4;90;141;7;134
244614043;500;684;701;5;284;383;2;115;11;3;101;169;10;159
244614044;500;665;666;5;238;388;1;98;1;1;96;140;10;130
244614045;500;695;695;10;247;413;1;86;0;4;82;161;3;158
244614046;500;704;706;7;252;365;1;134;1;2;131;118;6;112
244614047;500;753;753;9;286;394;1;105;3;4;98;181;5;176
244614048;500;743;743;6;273;343;3;154;0;9;145;119;9;110
244614049;500;685;685;5;243;406;1;93;3;5;85;150;9;141
244614050;500;752;753;5;272;385;1;114;2;4;108;158;4;154
244614051;500;628;628;4;217;388;1;111;2;7;102;106;6;100
244614052;500;637;637;3;223;414;1;85;0;3;82;138;4;134
244614053;500;657;658;5;241;396;2;102;1;2;99;139;6;133
244614054;500;741;741;5;270;408;1;91;0;1;90;179;10;169
244614055;500;844;844;6;425;340;1;159;1;5;153;266;3;263
244614056;500;827;827;5;424;386;1;113;1;0;112;311;14;297
244614057;500;937;937;7;322;394;1;105;4;3;98;217;7;210
244614058;500;807;808;5;352;363;2;135;3;4;128;217;11;206
244614059;500;804;805;6;295;369;1;130;1;4;125;165;6;159
244614060;500;820;820;9;318;215;2;283;7;12;264;35;0;35
244614061;500;707;707;5;226;412;1;87;1;4;82;139;11;128
244614062;500;768;768;5;238;394;2;104;1;6;97;134;4;130
244614063;500;718;725;4;253;310;3;187;1;13;173;66;0;66
244614064;500;753;753;7;310;313;1;186;4;10;172;124;6;118
244614065;500;684;684;5;229;389;1;110;2;4;104;119;4;115
244614066;500;729;729;6;246;379;1;120;2;10;108;126;6;120
244614067;700;632;632;5;223;607;4;89;3;3;83;134;6;128
244614068;500;640;640;5;253;384;1;115;0;6;109;138;11;127
244614069;500;648;648;6;207;413;2;85;1;0;84;122;5;117
244614070;500;654;654;3;204;417;2;81;1;3;77;123;10;113
244614071;500;662;662;2;214;397;1;102;0;6;96;112;8;104
244614072;500;637;638;7;229;413;1;86;2;1;83;143;7;136
244614073;500;711;729;5;242;384;1;115;5;3;107;127;5;122
244614074;500;596;596;6;285;387;1;112;0;5;107;173;8;165
244614075;500;883;885;1;148;427;1;72;2;1;69;76;3;73
244614076;500;739;739;2;171;353;3;144;2;10;132;27;0;27
244614077;500;668;668;10;224;370;1;129;5;2;122;95;4;91
244614078;500;669;669;5;196;406;1;93;1;9;83;103;5;98
244614079;100;15;15;4;19;81;0;19;0;0;19;0;0;0
244622001;500;811;811;0;185;400;1;99;2;5;92;86;4;82
244622002;500;768;773;4;246;365;1;134;2;12;120;112;7;105
244622003;500;618;619;3;171;419;1;80;2;3;75;91;8;83
244622004;500;923;924;2;304;342;0;158;4;3;151;146;7;139
244622005;500;664;664;3;184;414;1;85;2;4;79;99;8;91
244622006;500;680;680;4;225;359;2;139;0;8;131;86;9;77
244622007;500;680;681;5;191;396;1;103;1;1;101;88;9;79
244622008;500;874;874;2;80;460;1;39;6;0;33;41;1;40
244622009;500;710;712;4;100;434;1;65;2;1;62;35;5;30
244622010;500;805;805;2;96;438;1;61;4;4;53;35;0;35
244622011;500;913;913;2;123;422;1;77;6;3;68;46;0;46
244622012;500;978;979;1;153;397;1;102;5;2;95;51;3;48
244622013;500;936;936;4;102;437;1;62;7;0;55;40;1;39
244622014;300;543;544;3;109;238;4;58;4;0;54;51;5;46
244622015;400;608;609;4;155;309;1;90;3;3;84;65;6;59
244622016;400;716;716;4;119;335;2;63;3;3;57;56;1;55
244622017;400;676;678;2;117;347;1;52;1;3;48;65;1;64
244622018;300;489;489;7;146;217;1;82;0;6;76;64;2;62
244622019;300;394;394;4;105;247;1;52;3;0;49;53;3;50
244622020;400;615;615;3;137;318;2;80;5;3;72;57;2;55
244622021;400;550;552;4;110;342;1;57;0;0;57;53;3;50
244622022;300;432;432;1;91;258;1;41;1;2;38;50;4;45
244622023;300;544;545;3;109;229;2;69;2;3;64;40;2;38
244622024;300;452;452;10;108;250;1;49;3;2;44;59;1;58
244622025;300;429;430;4;80;258;1;41;1;2;38;39;2;37
244622026;300;368;368;5;112;228;1;71;1;1;69;41;2;39
244622027;300;486;486;6;110;238;1;61;1;1;59;49;1;48
244622028;300;439;440;3;128;235;1;64;4;1;59;64;2;62
244622029;300;483;483;4;141;216;1;83;2;3;78;58;1;57
244622030;300;537;538;5;169;184;4;112;2;6;104;57;3;54
254611001;500;602;605;4;190;403;4;93;2;4;87;97;2;95
254611002;500;734;735;6;241;394;1;105;3;3;99;136;8;128
254611003;500;619;619;8;239;405;1;94;5;2;87;145;10;135
254611004;500;511;511;5;205;423;2;75;2;8;65;130;12;118
254611005;500;686;686;5;235;401;0;99;0;1;98;136;2;134
254611006;500;619;619;36;106;455;1;44;2;2;40;62;2;60
254611007;500;948;950;3;358;319;3;178;4;5;169;180;12;168
254611008;500;532;533;7;201;426;1;73;3;1;69;128;1;127
254611009;500;687;687;3;238;399;1;100;2;2;96;138;4;134
254611010;500;812;814;6;274;381;2;117;2;5;110;157;12;145
254611011;500;537;538;1;187;414;1;85;1;3;81;102;5;97
254611012;500;562;562;36;221;410;1;89;4;5;80;132;8;124
254611013;500;790;791;7;273;373;4;123;5;2;116;150;11;139
254611014;500;786;786;6;314;361;2;137;2;6;129;177;9;168
254611015;500;633;634;4;261;393;4;103;0;3;100;158;7;151
254611016;500;750;751;4;246;391;3;106;1;3;102;140;6;134
254611017;500;717;717;7;265;375;1;124;3;2;119;141;9;132
254611018;500;840;840;6;305;366;1;133;1;8;124;172;6;166
254611019;500;804;804;6;294;385;1;114;2;5;107;180;7;173
254611020;500;816;817;3;257;392;1;107;4;2;101;150;5;145
254611021;500;664;664;7;230;379;3;118;1;4;113;112;5;107
254611022;500;583;583;7;185;397;2;101;3;3;95;84;3;81
254611023;500;614;614;4;196;392;0;108;3;0;105;88;3;85
254611024;500;692;693;0;255;378;1;121;2;4;115;134;4;130
254611025;500;616;616;5;223;422;1;77;2;1;74;146;11;135
254611026;500;497;497;4;158;429;1;70;2;1;67;88;2;86
254611027;500;477;477;17;184;420;1;79;3;5;71;105;0;105
254611028;500;649;663;7;244;395;2;103;3;0;100;141;6;135
254611029;500;538;540;5;182;424;1;75;1;3;71;107;3;104
254611030;500;549;550;4;185;405;1;94;0;3;91;91;4;87
254611031;500;665;665;6;210;383;2;115;0;5;110;95;7;88
254611032;500;644;644;2;246;407;1;92;0;4;88;154;5;150
254611033;500;509;507;2;189;418;1;81;2;3;76;108;2;106
254611034;500;656;656;4;256;382;1;117;2;6;109;139;9;130
254611035;500;703;703;5;269;383;2;115;7;5;103;154;6;148
254611036;500;569;569;4;190;387;2;111;1;9;101;79;3;76
254611037;500;662;662;6;207;410;1;89;2;1;86;118;3;115
254611038;500;590;590;6;170;440;1;59;0;3;56;111;5;106
254611039;500;697;699;8;217;408;1;91;3;3;85;126;3;123
254611040;500;857;857;4;210;411;1;88;3;3;82;122;7;115
254611041;500;486;487;7;156;433;1;66;1;1;64;90;1;89
254611042;500;612;612;4;245;394;1;105;6;6;93;140;6;134
254611043;500;595;595;6;178;416;1;83;1;0;82;95;3;92
254611044;500;531;532;4;200;429;1;70;5;5;60;130;3;127
254611045;500;642;643;7;222;413;0;87;1;2;84;135;7;128
254611046;500;634;634;12;205;418;1;81;0;7;74;124;3;121
254611047;500;649;642;7;191;402;2;96;3;0;93;95;1;94
254611048;500;583;583;5;220;418;1;81;1;1;79;139;5;134
254611049;500;464;464;6;136;434;3;63;3;4;56;73;8;65
254611050;500;483;483;9;171;442;2;56;0;2;54;115;4;111
254611051;500;672;672;7;247;404;1;95;1;1;93;152;6;146
254611052;500;535;551;4;214;407;1;92;0;5;87;122;7;115
254611053;500;506;506;6;180;434;0;66;2;1;63;114;8;106
254611054;500;654;656;6;275;387;1;112;6;3;103;163;10;153
254611055;500;590;590;5;241;393;2;105;0;2;103;136;4;132
254611056;500;646;646;6;10;490;1;9;0;0;9;1;0;1
254611057;500;815;815;7;106;434;2;64;4;1;59;42;2;40
254611058;500;557;557;6;33;471;2;27;2;0;25;6;0;6
254611059;500;1090;1093;6;61;458;1;41;1;0;40;20;2;18
254611060;500;978;981;19;85;460;1;39;3;1;35;46;3;43
254611061;500;962;987;9;29;473;1;26;3;0;23;3;0;3
254611062;500;959;960;4;22;485;1;14;2;0;12;8;0;8
254611063;500;606;606;7;60;463;1;36;7;1;28;24;1;23
254611064;500;949;951;4;35;461;5;34;4;1;29;1;1;0
254611065;500;866;866;5;38;474;0;26;5;0;21;12;0;12
254611066;500;851;851;6;20;489;0;11;1;0;10;9;0;9
254611067;500;859;860;5;74;465;0;35;3;0;32;39;0;39
254611068;500;580;581;3;26;472;3;25;4;0;21;1;0;1
254611069;500;552;568;6;203;414;1;85;3;4;78;118;8;110
254611070;500;532;532;5;170;423;1;76;0;1;75;94;1;93
254611071;500;916;917;6;25;479;2;19;2;0;17;6;1;5
254611072;500;343;345;4;12;488;1;11;1;0;10;1;0;1
254611073;500;493;493;6;13;492;1;7;2;0;5;6;0;6
254611080;100;17;17;10;26;73;1;26;1;1;24;0;0;0
254611081;100;67;67;36;40;60;0;40;0;2;38;0;0;0
254611082;200;133;133;71;76;123;1;76;0;2;74;0;0;0
254612001;500;999;999;5;416;351;1;148;0;0;148;268;26;242
254612002;500;909;911;5;300;347;1;152;0;0;152;148;0;148
254612003;500;893;894;5;346;369;1;130;0;5;125;216;11;205
254612004;500;866;866;7;304;348;2;150;2;4;144;154;9;145
254612005;500;782;785;8;260;378;1;121;4;5;112;139;6;133
254612006;500;635;635;8;208;416;1;83;0;1;82;125;3;122
254612007;500;748;748;8;279;381;2;117;1;1;115;162;3;159
254612008;500;637;637;7;212;398;3;99;3;4;92;113;7;106
254612009;500;698;698;7;263;373;1;126;5;6;115;137;5;132
254612010;500;619;619;4;231;385;1;114;8;2;104;117;5;112
254612011;500;621;622;3;231;268;1;231;7;14;210;0;0;0
254612012;500;432;433;13;155;441;1;58;2;3;53;97;6;91
254612013;500;534;535;6;166;420;1;79;1;3;75;87;2;85
254612014;500;594;594;5;216;391;3;106;4;4;98;110;8;102
254612015;500;665;671;6;250;361;1;138;3;4;131;112;5;107
254612016;500;682;682;9;291;382;2;116;4;2;110;175;8;167
254612017;500;964;964;8;386;340;4;156;5;4;147;230;13;217
254612018;500;621;621;7;229;397;2;101;2;1;98;128;6;122
254612019;500;510;510;8;212;396;2;102;0;2;100;110;3;107
254612020;500;633;633;5;244;415;1;84;0;2;82;160;6;154
254612021;500;652;652;11;251;404;2;94;2;4;88;157;3;154
254612022;500;813;814;7;343;367;1;132;6;2;124;211;12;199
254612023;500;887;887;9;352;360;1;139;1;0;138;213;7;206
254612024;500;663;663;7;266;377;1;122;2;0;120;144;0;144
254612025;500;296;752;5;301;378;1;121;2;5;114;180;4;176
254612026;500;620;620;6;230;385;4;111;1;6;104;119;9;110
254612027;500;830;830;7;339;344;1;155;1;2;152;184;4;180
254612028;500;728;728;4;238;343;1;156;6;3;147;82;9;73
254612029;500;693;693;6;278;384;1;115;1;1;113;163;8;155
254612030;500;758;758;7;293;374;3;123;2;6;115;170;6;164
254612031;500;737;737;3;260;387;6;107;4;2;101;153;3;150
254612032;500;794;794;4;288;396;1;103;9;4;90;185;11;174
254612033;500;676;676;7;242;391;2;107;2;4;101;135;5;130
254612034;500;617;617;19;273;391;1;108;4;6;98;165;9;156
254612035;500;671;671;6;191;393;2;105;4;1;100;86;3;83
254612036;500;673;673;6;263;390;3;107;2;4;101;156;9;147
254612037;500;514;514;16;185;419;1;80;0;0;80;105;3;102
254612038;500;655;655;6;265;373;1;126;1;2;123;139;6;133
254612039;500;704;704;6;274;372;1;127;1;2;124;147;2;145
254612040;300;384;384;22;157;219;1;80;0;3;77;77;3;74
254612041;200;40;40;54;69;130;1;69;0;6;63;0;0;0
254613001;500;715;715;9;262;410;2;88;1;2;85;174;9;165
254613002;500;741;742;6;264;393;1;106;6;4;96;158;4;154
254613003;600;906;907;22;317;336;3;261;4;11;246;56;0;56
254613004;600;859;859;9;282;456;1;143;2;6;135;139;4;135
254613005;600;876;876;6;312;443;1;156;2;4;150;156;9;147
254613006;600;845;845;6;150;555;1;44;0;1;43;106;2;104
254613007;500;780;780;5;287;369;3;128;4;4;120;159;13;146
254613008;500;712;712;4;256;383;1;116;3;4;109;140;6;134
254613009;600;867;867;3;333;377;1;222;2;14;206;111;6;105
254613010;600;856;856;3;296;471;1;128;1;6;121;168;5;163
254613011;600;933;933;23;310;449;2;149;4;5;140;161;7;154
254613012;700;954;954;8;350;525;1;174;4;4;166;176;5;171
254613013;600;865;865;12;308;453;2;145;2;0;143;163;10;153
254613014;600;876;877;3;234;472;5;123;4;7;112;111;6;105
254613015;700;948;949;5;277;568;2;130;4;5;121;147;5;142
254613016;700;934;934;3;286;564;1;135;2;4;129;151;9;142
254613017;600;843;845;4;256;463;2;135;5;3;127;121;4;117
254613018;600;897;897;7;290;448;4;148;7;3;138;142;10;132
254613019;600;910;911;5;221;510;1;89;1;6;82;132;3;129
254613020;600;893;893;6;278;479;3;118;0;0;118;160;0;160
254613021;600;885;885;5;242;498;1;101;2;4;95;141;4;137
254613022;700;943;945;1;261;577;2;121;1;3;117;140;1;139
254613023;700;942;969;7;287;566;1;133;4;3;126;154;13;141
254613024;700;981;983;5;276;576;1;123;3;6;114;153;7;146
254613025;700;995;995;5;316;540;5;155;6;4;145;161;5;156
254613026;600;805;814;5;266;455;1;144;1;4;139;122;6;116
254613027;600;810;810;5;259;427;1;172;0;9;163;87;1;86
254613028;600;903;904;3;309;455;4;141;3;6;132;168;3;165
254613029;600;887;887;6;239;452;7;141;6;8;127;98;5;93
254613030;600;854;857;4;266;462;2;136;1;1;134;130;6;124
254613031;500;765;765;7;244;376;2;122;5;5;112;122;4;118
254613032;600;799;800;4;270;459;1;140;5;4;131;130;9;121
254613033;500;787;789;4;264;362;1;137;1;1;135;127;2;125
254613034;600;830;833;23;275;462;1;137;11;4;122;138;7;131
254613035;600;867;867;8;265;477;2;121;5;2;114;144;8;136
254613036;600;848;848;7;253;501;1;98;1;0;97;155;4;151
254613037;600;860;861;5;281;476;4;120;5;6;109;161;9;152
254613038;600;840;840;6;214;436;0;164;3;10;151;50;0;50
254613039;600;891;893;5;248;481;1;118;6;3;109;130;7;123
254613040;600;892;893;3;262;490;3;107;0;1;106;155;7;148
254613041;700;966;968;5;307;585;3;112;0;2;110;195;16;179
254613042;600;884;885;2;288;495;2;103;1;2;100;185;4;181
254613043;600;915;915;6;275;472;1;127;4;8;115;148;9;139
254613044;700;997;1001;8;279;589;2;109;5;2;102;170;7;163
254613045;700;959;961;3;319;568;1;131;4;3;124;188;8;180
254613046;500;726;726;6;240;366;3;131;1;8;122;109;4;105
254613047;600;826;826;4;263;462;1;137;0;5;132;126;11;115
254613048;600;845;845;13;310;454;1;145;1;2;142;165;6;159
254613049;600;832;832;7;311;449;2;149;4;7;138;162;10;152
254613050;600;847;847;6;279;482;1;117;7;4;106;162;3;159
254613051;500;752;752;5;257;380;1;119;1;5;113;138;0;138
254613052;400;636;637;7;227;296;3;101;2;3;96;126;8;118
254613053;600;808;808;2;269;463;5;132;0;4;128;137;3;134
254613054;600;849;866;6;322;462;4;134;2;2;130;188;8;180
254613055;500;654;656;3;221;395;2;103;1;1;101;118;5;113
254613056;600;850;851;6;216;487;1;112;4;6;102;104;7;97
254613057;600;855;855;2;239;511;1;88;2;2;84;151;7;144
254613058;500;696;697;5;212;397;1;102;2;1;99;110;4;106
254613059;500;780;780;5;237;386;1;113;2;6;105;124;7;117
254613060;500;775;775;7;209;383;1;116;1;1;114;93;5;88
254613061;500;655;656;5;209;409;1;90;3;5;82;119;7;112
254613062;500;716;717;2;198;403;1;96;1;5;90;102;4;98
254613063;600;870;870;4;289;441;4;155;3;3;149;134;4;130
254613064;600;870;870;7;235;489;7;104;5;3;96;131;10;121
254613065;600;884;884;5;291;481;1;118;3;1;114;173;7;166
254613066;500;748;750;3;218;390;1;109;2;5;102;109;3;106
254613067;600;813;813;2;221;503;2;95;0;0;95;126;14;112
254613068;500;769;769;4;253;367;1;132;2;0;130;121;7;114
254613069;600;836;837;6;235;445;1;154;5;3;146;81;7;74
254613070;400;585;588;6;184;308;2;90;3;3;84;94;4;90
254613071;400;614;614;4;217;284;2;114;2;6;106;103;7;96
254613072;100;15;15;1;16;83;1;16;0;0;16;0;0;0
254618001;600;638;639;10;257;530;1;69;0;2;67;188;9;179
254618002;900;952;952;9;396;738;2;160;3;7;150;236;6;230
254618003;700;704;704;11;301;599;2;99;2;4;93;202;4;198
254618004;700;720;723;5;292;572;2;126;0;1;125;166;5;161
254618005;700;708;709;5;288;621;2;77;2;2;73;211;8;203
254618006;900;926;926;5;344;777;1;122;7;4;111;222;5;217
254618007;700;704;652;4;210;618;0;82;0;0;82;128;6;122
254618008;700;758;759;4;273;591;1;108;1;4;103;165;8;157
254618009;800;836;836;7;307;657;4;139;3;4;132;168;4;164
254618010;700;697;697;7;286;558;2;140;1;2;137;146;7;139
254618011;700;682;683;10;238;605;1;94;2;3;89;144;5;139
254618012;700;669;671;5;258;594;3;103;3;7;93;155;8;147
254618013;700;634;634;10;92;607;1;92;1;1;90;135;10;125
254618014;600;627;627;15;205;524;1;75;2;4;69;130;6;124
254618015;600;581;582;3;213;515;1;84;4;3;77;129;4;125
254618016;800;773;773;3;267;637;5;158;5;9;144;109;5;104
254618017;700;630;630;3;211;618;1;81;3;2;76;130;9;121
254618018;700;658;658;7;277;593;1;106;2;5;99;172;8;164
254618019;700;715;715;6;215;616;1;83;4;3;76;132;5;127
254618020;700;680;680;4;251;594;1;105;1;4;100;146;3;143
254618021;600;584;584;4;206;513;2;85;0;1;84;121;6;115
254618022;800;797;797;2;313;679;1;120;0;4;116;193;5;188
254618023;700;643;646;4;201;600;1;99;4;2;93;102;4;98
254618024;800;849;849;7;322;686;2;112;1;1;110;210;14;196
254618025;500;536;536;13;198;320;2;178;1;7;170;20;0;20
254618026;700;676;676;6;246;572;4;124;3;2;119;122;3;119
254618027;600;553;553;6;204;518;1;81;1;0;80;123;7;116
254618028;700;702;703;2;241;594;1;105;2;3;100;136;7;129
254618029;600;633;633;5;257;492;7;101;4;2;95;156;4;152
254618030;600;599;600;9;234;479;3;118;1;3;114;116;5;111
254618031;600;596;597;4;259;494;1;105;1;2;102;154;6;148
254618032;700;675;675;6;217;591;1;108;0;1;107;109;10;99
254618033;500;503;504;4;168;421;1;78;0;2;76;90;7;83
254618034;700;718;718;7;236;530;1;169;4;5;160;67;5;62
254618035;600;562;564;10;251;495;1;104;4;0;100;147;3;144
254618036;800;885;886;4;348;661;1;138;4;5;129;210;5;205
254618037;700;708;708;5;290;596;5;99;4;5;90;191;7;184
254618038;700;701;702;8;247;597;1;102;4;9;89;145;4;141
254618039;700;733;733;6;229;609;3;88;5;3;80;141;8;133
254618040;600;606;607;6;216;527;1;72;1;4;67;144;6;138
254618041;700;695;696;4;238;585;3;112;5;3;104;126;6;120
254618042;700;716;718;4;283;603;1;96;6;0;90;187;10;177
254618043;600;195;641;7;201;504;1;95;3;3;89;106;4;102
254618044;700;720;720;9;236;607;3;90;3;4;83;146;7;139
254618045;100;16;16;42;47;52;1;47;5;1;41;0;0;0
254618046;600;593;593;5;208;523;1;76;2;2;72;132;6;126
254618047;500;483;483;13;180;434;1;65;0;0;65;115;11;104
254618048;700;710;710;9;291;456;1;243;1;6;236;48;3;45
254618049;900;907;908;9;349;759;1;140;4;5;131;209;13;196
254618050;800;820;821;4;363;665;3;132;0;8;124;231;9;222
254618051;700;684;684;4;233;598;1;101;1;2;98;132;6;126
254618052;600;601;602;8;196;502;2;96;4;4;88;100;3;97
254618053;500;529;529;3;219;431;3;66;0;3;63;153;7;146
254618054;800;788;788;4;278;685;2;113;1;2;110;165;9;156
254618055;900;937;938;5;404;725;1;174;1;11;162;226;11;210
254618056;500;538;539;11;182;430;2;68;3;5;60;114;4;110
254618057;600;589;589;5;220;522;3;75;2;1;72;145;2;143
254618058;600;538;538;4;177;508;1;91;4;0;87;86;2;84
254618059;500;489;489;28;191;423;1;76;0;2;74;115;7;108
254618060;600;563;564;7;173;507;7;86;5;1;80;87;3;84
254618061;900;955;957;5;396;732;2;166;3;5;158;230;7;223
254618062;800;799;805;1;366;687;5;108;5;4;99;258;12;246
254618063;600;583;586;5;280;481;3;116;2;4;110;164;11;153
254618064;700;701;702;7;288;619;2;79;0;5;74;209;8;201
254618065;600;575;575;5;233;516;1;83;1;1;81;150;5;145
254618066;600;628;628;2;200;555;1;44;3;0;41;156;5;151
254618067;600;563;563;5;186;522;2;76;0;2;74;110;3;107
254618068;600;535;536;5;237;498;1;101;2;1;98;136;6;130
254618069;600;616;616;6;255;496;1;103;0;6;97;152;6;146
254618070;600;599;599;5;232;530;2;68;0;3;65;164;10;154
254618071;800;665;667;2;258;695;1;104;3;2;99;154;8;146
254618072;100;24;24;11;29;70;1;29;0;3;26;0;0;0
254618073;100;13;13;8;20;79;1;20;0;0;20;0;0;0
254619001;800;819;829;6;290;694;1;105;2;2;101;185;7;178
254619002;500;494;494;7;168;441;2;57;1;0;56;111;7;104
254619003;800;750;750;6;184;709;1;90;3;6;81;94;3;91
254619004;796;796;796;6;194;685;1;110;13;2;95;84;2;82
254619005;700;733;735;7;219;597;2;101;1;3;97;118;6;112
254619006;700;716;716;9;195;596;2;102;7;0;95;93;5;88
254619007;700;648;649;5;209;601;1;98;2;1;95;111;2;109
254619008;600;539;541;3;160;454;3;143;8;4;131;17;1;16
254619009;700;648;648;4;208;599;1;100;2;5;93;108;8;100
254619010;600;577;577;8;171;540;1;59;2;3;54;112;8;104
254619011;600;637;637;7;211;523;1;76;1;2;73;135;3;132
254619012;300;296;296;6;95;204;1;95;0;2;93;0;0;0
254619013;500;467;467;6;149;448;1;51;0;3;48;98;7;91
254619014;700;726;726;8;236;598;1;101;4;3;94;135;3;132
254619015;900;875;876;3;231;808;1;91;0;2;89;140;3;137
254619016;900;898;898;6;163;816;4;80;3;7;70;83;8;75
254619017;700;692;694;8;202;619;1;80;4;4;72;122;3;119
254619018;700;737;738;3;260;584;1;115;2;0;113;145;8;137
254619019;600;556;556;6;205;496;1;103;2;4;97;102;5;97
254619020;600;606;606;7;205;503;5;92;4;5;83;113;7;106
254619021;700;702;703;2;206;613;1;86;4;3;79;120;8;112
254619022;700;712;712;9;239;595;1;104;4;0;100;135;8;127
254619023;900;882;884;5;259;773;1;126;3;3;120;133;5;128
254619024;800;825;825;5;239;685;2;113;0;1;112;126;3;123
254619025;900;949;949;7;351;778;1;121;3;4;114;230;22;208
254619026;700;709;709;12;250;601;1;98;5;5;88;152;6;146
254619027;700;690;703;5;267;571;1;128;2;0;126;139;0;139
254619028;700;680;680;2;223;587;1;112;3;4;105;111;3;108
254619029;800;784;784;5;232;697;3;100;2;6;92;132;9;123
254619030;800;791;791;5;257;674;1;125;1;3;121;132;6;126
254619031;700;717;717;3;223;613;3;84;2;2;80;139;5;134
254619032;700;662;662;6;187;624;1;75;1;2;72;112;7;105
254619033;700;738;738;7;215;593;1;106;6;3;97;109;3;106
254619034;800;765;765;7;235;709;1;90;3;3;84;145;8;137
254619035;800;846;847;6;306;679;1;120;7;3;110;186;3;183
254619036;700;683;684;4;247;603;1;96;2;4;90;151;10;141
254619037;600;641;642;7;226;500;1;99;2;5;92;127;10;117
254619038;900;852;852;8;309;638;1;261;3;5;253;48;4;44
254619039;900;913;913;5;358;742;2;156;2;5;149;202;6;196
254619040;700;725;725;5;251;583;4;113;3;3;107;138;7;131
254619041;700;649;649;6;229;596;4;100;3;3;94;129;8;121
254619042;600;549;549;7;172;524;3;73;3;2;68;99;10;89
254619043;600;604;604;5;188;515;1;84;4;3;77;104;12;92
254619044;600;604;607;6;182;514;1;85;1;2;82;97;6;91
254619045;700;721;723;7;199;611;1;88;4;4;80;111;8;103
254619046;800;793;794;5;181;720;2;78;5;2;71;103;1;102
254619047;600;561;570;4;215;494;2;104;1;5;98;111;6;105
254619048;600;625;645;6;210;487;6;107;5;2;100;103;2;101
254619049;800;798;800;4;292;640;6;154;4;3;147;138;1;137
254619050;700;669;672;6;192;605;3;92;1;3;88;100;9;91
254619051;600;571;581;7;183;524;4;72;3;1;68;111;0;111
254619052;800;751;751;5;240;559;1;240;6;11;223;0;0;0
254619053;800;755;755;5;249;670;2;128;1;7;120;121;9;112
254619054;800;801;801;14;188;709;1;90;4;4;82;98;2;96
254619055;1000;951;952;9;253;883;1;116;7;3;106;137;5;132
254619056;800;741;741;2;215;704;1;95;6;0;89;120;8;112
254619057;700;715;715;4;225;575;2;123;3;4;116;102;8;94
254619058;700;730;732;6;194;609;1;90;13;1;76;104;0;104
254619059;800;815;818;5;230;704;0;96;2;2;92;134;0;134
254619060;800;741;743;5;241;673;1;126;5;3;118;115;3;112
254619061;700;700;681;7;214;602;1;97;6;0;91;117;0;117
254619062;700;633;635;5;200;609;1;90;2;2;86;110;5;105
254619063;700;725;727;4;219;609;1;90;3;2;85;129;9;120
254619064;700;680;681;7;213;619;1;80;3;2;75;133;7;126
254619065;900;885;886;6;266;750;1;149;5;9;135;117;7;110
254619066;700;656;656;5;185;622;1;77;3;2;72;108;3;105
254619067;700;668;670;5;234;592;1;107;2;6;99;127;9;118
254619068;800;817;817;2;291;647;14;139;6;8;125;152;8;144
254619069;900;851;852;3;267;760;1;139;1;2;136;128;7;121
254619070;800;821;822;10;284;654;2;144;5;2;137;140;17;123
254619071;700;702;702;4;135;541;33;126;32;1;93;9;0;9
254619072;700;192;687;5;197;478;25;197;26;2;169;0;0;0
254619073;900;906;907;6;345;772;1;127;2;5;120;218;4;214
254619074;800;801;802;5;286;669;1;130;5;7;118;156;10;146
254619075;900;926;927;7;316;780;3;117;4;2;111;199;14;185
254619076;800;750;750;4;265;685;1;114;2;0;112;151;5;146
254619077;700;725;725;6;243;596;1;103;7;5;91;140;7;133
254619078;700;643;644;6;199;608;2;90;1;2;87;109;7;102
254619079;700;683;683;0;151;617;1;82;2;1;79;69;0;69
254619080;800;775;775;6;253;614;2;184;2;11;173;69;1;68
254619081;800;769;769;2;205;696;1;103;2;2;99;102;4;98
254619082;900;891;892;4;299;778;2;120;1;5;114;179;5;174
254619083;900;909;909;3;287;779;1;120;5;5;110;167;12;155
254619084;700;681;682;13;218;617;1;82;4;2;76;136;6;130
254619085;600;575;584;6;212;481;3;116;3;4;109;96;4;92
254619086;700;719;719;5;242;577;1;122;3;6;113;120;6;114
254619087;700;689;690;6;220;572;1;127;2;1;124;93;5;88
254619088;800;764;765;5;260;675;3;122;2;6;114;138;10;128
254619089;900;915;917;9;338;764;2;134;2;1;131;204;12;192
254619090;900;915;928;9;363;751;5;144;2;5;137;219;14;205
254619091;900;855;856;5;248;786;2;112;2;3;107;136;11;125
254619092;700;695;696;4;187;603;1;96;4;5;87;91;2;89
254619093;700;642;642;5;235;601;2;97;1;1;95;138;9;129
254619094;800;691;693;7;191;699;2;99;4;4;91;92;4;88
254619095;600;617;618;7;199;517;1;82;2;3;77;117;5;112
254619096;800;802;802;4;267;674;4;122;4;6;112;145;3;142
254619097;800;757;788;6;260;685;2;113;2;0;111;147;13;134
254619098;1000;939;940;9;362;819;1;180;15;1;164;182;9;173
254619099;1000;942;942;3;320;864;1;135;5;4;126;185;7;178
254619100;900;820;823;5;313;727;1;172;7;8;157;141;0;141
254619101;900;916;916;7;312;775;1;124;1;4;119;188;16;172
254619102;900;834;836;6;297;754;9;137;11;1;125;160;5;155
254619103;900;884;885;2;292;773;2;125;3;4;118;167;11;156
254619104;900;873;874;6;328;752;1;147;2;2;143;181;6;175
254619105;1000;987;987;5;335;897;2;101;4;1;96;234;6;228
254619106;900;868;868;6;276;769;1;130;9;4;117;146;3;143
254619107;900;859;860;8;261;796;3;101;2;2;97;160;13;147
254619108;700;715;715;5;272;561;1;138;3;14;121;134;8;126
254619109;900;830;824;6;287;783;1;116;0;2;114;171;11;160
254619110;900;913;913;5;299;760;9;131;6;4;121;168;7;161
254619111;800;779;779;4;256;690;1;109;1;5;103;147;3;144
254619112;700;652;652;6;219;600;1;99;1;5;93;120;7;113
254619113;600;630;630;6;212;516;1;83;5;2;76;129;6;123
254619114;800;789;789;4;233;695;2;103;4;6;93;130;8;122
254619115;900;936;936;5;293;762;12;126;11;1;114;167;2;165
254619116;600;584;584;3;194;521;1;78;1;3;74;116;6;110
254619117;700;421;721;9;247;587;2;111;4;2;105;136;5;131
254619118;700;655;655;9;222;608;2;90;3;2;85;132;7;125
254619119;700;726;726;4;232;587;2;111;2;3;106;121;13;108
254619120;700;666;667;5;222;585;2;113;1;4;108;109;7;102
254619121;800;801;801;6;282;648;1;151;2;7;142;131;5;126
254619122;1000;982;982;6;395;826;1;173;6;5;162;222;14;208
254619123;800;312;845;4;314;664;3;133;2;5;126;181;7;174
254619124;800;747;747;7;291;647;11;142;10;6;126;149;8;141
254619125;600;577;587;5;199;500;6;94;3;3;88;105;4;101
254619126;700;703;703;4;228;600;1;99;6;5;88;129;2;127
254619127;700;689;699;5;238;589;1;110;1;2;107;128;0;128
254619128;700;680;681;7;216;615;1;84;0;1;83;132;9;123
254619129;900;841;841;3;250;809;1;90;1;4;85;160;3;157
254619130;800;827;828;6;316;664;2;134;2;5;127;182;10;172
254619131;300;309;309;11;131;218;5;77;5;1;71;54;1;53
254619132;700;672;672;4;164;515;25;160;23;2;135;4;0;4
254619133;100;29;29;5;33;66;1;33;0;0;33;0;0;0
254620001;700;725;726;8;232;604;1;95;2;1;92;137;4;133
254620002;600;575;575;5;172;530;1;69;1;2;66;103;4;99
254620003;600;627;628;7;177;524;1;75;1;3;71;102;7;95
254620004;600;580;580;1;169;520;3;77;3;0;74;92;5;87
254620005;800;880;881;5;258;700;0;100;0;1;99;158;8;150
254620006;800;889;889;4;280;662;1;137;5;4;128;143;3;140
254620007;700;706;706;3;227;602;1;97;3;8;86;130;7;123
254620008;700;705;705;9;238;587;1;112;4;2;106;126;2;124
254620009;800;752;753;5;193;714;3;83;1;7;75;110;4;106
254620010;700;733;733;6;174;589;2;109;1;1;107;65;1;64
254620011;700;720;722;9;197;620;1;79;3;1;75;118;5;113
254620012;700;732;732;4;231;591;4;105;4;3;98;126;3;123
254620013;700;734;734;0;233;596;1;103;2;4;97;130;6;124
254620014;800;844;845;5;218;704;1;95;2;3;90;123;3;120
254620015;600;640;640;1;165;528;3;71;2;1;68;91;5;86
254620016;800;794;794;2;233;693;3;104;3;2;99;129;7;122
254620017;700;699;700;3;176;612;3;85;4;3;78;91;4;87
254620018;700;721;721;6;219;610;1;89;4;3;82;130;2;128
254620019;800;772;772;5;234;697;1;102;0;2;100;132;11;121
254620020;600;551;551;4;137;528;1;71;2;3;66;66;4;62
254620021;700;722;727;2;192;597;2;101;3;2;96;91;6;85
254620022;600;827;827;6;182;522;1;77;2;6;69;105;3;102
254620023;800;788;788;4;235;711;1;88;2;6;80;147;9;138
254620024;800;772;773;11;242;689;2;109;3;3;103;133;10;123
254620025;700;706;707;7;232;588;1;111;2;0;109;121;5;116
254620026;700;646;647;6;162;617;1;82;3;4;75;80;4;76
254620027;600;613;620;3;194;492;1;107;1;2;104;87;6;81
254620028;700;744;744;8;279;592;1;107;3;4;100;172;7;165
254620029;700;671;671;6;240;583;1;116;5;5;106;124;9;115
254620030;800;769;770;6;256;707;1;92;1;2;89;164;5;159
254620031;800;748;748;8;306;654;1;145;2;5;138;161;8;153
254620032;600;607;608;7;154;539;1;60;1;1;58;94;3;91
254620033;700;744;744;6;269;565;3;132;6;3;123;137;2;135
254620034;600;595;595;8;214;493;3;104;3;4;97;110;5;105
254620035;800;825;827;6;320;627;2;171;4;14;153;149;8;141
254620036;800;773;773;5;243;677;1;122;6;6;110;121;7;114
254620037;700;708;710;7;267;573;1;126;4;5;117;141;7;134
254620038;800;872;873;3;330;636;1;163;6;6;151;167;12;155
254620039;700;678;679;8;240;601;1;98;1;1;96;142;8;134
254620040;800;867;868;6;192;685;1;114;6;1;107;78;4;74
254620041;900;925;925;5;210;788;1;111;7;4;100;99;4;95
254620042;800;897;898;6;292;664;1;135;5;10;120;157;5;152
254620043;800;893;893;5;290;645;1;154;1;8;145;136;7;129
254620044;700;648;648;8;196;618;1;81;1;2;78;115;7;108
254620045;600;611;612;6;88;532;2;66;14;4;48;22;2;20
254620046;800;859;864;7;247;677;1;122;13;3;106;125;13;112
254620047;800;814;814;6;259;654;4;142;3;5;134;117;6;111
254620048;400;357;357;8;120;357;1;42;1;1;40;78;8;70
254620049;800;772;773;4;238;659;2;139;1;4;134;99;5;94
254620050;900;857;859;5;269;661;4;235;2;7;226;34;1;33
254620051;800;846;849;7;280;545;1;254;3;13;238;26;3;23
254620052;900;894;894;6;296;727;1;172;11;3;158;124;8;116
254620053;700;698;698;2;247;534;1;165;3;5;157;82;7;75
254620054;200;884;884;7;71;168;1;31;3;0;29;40;1;39
254620055;500;491;491;8;151;431;0;69;0;1;68;82;5;77
254620056;600;571;571;7;162;532;1;67;0;4;63;95;4;91
254621001;500;454;455;3;140;433;1;66;1;3;62;74;4;70
254621002;500;429;429;2;124;429;1;70;0;2;68;54;1;53
254621004;500;536;536;4;190;401;1;98;3;3;92;92;3;89
254621005;500;565;565;5;247;357;2;141;6;5;130;106;5;101
254621006;500;663;663;2;186;404;1;95;4;3;88;91;7;84
254621007;500;588;588;5;161;408;2;90;1;1;88;71;7;64
254621008;500;867;867;4;276;347;1;152;10;7;135;124;7;117
254621009;500;845;845;5;291;352;1;147;1;4;142;144;8;136
254621010;500;744;744;3;231;373;6;121;5;3;113;110;6;104
254621011;500;650;650;1;189;411;1;88;3;5;80;101;9;92
254621012;500;773;773;3;206;384;1;115;3;2;110;91;1;90
254621013;502;825;825;1;182;409;1;92;2;4;86;90;4;86
254621014;500;552;553;5;151;403;1;96;1;6;89;55;2;53
254621015;500;831;831;2;258;381;1;118;1;4;113;140;1;139
254621016;500;714;714;5;234;370;1;129;8;6;115;105;4;101
254621017;500;700;700;2;180;411;1;88;0;1;87;92;4;88
254621018;500;753;753;2;211;385;1;114;6;2;106;97;4;93
254621019;500;663;663;6;214;387;5;108;5;2;101;106;5;101
254621020;500;640;641;4;121;447;1;52;3;0;49;69;2;67
254621021;500;612;612;9;132;431;2;67;1;2;64;65;4;61
254621022;500;430;430;5;100;446;1;53;1;0;52;47;1;46
254621023;500;497;520;3;133;414;1;85;0;3;82;48;2;46
254621024;500;764;764;5;301;339;1;160;2;4;154;141;4;137
254621025;500;557;557;3;256;341;1;158;5;6;147;98;8;90
254621026;500;630;633;2;165;404;1;95;0;3;92;70;1;69
254621027;500;594;594;4;174;409;1;90;3;2;85;84;2;82
254621028;500;644;644;3;141;423;2;75;5;2;68;66;0;66
254621029;500;531;531;3;243;364;2;134;9;9;116;109;6;103
254621030;500;611;612;4;189;399;1;100;7;6;87;89;5;84
254621031;500;536;537;6;233;353;5;142;4;11;127;91;3;88
254621032;500;503;503;3;135;433;1;66;2;3;61;69;2;67
254621033;500;504;504;1;153;428;1;71;0;4;67;82;4;78
254621034;500;516;516;2;168;403;1;96;3;1;92;72;3;69
254621035;500;496;499;3;147;414;5;81;5;6;70;66;1;65
254621036;500;624;624;4;202;396;1;103;0;4;99;99;7;92
254621037;500;624;624;3;192;405;1;94;3;4;87;98;4;94
254624001;700;774;774;7;313;560;1;139;6;4;129;174;6;168
254624002;700;759;759;10;329;379;1;320;6;14;300;9;4;5
254624003;900;963;963;6;388;681;1;218;4;4;210;170;3;167
254624004;800;861;862;8;355;611;1;188;1;5;182;167;9;158
254624005;800;959;959;6;346;586;5;209;8;6;195;137;10;127
254624006;900;950;950;9;340;720;1;179;7;6;166;161;6;155
254624007;600;753;753;6;319;465;1;134;6;2;126;185;7;178
254624008;900;991;991;7;333;740;4;156;4;3;149;177;5;172
254624009;500;600;600;6;216;403;1;96;3;0;93;120;7;113
254624010;400;439;449;9;215;280;1;119;3;5;111;96;7;89
254624011;700;731;731;10;315;552;2;146;3;5;138;169;7;162
254624012;200;92;92;8;35;164;1;35;2;0;33;0;0;0
254624013;700;801;802;5;322;559;1;140;4;4;132;182;13;169
254624014;400;484;484;9;204;304;2;94;3;4;87;110;11;99
254624015;300;200;200;28;92;207;1;92;3;1;88;0;0;0
254624016;200;98;98;66;98;101;1;98;3;6;89;0;0;0
254624017;100;22;22;19;40;59;1;40;0;2;38;0;0;0
254624018;100;65;65;11;46;53;1;46;0;2;44;0;0;0
254624019;100;17;17;13;28;71;1;28;2;1;25;0;0;0
260600001;700;766;766;3;342;463;3;234;10;19;205;108;7;101
260600002;600;642;642;4;335;408;2;190;10;15;165;145;10;135
260600003;500;643;644;0;318;288;3;209;5;24;180;109;5;104
260600004;800;803;810;0;409;474;1;325;15;27;283;84;8;76
260600005;500;665;666;9;332;274;2;224;9;23;192;108;11;97
260600006;800;893;893;6;466;494;1;305;9;32;264;161;12;149
260600007;500;578;577;2;367;231;1;268;3;36;229;99;4;95
260600008;500;593;593;7;347;290;1;209;4;13;192;138;13;125
260600009;400;491;491;2;308;172;11;217;10;20;187;91;6;85
260600010;300;361;361;6;217;142;2;156;3;13;140;61;1;60
260600011;300;260;260;4;197;102;1;197;7;9;181;0;0;0
260600012;200;129;129;8;101;98;1;101;3;6;92;0;0;0
260700001;300;581;582;1;233;196;1;103;1;2;100;130;8;122
260700002;400;677;677;6;204;251;1;148;2;10;136;56;0;56
260700003;500;863;864;5;276;349;1;150;2;0;148;126;5;121
260700004;400;820;821;4;294;241;1;158;5;2;151;136;2;134
260700005;400;820;821;2;298;252;2;146;3;7;136;149;8;141
260700006;500;843;843;7;291;322;3;175;5;5;165;116;8;108
260700007;500;936;937;0;347;345;1;154;2;5;147;193;11;182
260700008;400;779;779;7;283;275;1;124;0;7;117;159;7;152
260700009;400;653;653;6;253;277;2;121;3;1;117;132;9;123
260700010;400;712;712;5;232;255;1;144;3;5;136;88;4;84
260700011;500;826;827;5;272;344;1;155;5;5;145;117;1;116
260700012;400;771;771;6;133;327;1;72;3;0;69;61;2;59
260700013;400;802;804;3;197;326;1;73;5;3;65;124;9;115
260700014;300;515;515;3;119;212;2;86;4;5;77;33;1;32
260700015;500;950;947;3;97;419;1;80;9;2;69;17;0;17
260700016;400;797;800;4;129;313;1;86;1;1;84;43;2;41
260700017;400;675;676;5;224;300;1;99;8;4;87;125;3;122
260700018;500;869;869;3;301;338;1;161;3;3;155;140;7;133
260700019;400;695;696;3;123;336;1;63;3;3;57;60;4;56
260700020;400;691;692;5;184;318;1;81;3;1;77;103;5;98
260700021;400;776;778;5;229;290;1;109;5;4;100;120;5;115
260700022;400;696;698;1;188;315;1;84;3;1;80;104;2;102
260700023;400;772;778;4;227;274;1;125;5;3;117;102;5;97
260700024;100;550;55;6;37;61;2;37;1;0;36;0;0;0
260700025;500;692;692;6;201;376;2;122;1;3;118;79;0;79
260700026;500;666;667;6;216;375;1;124;3;2;119;92;6;86
260700027;400;458;458;3;161;306;1;93;4;4;85;68;7;61
260700028;400;677;678;4;201;262;1;137;5;3;129;64;5;59
260700029;500;734;734;4;237;266;1;233;4;8;221;4;0;4
260700030;400;601;601;5;187;288;1;111;2;3;106;76;4;72
260700031;400;565;565;4;178;252;1;147;10;1;136;31;2;29
260700032;300;414;414;5;119;204;1;95;6;2;87;24;0;24
260700033;100;77;77;5;63;35;2;63;3;1;59;0;0;0
260700034;100;74;75;8;47;52;1;47;1;1;45;0;0;0
260700035;100;28;28;7;27;72;1;27;0;0;27;0;0;0
260700036;400;697;694;5;169;263;1;136;10;3;123;33;3;30
260700037;400;702;702;0;92;326;1;73;5;1;67;19;2;17
260700038;200;173;174;5;90;109;1;90;5;3;82;0;0;0
260700039;100;91;91;7;56;43;1;56;3;2;51;0;0;0
260700040;100;97;97;6;53;46;1;53;3;0;50;0;0;0
260700041;500;754;755;2;205;362;2;136;9;3;124;69;3;66
260700042;400;671;671;0;197;278;1;121;8;0;113;76;4;72
260700043;500;754;757;3;196;368;1;131;8;2;121;65;1;64
260700044;400;547;547;4;143;305;1;94;7;2;85;49;1;48
260700045;100;33;33;13;23;76;1;23;0;1;22;0;0;0
260900001;600;662;663;2;220;451;2;147;7;6;134;73;9;64
260900002;600;662;662;6;213;433;1;166;6;6;154;47;1;46
260900003;600;728;729;2;216;456;2;142;5;7;130;74;1;73
260900004;500;599;599;2;217;326;1;173;7;7;159;44;3;41
260900005;800;905;906;0;242;627;1;172;6;5;161;70;5;65
260900006;200;115;115;9;82;117;1;82;6;2;74;0;0;0
260900007;100;47;47;7;39;60;1;39;6;1;32;0;0;0
260900008;100;75;75;6;42;57;1;42;1;0;41;0;0;0
260900009;200;116;116;6;59;140;1;59;4;7;48;0;0;0
260900010;100;68;68;8;40;59;1;40;3;0;37;0;0;0
260900011;200;158;158;6;92;107;1;92;5;2;85;0;0;0
261000001;500;607;608;6;192;401;1;98;3;4;91;94;2;92
261000002;500;498;499;4;148;427;1;72;0;2;70;76;10;66
261000003;400;448;450;5;112;314;2;84;5;5;74;28;0;28
261000004;250;229;229;3;101;145;4;101;4;6;91;0;0;0
261000005;250;262;262;6;122;127;1;122;5;4;113;0;0;0
261000006;800;820;820;6;216;649;6;145;5;3;137;71;1;70
261000007;100;135;135;5;66;33;1;66;0;2;64;0;0;0
261000008;100;138;138;4;64;34;2;64;1;6;57;0;0;0
261000009;150;156;156;5;68;81;1;68;0;3;65;0;0;0
261000010;200;180;180;6;69;129;2;69;1;3;65;0;0;0
261000011;200;210;210;2;101;98;1;101;2;4;95;0;0;0
261000012;100;133;133;6;62;37;1;62;5;0;57;0;0;0
261000013;300;340;340;2;134;165;1;134;0;6;128;0;0;0
261000014;150;191;192;2;86;63;1;86;5;3;78;0;0;0
261000015;200;169;169;3;48;151;1;48;1;0;47;0;0;0
261600001;500;603;603;5;190;363;2;135;4;4;127;55;0;55
261600002;400;585;585;7;209;281;1;118;2;5;111;91;5;86
261600003;400;514;514;7;191;278;2;120;8;3;109;71;6;65
261600004;550;673;673;4;202;398;1;151;9;4;138;51;4;47
261600005;300;291;291;3;118;181;1;118;6;6;106;0;0;0
261600006;100;58;58;8;51;48;1;51;0;0;51;0;0;0
261600007;100;56;56;6;38;61;1;38;2;0;36;0;0;0
261600008;150;129;129;6;76;73;1;76;1;3;72;0;0;0
261600010;70;43;43;6;39;30;1;39;1;0;38;0;0;0
261600011;100;55;55;6;45;54;1;45;0;1;44;0;0;0
261600012;50;36;36;7;32;17;1;32;0;0;32;0;0;0
261600013;150;110;110;4;30;119;1;30;0;0;30;0;0;0
261600014;150;140;140;5;67;81;2;67;3;2;62;0;0;0
261600015;400;399;399;3;159;286;1;113;5;4;104;46;4;42
261600016;100;54;54;8;30;69;1;30;1;0;29;0;0;0
261600017;130;108;108;6;56;73;1;56;2;2;52;0;0;0
261600019;100;82;82;7;47;52;1;47;0;0;47;0;0;0
261600020;50;37;37;7;29;20;1;29;1;0;28;0;0;0
261700001;700;774;774;5;194;602;1;97;3;3;91;97;1;96
261700002;600;621;621;2;187;509;1;90;1;7;82;97;5;92
261700003;700;755;756;7;195;609;1;90;0;2;88;105;4;101
261700004;1000;999;999;1;314;841;1;158;1;4;153;156;9;147
261700005;900;907;907;1;219;794;1;105;3;2;100;114;7;107
261700006;900;923;923;5;252;783;2;115;4;1;110;137;3;134
261700007;700;759;759;2;191;550;2;148;3;3;142;43;4;39
261700008;100;19;19;9;24;75;1;24;0;1;23;0;0;0
261700009;700;806;806;0;231;594;1;105;1;9;95;126;10;116
261700010;700;698;698;2;153;620;1;79;5;0;74;74;3;71
261700011;700;765;766;1;160;586;1;113;4;6;103;49;2;44
261700012;500;531;532;1;163;423;3;74;1;0;73;89;1;88
261700013;900;892;892;6;272;700;1;199;3;11;185;73;2;71
261700014;800;824;825;2;209;707;1;92;1;5;86;117;5;112
261700015;400;362;362;3;96;355;1;44;2;0;42;52;5;47
261700016;300;292;292;3;84;213;3;84;3;4;77;0;0;0
261700017;400;465;465;4;133;337;1;62;0;1;61;71;3;68
261700018;600;638;639;4;188;526;1;73;2;10;61;115;6;109
261700019;800;874;874;3;258;647;1;152;4;7;141;106;4;102
261700020;300;361;361;7;128;240;1;59;2;4;53;69;5;64
261700021;500;553;553;0;137;427;1;72;3;4;65;65;3;62
261700022;400;325;325;4;160;239;1;160;1;4;155;0;0;0
261700023;100;70;70;3;57;42;1;57;0;2;55;0;0;0
261700024;200;163;163;5;95;104;1;95;5;3;87;0;0;0
261700025;500;563;565;1;163;401;1;98;6;7;85;65;2;63
261700026;800;782;782;7;131;732;1;67;3;2;62;64;3;61
261700027;600;580;580;0;151;491;1;108;3;3;102;43;1;42
261700028;500;549;530;3;145;388;1;111;3;3;105;34;3;31
261700029;200;109;109;4;58;139;3;58;1;0;57;0;0;0
261700030;100;70;70;6;31;68;1;31;0;2;29;0;0;0
261700031;100;49;49;4;38;61;1;38;0;2;36;0;0;0
261700032;300;266;253;5;148;151;1;148;3;2;143;0;0;0
261700033;400;456;456;4;161;347;1;52;1;0;51;109;6;103
261800001;700;726;726;2;280;496;1;203;9;2;192;77;4;73
261800002;800;821;821;2;266;606;1;193;8;1;184;73;1;72
261800003;700;778;778;1;285;507;14;179;13;0;166;106;6;100
261800004;600;687;687;2;309;397;2;201;7;8;186;108;1;107
261800005;1000;986;987;10;388;692;3;305;19;2;284;83;3;80
261800006;800;868;871;1;357;590;1;209;13;3;193;148;2;146
261800007;700;737;737;2;303;501;1;198;6;8;184;105;4;101
261800008;700;693;694;9;296;410;3;287;11;3;273;9;4;5
261800009;800;818;819;1;347;583;1;216;4;3;209;131;8;123
261800010;800;785;785;2;292;603;1;196;11;4;181;96;8;88
261800011;800;857;857;4;327;566;1;233;11;5;217;94;9;85
261800013;200;141;141;6;84;115;1;84;3;0;81;0;0;0
261800014;100;73;73;7;40;59;1;40;0;0;40;0;0;0
261800015;100;61;61;11;51;48;1;51;5;0;46;0;0;0
261800016;100;81;81;8;62;37;1;62;1;0;61;0;0;0
261800017;200;114;114;11;82;117;1;82;6;1;75;0;0;0
261800018;300;254;255;3;136;163;1;136;8;3;125;0;0;0
261800019;200;166;166;7;104;95;1;104;6;1;97;0;0;0
261800020;300;276;276;4;172;127;1;172;12;4;156;0;0;0
262000001;900;872;874;2;250;725;2;173;9;2;162;77;2;75
262000002;800;862;862;7;221;671;1;128;12;4;112;93;3;90
262000003;723;729;729;4;217;585;1;137;9;3;125;80;4;76
262000004;900;913;913;8;258;706;1;193;4;5;184;65;3;62
262000005;800;877;877;3;260;608;2;190;7;3;180;70;1;69
262000006;900;228;844;3;231;742;2;156;13;6;137;75;2;73
262000007;700;751;751;7;260;529;1;170;4;7;159;90;7;83
262000008;500;534;536;6;193;382;1;117;1;5;111;76;5;71
262000009;800;862;867;4;235;649;1;150;1;2;147;85;5;80
262000010;300;358;359;7;133;174;1;125;15;1;109;8;1;7
262000011;1000;1074;1075;6;444;555;1;444;34;3;407;0;0;0
262000012;900;1009;1009;4;505;394;1;505;30;2;473;0;0;0
262000013;200;172;167;5;76;118;6;76;5;3;68;0;0;0
262000014;400;399;399;5;181;282;1;117;7;2;108;64;7;57
262000015;200;233;235;5;125;74;1;125;3;2;120;0;0;0
262000016;200;133;133;4;62;137;1;62;2;1;59;0;0;0
262000017;100;14;21;6;20;79;1;20;2;0;18;0;0;0
262000018;100;67;67;6;52;47;1;52;2;0;50;0;0;0
262000019;400;398;398;7;136;303;1;96;8;1;87;40;1;39
262000020;200;194;194;4;124;75;1;124;3;2;119;0;0;0
262000021;100;52;52;4;38;61;1;38;1;0;37;0;0;0
262000022;100;35;40;5;40;59;1;40;3;0;37;0;0;0
262000023;100;37;37;5;28;70;2;28;1;1;26;0;0;0
262000024;500;510;510;4;186;364;1;135;10;2;123;51;4;47
262000025;300;288;288;4;97;202;1;97;7;2;88;0;0;0
262000026;600;658;658;5;163;481;1;118;4;2;112;45;3;42
262000027;100;26;26;8;23;76;1;23;1;0;22;0;0;0
262000028;100;63;63;5;56;43;1;56;8;0;48;0;0;0
262000029;100;67;67;6;47;52;1;47;1;1;45;0;0;0
262000030;900;1019;1019;4;394;515;1;384;42;0;342;10;0;10
262400001;700;673;688;0;258;523;2;175;9;5;161;83;1;82
262400002;700;692;705;1;264;538;1;161;7;12;142;103;5;98
262400003;400;384;389;0;157;301;1;98;6;2;90;59;3;56
262500001;600;620;622;3;198;474;1;125;2;4;119;73;5;68
262500002;600;585;593;4;169;507;1;92;3;2;87;77;4;73
262500003;500;562;562;3;191;381;1;118;5;5;108;73;5;68
262500004;800;821;822;5;184;695;5;100;1;1;98;84;4;80
262500005;400;455;464;3;156;301;2;97;3;2;92;59;4;55
262500006;600;584;586;7;213;461;1;138;4;8;126;75;3;72
262500007;600;669;672;5;181;499;1;100;4;5;91;81;4;77
262500008;500;501;503;7;170;401;1;98;1;5;92;72;4;68
262500009;700;670;671;4;194;575;1;124;4;4;116;70;2;68
262500010;500;550;550;3;162;393;1;106;4;3;99;56;3;53
262500011;700;716;722;7;214;549;1;150;7;1;142;64;3;61
262500012;500;482;484;5;133;417;1;82;2;4;76;51;6;45
262500013;500;544;548;6;147;393;1;106;5;3;98;41;3;38
262500014;700;719;720;0;184;558;1;141;10;2;129;43;0;43
262500015;500;539;539;3;154;405;2;93;4;0;89;61;2;59
262500016;600;578;582;2;172;484;1;115;2;3;110;57;2;55
262500017;200;161;161;8;55;145;0;55;3;0;52;0;0;0
262500018;200;182;190;1;98;101;1;98;4;2;92;0;0;0
262500019;100;45;47;7;37;62;1;37;1;0;36;0;0;0
262500020;100;28;28;0;28;71;1;28;0;0;28;0;0;0
262500021;100;22;22;11;33;65;2;33;2;3;28;0;0;0
262600001;600;616;616;9;191;476;1;123;3;3;117;68;1;67
262600002;600;759;768;7;235;470;1;129;4;2;123;106;6;100
262600003;700;840;839;8;238;559;1;140;1;6;133;98;0;98
262600004;700;817;818;6;274;543;1;156;5;2;149;118;4;114
262600005;700;719;719;8;239;571;1;128;4;1;123;111;0;111
262600006;700;759;765;4;279;528;4;168;4;3;161;111;7;104
262600007;700;767;767;6;290;514;2;184;5;8;171;106;10;96
262600008;700;749;749;8;234;556;1;143;2;5;136;91;5;86
262600009;800;903;905;9;276;635;1;164;7;4;153;112;4;108
262600010;800;882;883;6;298;649;1;150;4;5;141;148;8;140
262600011;800;891;894;5;296;620;2;178;5;5;168;118;4;114
262600012;700;754;754;1;250;536;1;163;8;5;150;87;3;84
262600013;800;794;796;2;278;617;1;182;4;11;167;96;4;92
262600014;500;451;452;3;205;365;1;134;10;3;121;71;2;69
262600015;200;78;79;5;51;148;1;51;4;5;42;0;0;0
262600016;400;312;312;3;165;234;1;165;6;4;155;0;0;0
262600017;200;164;164;3;74;125;1;74;4;0;70;0;0;0
262600018;800;902;902;5;288;582;1;217;9;3;205;71;2;69
262600019;700;732;732;6;254;511;1;188;9;3;176;66;2;64
262600020;300;274;278;5;129;169;2;129;3;3;123;0;0;0
262600021;300;203;203;4;135;163;2;135;5;2;128;0;0;0
262600022;200;100;101;7;73;126;1;73;0;4;69;0;0;0
262600023;100;80;75;5;46;53;1;46;1;1;44;0;0;0
262600024;100;43;43;7;29;69;2;29;1;1;27;0;0;0
262600025;100;15;15;5;19;80;1;19;0;0;19;0;0;0
263400001;700;824;825;6;327;515;1;184;1;3;180;143;9;134
263400002;500;593;596;4;209;409;1;90;0;2;88;119;6;113
263400003;550;641;642;5;175;482;1;67;4;3;60;108;6;102
263400004;600;711;711;2;239;506;1;93;4;2;87;146;10;136
263400005;500;695;695;2;182;429;1;70;3;1;66;112;5;107
263400006;500;476;462;4;182;338;1;161;14;7;140;21;3;18
263400007;250;204;189;5;113;136;1;113;18;5;90;0;0;0
263400008;100;47;47;6;41;58;1;41;1;2;38;0;0;0
263400009;150;106;106;6;69;80;1;69;1;3;65;0;0;0
263400010;100;59;59;7;41;58;1;41;0;3;38;0;0;0
263400011;700;768;769;6;282;454;1;245;46;3;196;37;1;36
263400012;150;94;94;7;55;94;1;55;2;2;51;0;0;0
263400013;500;456;445;4;252;251;20;229;19;7;203;23;0;23
263400014;300;243;244;3;131;168;1;131;8;4;119;0;0;0
263400015;200;156;156;6;87;112;1;87;4;0;83;0;0;0
263900001;500;560;560;0;104;433;1;66;6;0;60;38;2;36
263900002;500;347;348;2;119;448;1;51;0;1;50;68;2;66
263900003;1000;839;839;4;196;873;1;126;4;0;122;70;3;67
263900004;500;608;608;2;129;409;1;90;8;1;81;39;1;38
263900005;500;679;680;7;159;393;5;102;5;3;94;57;2;55
263900006;500;574;574;2;117;431;1;68;3;1;64;49;0;49
263900007;500;675;676;0;221;371;1;128;8;1;119;93;6;87
263900008;500;752;753;3;168;397;1;102;7;1;94;66;3;63
263900009;500;650;650;3;193;406;2;92;6;2;84;101;4;97
263900010;500;465;465;0;153;412;1;87;4;1;82;66;3;63
263900011;500;439;439;2;132;420;3;77;2;3;72;55;0;55
263900012;500;526;526;5;192;378;1;121;3;7;111;71;5;66
263900013;500;625;625;0;217;392;1;107;3;4;100;110;2;108
263900014;500;696;697;4;202;392;1;107;3;2;102;95;7;88
263900015;500;578;579;6;209;357;2;141;4;10;127;68;3;65
263900016;500;657;658;0;196;397;1;102;4;3;95;94;3;91
263900017;500;580;582;6;165;395;1;104;3;5;96;61;4;57
263900018;500;578;578;6;157;406;1;93;2;7;84;64;3;61
263900019;500;498;500;6;166;422;1;77;2;0;75;89;1;88
263900020;500;492;492;4;151;426;2;72;3;1;68;79;4;75
263900021;500;479;480;3;115;432;1;67;5;0;62;48;0;48
263900022;100;62;62;6;29;70;1;29;0;0;29;0;0;0
263900023;500;385;385;2;91;436;2;62;6;0;56;29;2;27
263900024;500;692;694;4;216;379;3;118;5;5;108;98;4;94
263900025;500;706;709;1;200;379;1;120;1;6;113;80;3;77
263900026;500;619;619;1;191;401;1;98;10;3;85;93;3;90
263900027;500;194;653;2;194;381;1;118;2;2;114;76;2;74
263900028;500;586;586;0;142;421;1;78;2;3;73;64;5;59
263900029;500;633;634;8;206;296;1;203;5;4;194;3;1;2
263900030;1000;828;829;0;251;881;1;118;3;4;111;133;8;125
263900031;1000;707;717;2;201;876;1;123;4;3;116;78;4;74
263900032;1000;883;883;5;518;482;1;517;10;0;507;1;0;1
263900033;1000;819;821;0;219;780;1;219;17;0;202;0;0;0
263900034;1000;876;876;0;96;903;1;96;20;0;76;0;0;0
263900035;500;628;628;3;273;228;1;271;21;0;250;2;0;2
263900036;1000;991;991;3;604;400;1;594;34;0;567;5;0;5
263900037;100;91;91;6;53;46;1;53;2;1;50;0;0;0
263900038;200;66;66;4;42;157;1;42;1;0;41;0;0;0
263900039;200;181;183;1;73;126;1;73;3;0;70;0;0;0
263900040;100;127;127;5;67;32;1;67;6;4;57;0;0;0
263900041;100;99;100;5;56;42;2;56;1;1;54;0;0;0
263900042;500;708;708;0;188;369;1;130;6;6;118;58;3;55
263900043;100;92;92;2;52;45;3;52;0;1;51;0;0;0
263900044;200;213;210;3;99;100;1;99;8;4;87;0;0;0
263900045;500;329;329;4;104;395;1;104;11;3;90;0;0;0
263900046;200;176;176;5;99;100;1;99;7;1;91;0;0;0
263900047;200;141;141;0;72;127;1;72;4;0;68;0;0;0
263900048;200;221;221;2;117;82;1;117;3;4;110;0;0;0
263900049;200;156;156;1;109;90;1;109;6;3;100;0;0;0
263900050;200;179;179;2;103;96;1;103;5;5;93;0;0;0
263900051;200;204;205;0;69;129;2;69;2;3;64;0;0;0
263900052;500;294;296;0;60;439;1;60;0;3;57;0;0;0
263900053;500;399;403;1;122;429;1;70;0;2;68;52;2;50
263900054;500;486;486;2;163;390;1;109;1;2;106;54;1;53
263900055;500;518;518;0;211;342;3;155;3;5;147;56;5;51
263900056;500;443;445;0;168;339;2;159;2;1;154;9;0;9
263900057;200;214;215;3;107;92;1;107;3;2;102;0;0;0
263900058;500;311;311;1;156;374;1;125;5;2;118;31;1;30
263900059;500;445;445;1;185;354;1;145;6;3;136;40;1;39
263900060;500;509;510;0;248;322;1;177;7;5;165;71;2;69
263900061;500;342;342;0;165;383;1;116;6;3;107;49;1;48
263900062;500;496;496;2;134;393;1;106;2;3;101;28;3;25
263900063;500;480;481;0;156;402;1;97;4;0;93;59;3;56
263900064;50;47;47;2;37;12;1;37;8;2;27;0;0;0
263900066;25;17;17;0;17;8;0;17;0;0;17;0;0;0
263900067;25;8;8;11;19;5;1;19;1;1;17;0;0;0
264300001;700;813;813;6;308;551;1;148;0;4;144;160;8;152
264300002;700;869;871;2;328;536;1;163;2;4;157;165;11;154
264300003;600;732;732;4;158;510;1;89;0;3;86;69;2;67
264300004;600;726;726;7;189;470;1;129;3;7;119;60;0;60
264300005;600;724;725;7;213;476;1;123;9;6;108;90;4;86
264300006;700;776;776;6;197;591;1;108;6;4;98;89;5;84
264300007;700;894;894;7;236;577;1;122;3;5;114;114;4;110
264300008;700;869;871;5;263;552;1;147;6;6;135;116;12;104
264300009;200;130;130;7;50;149;1;50;4;1;45;0;0;0
264300010;200;56;117;3;56;144;0;56;0;2;54;0;0;0
264300011;100;50;51;8;29;70;1;29;1;1;27;0;0;0
264300012;200;139;139;4;57;142;1;57;0;4;53;0;0;0
264300013;500;585;585;7;158;364;5;131;4;0;127;27;0;27
264300014;500;480;482;1;105;414;1;85;2;1;82;20;0;20
264300015;200;149;149;4;58;141;1;58;6;3;49;0;0;0
264300016;700;175;748;6;181;596;3;101;2;4;95;80;5;75
264300017;400;406;406;4;133;289;1;110;8;1;101;23;3;20
264300018;500;490;490;2;137;397;1;102;3;1;98;35;1;34
264300019;100;21;21;7;16;83;1;16;0;0;16;0;0;0
264300020;100;37;37;6;25;74;1;25;2;0;23;0;0;0
264300021;200;116;116;6;51;148;1;51;2;1;48;0;0;0
264300022;100;37;37;1;25;74;1;25;1;0;24;0;0;0
264300023;600;600;600;6;169;474;1;125;9;3;113;44;0;38
264300024;600;592;592;3;149;518;1;81;4;2;75;68;1;67
264300025;100;78;78;3;30;69;1;30;1;0;29;0;0;0
264300026;200;147;147;4;64;135;1;64;1;3;60;0;0;0
264300027;700;725;725;4;274;485;1;214;9;4;201;60;0;60
264300028;700;728;728;3;237;530;1;169;7;3;159;68;2;66
264300029;100;52;52;8;22;77;1;22;1;0;21;0;0;0
264300030;100;63;63;7;31;68;1;31;0;0;31;0;0;0
264300031;100;67;67;6;29;70;1;29;1;0;28;0;0;0
264300032;300;242;242;7;111;187;2;111;4;6;101;0;0;0
264300033;400;310;310;5;163;236;1;163;12;2;149;0;0;0
264300034;100;55;59;5;55;43;2;55;1;1;53;0;0;0
264300035;100;63;63;6;40;59;1;40;1;0;39;0;0;0
264300036;300;201;201;2;62;233;5;62;5;0;57;0;0;0
264300037;600;706;706;8;275;405;0;195;3;2;190;80;4;76
264300038;100;54;54;4;25;74;1;25;0;0;25;0;0;0
264300039;700;744;744;6;211;488;1;211;29;7;175;0;0;0
264300040;600;643;644;3;213;435;1;164;2;8;154;49;2;47
264500001;50;35;35;8;27;22;1;27;0;1;26;0;0;0
264500002;110;97;97;7;62;47;1;62;0;4;58;0;0;0
264500003;750;778;779;0;201;622;1;127;4;9;114;74;3;71
264500004;750;748;748;2;239;583;1;166;4;2;160;73;4;69
264500005;550;556;556;2;176;446;2;102;1;3;98;74;3;71
264500006;550;543;543;5;159;443;2;105;3;2;100;54;3;51
264500007;600;583;583;0;189;492;1;107;3;1;103;82;7;75
264500008;750;238;752;0;238;621;2;127;4;5;118;111;2;109
264500009;510;557;557;0;145;447;1;62;0;2;60;83;6;77
264500010;650;680;680;0;186;543;1;106;5;1;100;80;4;76
264500011;500;557;557;0;176;391;1;108;4;4;100;68;3;65
264500012;500;538;538;3;145;412;1;87;2;1;84;58;2;56
264500013;450;492;493;0;130;386;1;63;4;1;58;67;4;63
264500014;30;19;19;8;20;9;1;20;1;0;19;0;0;0
264500015;80;56;56;6;37;42;1;37;2;0;35;0;0;0
264500016;120;88;88;7;55;64;1;55;5;6;44;0;0;0
264500017;50;24;24;6;26;23;1;26;2;1;23;0;0;0
264700001;655;651;654;0;169;558;1;96;4;4;88;73;4;69
264700002;450;447;450;0;129;378;1;71;5;2;64;58;1;57
264700003;680;677;679;0;210;557;1;122;7;5;110;88;5;83
264700004;595;592;593;1;198;486;1;108;3;3;102;90;6;84
264700005;535;534;536;0;154;429;1;105;7;3;95;49;1;48
264700006;592;590;598;1;183;481;1;110;12;1;97;73;2;71
264700007;542;540;551;1;168;443;1;98;6;1;91;70;1;69
264700008;218;216;217;2;86;131;1;86;2;2;82;0;0;0
264700009;145;143;143;1;70;73;2;70;1;8;61;0;0;0
264700010;175;171;171;5;83;91;1;83;3;2;78;0;0;0
264700011;13;10;10;0;10;2;1;10;0;0;10;0;0;0
265400001;700;671;671;2;195;582;1;117;5;5;107;78;1;77
265400002;500;536;536;0;129;429;1;70;2;1;67;59;4;55
265500001;400;441;441;4;135;299;1;100;4;6;90;34;1;33
265500002;400;448;451;0;133;341;1;58;1;1;56;75;2;73
265500003;300;350;350;2;130;248;1;51;2;2;47;79;5;74
265500004;600;572;572;0;176;520;2;78;4;2;72;98;8;89
265500005;500;501;512;0;135;412;2;86;5;2;79;49;2;47
265500006;600;619;622;5;205;468;1;131;11;1;119;74;5;69
265500007;600;640;642;3;176;497;1;102;5;3;94;74;4;70
265500008;500;548;548;0;156;410;1;89;6;3;80;67;2;65
265500009;600;560;561;2;144;524;1;75;4;6;65;69;3;66
265500010;600;610;615;0;169;522;1;77;1;2;74;92;6;86
265500011;500;497;499;0;165;429;2;69;0;3;66;96;3;93
265500012;600;580;580;4;173;493;1;106;3;1;102;67;3;64
265500013;100;15;15;0;11;88;1;11;1;1;9;0;0;0
265500014;100;14;14;0;14;85;1;14;0;1;13;0;0;0
265600001;500;608;610;1;147;422;1;77;0;5;72;70;5;65
265600002;450;533;533;1;126;382;1;67;4;4;59;59;3;56
265600003;200;186;186;5;72;127;1;72;1;2;69;0;0;0
265600004;200;226;226;4;103;96;1;103;3;6;94;0;0;0
265600005;50;53;53;7;32;17;1;32;0;2;30;0;0;0
265600006;100;78;78;6;40;59;1;40;4;1;35;0;0;0
265700001;600;550;551;0;200;467;1;132;6;6;120;68;4;64
265700002;400;431;430;0;148;289;0;111;8;1;102;37;4;33
265800001;650;641;644;0;233;496;2;152;4;12;136;81;8;73
265800002;530;580;589;6;230;389;1;140;7;5;128;90;4;86
265800003;20;11;11;0;10;9;1;10;2;0;8;0;0;0
265900001;600;634;649;3;313;372;1;227;19;8;200;86;1;85
265900002;600;632;639;6;361;291;1;308;25;2;281;53;2;51
265900003;600;615;623;1;327;362;1;237;17;4;216;90;8;82
265900004;500;574;585;2;302;254;1;245;24;3;218;57;3;54
265900005;500;553;553;1;318;237;1;262;10;9;243;56;5;51
265900006;700;693;693;7;412;309;1;390;33;1;356;22;0;22
265900007;100;75;75;11;80;17;3;80;20;0;60;0;0;0
265900008;100;35;35;2;37;63;0;37;2;1;34;0;0;0
270400001;400;420;420;4;167;275;2;123;5;1;117;44;1;43
270400002;100;55;55;5;30;69;1;30;0;0;30;0;0;0
270400003;200;164;164;3;83;116;1;83;2;0;81;0;0;0
270400004;400;377;378;3;154;261;1;138;9;0;129;16;0;16
270400005;400;460;462;3;133;271;1;128;9;4;115;5;0;5
270400006;400;464;465;3;154;258;1;141;10;0;131;13;0;13
270400007;400;482;482;3;170;267;1;132;2;2;128;38;2;36
270400008;400;517;519;3;188;245;1;154;9;0;145;34;0;34
270400009;220;236;237;4;115;103;2;115;7;2;106;0;0;0
270400010;400;458;459;4;158;246;2;152;17;0;135;6;0;6
270400011;500;585;586;3;284;219;1;280;9;0;271;4;0;4
270400012;400;424;424;5;131;277;1;122;11;1;110;9;0;9
270400013;100;55;55;6;41;58;1;41;2;2;37;0;0;0
270400014;200;169;169;3;93;106;1;93;4;4;85;0;0;0
270400015;120;108;108;5;69;50;1;69;1;2;66;0;0;0
270400016;100;37;37;4;29;70;1;29;0;1;28;0;0;0
270400017;100;57;57;5;34;65;1;34;0;1;33;0;0;0
270400018;120;116;116;4;68;52;0;68;0;2;66;0;0;0
270400019;100;30;30;6;20;79;1;20;2;0;18;0;0;0
270400020;100;77;78;5;26;73;1;26;0;0;26;0;0;0
270400021;100;95;95;7;50;49;1;50;5;1;44;0;0;0
270400022;100;57;57;6;33;66;1;33;2;1;30;0;0;0
270400023;140;133;134;5;74;65;1;74;4;1;69;0;0;0
270400024;20;13;13;1;13;7;0;13;1;0;12;0;0;0
270700001;600;651;651;9;257;411;1;188;14;4;170;69;1;68
270700002;700;689;689;6;285;509;1;190;6;6;178;95;3;92
270700003;600;658;658;7;266;415;1;184;5;7;172;82;1;81
270700004;500;481;481;7;218;356;2;142;7;9;126;76;1;75
270700005;700;721;721;6;273;534;1;165;14;3;148;108;6;102
270700006;800;779;779;4;331;566;3;231;12;4;215;100;3;97
270700007;800;780;781;4;324;577;1;222;6;4;212;102;2;100
270700008;500;548;549;6;153;396;1;103;9;1;93;50;1;49
270700009;500;623;623;5;188;376;4;120;7;3;110;68;6;62
270700010;300;240;240;4;103;194;3;103;8;3;92;0;0;0
270700011;200;139;139;6;84;115;1;84;5;3;76;0;0;0
270700012;100;62;62;4;49;50;1;49;1;1;47;0;0;0
270700013;100;32;32;7;28;70;2;28;0;0;28;0;0;0
270700014;200;75;173;5;75;124;1;75;1;1;73;0;0;0
270700015;600;593;593;4;263;376;1;223;12;8;203;40;3;37
270700016;500;482;482;3;247;310;1;189;6;8;175;58;1;57
270700017;300;286;286;5;90;209;1;90;7;4;79;0;0;0
270700018;200;115;115;6;62;135;3;62;1;1;60;0;0;0
270700019;600;611;611;5;311;304;1;295;21;2;272;16;1;15
270700020;600;689;689;4;248;375;1;224;17;4;203;24;0;24
270700021;200;164;164;3;92;107;1;92;4;5;83;0;0;0
270700022;100;14;14;11;25;74;1;25;0;1;24;0;0;0
271200001;700;808;808;8;264;555;1;144;6;6;132;120;4;116
271200002;700;776;777;6;240;564;3;133;6;2;125;107;3;104
271200003;600;718;719;4;167;506;1;93;2;0;91;74;1;73
271200004;500;528;528;6;176;421;1;78;1;1;76;98;3;95
271200005;700;793;794;4;255;553;1;146;1;1;144;109;4;105
271200006;700;789;791;3;241;588;1;111;2;1;108;130;2;128
271200007;600;712;714;5;238;482;2;116;0;3;113;122;1;121
271200008;600;618;618;6;239;492;1;107;3;2;102;132;6;126
271200009;800;919;919;5;326;622;1;177;8;5;164;149;5;144
271200010;500;641;641;10;220;403;1;96;2;3;91;124;11;113
271200011;700;842;844;8;267;555;1;144;3;7;134;123;2;121
271200012;600;660;665;5;204;489;1;110;5;3;102;94;5;89
271200013;600;678;679;5;209;504;1;95;3;0;92;114;1;113
271200014;700;829;833;10;300;544;2;154;13;6;135;146;5;141
271200015;600;663;664;7;225;487;1;112;2;4;106;113;6;107
271200016;600;708;708;6;256;468;3;129;4;3;122;127;9;118
271200017;600;677;681;6;270;479;1;120;1;4;115;150;8;142
271200018;600;646;648;11;224;503;1;96;2;2;92;128;4;124
271200019;800;939;942;9;323;639;3;158;2;7;149;165;7;158
271200020;600;686;686;7;244;484;1;115;4;1;110;129;6;123
271200021;500;626;628;6;232;384;2;114;5;3;106;118;5;113
271200022;600;756;756;7;259;458;2;140;2;4;134;119;3;116
271200023;700;847;847;7;309;568;2;130;3;0;127;179;7;172
271200024;800;908;912;10;308;648;1;151;6;3;142;157;3;154
271200025;700;803;806;6;253;543;3;154;7;2;145;99;5;94
271200026;700;745;749;5;169;613;2;85;4;2;79;84;2;82
271200027;800;873;875;8;239;621;1;178;6;3;169;61;2;59
271200028;500;629;630;10;163;404;1;95;5;1;89;68;6;62
271200029;600;735;735;10;173;516;1;83;3;2;78;89;5;84
271200030;600;614;614;7;149;530;1;69;4;1;64;80;3;77
271200031;800;853;853;6;208;682;3;115;1;3;111;93;5;88
271200032;800;821;864;4;212;710;1;89;5;0;84;123;8;115
271200033;700;781;789;6;181;604;1;95;3;4;88;86;7;79
271200034;600;719;719;7;216;475;1;124;8;5;111;92;4;88
271200035;600;713;717;6;209;486;1;113;5;4;104;96;2;94
271200036;700;769;769;6;203;584;1;115;7;2;106;88;1;87
271200037;800;852;855;7;235;547;18;235;14;0;221;0;0;0
271200038;1000;1029;1035;5;328;684;1;315;28;0;287;13;0;13
271200039;600;692;694;8;183;511;1;88;6;2;80;95;3;92
271200040;600;668;671;5;166;482;1;117;11;4;102;49;4;45
271200041;800;840;840;5;207;685;5;110;4;3;103;97;3;94
271200042;800;837;841;6;230;608;6;186;5;7;174;44;1;43
271200043;800;936;937;7;288;649;1;150;5;2;143;138;2;136
271200044;800;893;896;9;319;642;2;156;1;3;152;163;3;160
271200045;800;870;900;6;288;643;1;156;0;5;151;132;4;128
271200046;800;853;870;2;295;639;1;160;7;7;146;135;4;131
271200047;700;816;816;4;279;554;1;145;3;3;139;134;3;131
271200048;500;571;573;10;182;417;1;82;3;1;78;100;4;96
271200049;600;698;702;7;205;495;1;104;13;2;89;101;7;94
271200050;500;571;572;5;185;423;1;76;6;0;70;109;2;107
271200051;700;741;744;10;262;580;1;119;4;5;110;143;10;133
271200052;700;747;749;11;261;559;1;140;2;5;133;121;4;117
271200053;700;793;796;7;273;558;1;141;3;7;131;132;4;128
271200054;600;697;723;8;228;479;4;117;3;1;113;111;4;107
271200055;700;755;755;4;238;562;3;135;2;4;129;103;7;96
271200056;500;604;607;8;167;436;1;63;3;0;60;104;3;101
271200057;700;751;782;6;230;564;1;135;4;3;128;95;3;92
271200058;500;550;552;4;202;366;0;134;7;0;127;68;4;64
271200059;500;535;537;6;223;356;1;143;5;2;136;80;3;77
271200060;600;686;688;7;225;451;2;147;7;3;137;78;0;78
271200061;700;753;757;4;213;556;1;143;8;6;129;70;2;68
271200062;700;786;786;2;211;539;1;160;6;5;149;51;2;49
271200063;200;219;219;4;146;53;1;146;4;2;140;0;0;0
271200064;600;672;673;5;263;376;2;222;12;7;203;41;3;38
271200065;700;821;822;2;183;563;2;135;6;3;126;48;0;48
271200066;700;765;765;4;208;525;1;174;6;1;167;34;2;32
271200067;700;711;781;5;261;479;3;218;12;1;205;43;0;43
271200068;500;607;608;4;271;295;1;204;15;4;185;67;5;62
271200069;800;911;913;0;267;618;3;179;6;0;173;88;3;85
271200070;800;911;913;3;291;616;1;183;6;5;172;108;4;104
271200071;800;947;949;2;297;569;1;230;16;2;212;67;2;65
271200072;900;927;927;6;322;727;1;172;6;2;164;150;4;146
271200073;900;1000;1000;8;299;712;1;187;11;2;174;112;7;105
271200074;500;577;577;5;220;325;1;174;11;2;161;46;3;43
271200075;200;177;177;4;77;122;1;77;5;1;71;0;0;0
271200076;700;758;761;5;200;591;1;108;5;2;101;92;3;89
271200077;700;672;672;6;196;586;1;113;4;2;107;83;2;81
271200078;700;713;715;6;212;555;1;144;4;5;135;68;4;64
271200079;800;978;980;6;292;557;1;242;12;9;221;50;1;49
271200080;800;888;888;5;168;653;1;146;14;3;129;22;5;17
271200081;900;899;899;2;365;627;1;272;15;4;253;93;4;89
271200082;800;910;910;5;263;590;1;209;13;0;196;54;2;52
271200083;800;900;901;2;285;579;2;219;11;7;201;66;1;65
271200084;200;161;161;3;104;93;3;104;7;6;91;0;0;0
271200085;1000;1004;1005;4;203;811;1;188;9;5;174;15;2;13
271200086;500;447;464;7;187;346;1;153;5;3;145;34;2;32
271200087;100;68;68;8;47;52;1;47;5;2;40;0;0;0
271200088;100;44;44;3;20;80;0;20;0;0;20;0;0;0
271200089;100;11;11;25;27;72;1;27;0;0;27;0;0;0
271200090;100;14;14;4;15;85;0;15;1;0;14;0;0;0
271200091;100;11;11;5;16;84;0;16;0;0;16;0;0;0
272200001;500;579;579;3;169;365;11;124;11;2;111;45;0;45
272200002;500;640;640;0;181;380;7;113;7;3;103;68;3;65
272200003;648;649;649;4;207;504;2;142;9;9;124;65;2;63
272200004;700;802;804;8;414;309;1;390;44;2;344;24;0;24
272200005;500;708;709;4;96;435;1;64;4;1;59;32;5;27
272200006;500;881;881;2;142;414;1;85;16;4;65;57;0;57
272200007;500;999;999;1;127;393;1;106;6;0;100;21;0;21
272200008;300;233;234;3;113;186;1;113;0;2;111;0;0;0
272200009;600;659;659;5;183;470;1;129;10;0;119;54;0;54
272200010;500;399;399;4;167;367;1;132;3;2;127;35;0;35
272200011;500;480;480;2;243;278;1;221;11;0;210;22;1;21
272200012;500;415;415;1;190;308;2;190;13;1;176;0;0;0
272200013;500;585;585;5;185;370;1;129;2;2;125;56;1;55
272200014;500;502;504;1;236;285;1;214;20;2;192;22;1;21
272200015;500;400;400;6;149;357;1;142;7;1;134;7;0;7
272200016;600;665;665;2;303;301;1;298;27;0;271;5;0;5
272300001;200;254;254;4;101;98;1;101;6;1;94;0;0;0
272300002;100;39;39;6;27;72;1;27;0;1;26;0;0;0
272300003;200;180;180;3;81;118;1;81;4;0;77;0;0;0
272300004;200;191;191;3;71;128;1;71;4;1;66;0;0;0
272300005;100;155;156;3;69;29;2;69;3;0;66;0;0;0
272300006;100;70;70;5;41;58;1;41;3;0;38;0;0;0
272300007;100;132;132;3;77;22;1;77;1;3;73;0;0;0
272300008;100;46;46;3;39;60;1;39;1;0;38;0;0;0
272300009;200;143;143;5;82;117;1;82;4;2;76;0;0;0
272300010;200;181;181;7;94;105;1;94;2;1;91;0;0;0
272300011;100;58;58;5;34;65;1;34;2;1;31;0;0;0
272300012;200;198;199;2;99;100;1;99;4;0;95;0;0;0
272300013;200;311;311;5;128;70;2;128;13;2;113;0;0;0
272400001;700;769;769;5;293;486;1;213;12;6;195;80;3;77
272400002;700;755;755;5;344;469;3;228;8;6;214;116;3;113
272400003;800;758;768;4;310;561;2;237;13;2;222;73;2;71
272400004;200;263;263;1;139;60;1;139;3;12;124;0;0;0
272400005;100;51;47;4;35;64;1;35;2;0;33;0;0;0
272400006;600;651;655;0;239;415;2;183;6;1;176;56;1;55
272400007;500;578;579;1;219;337;3;160;5;6;149;59;1;58
272400008;600;593;594;2;225;390;1;209;2;8;199;16;4;12
272400009;600;632;632;3;237;376;8;216;7;6;203;21;0;21
272400010;700;585;707;4;280;429;1;270;13;2;254;10;0;10
272400011;800;791;803;3;245;609;2;189;8;3;178;56;4;52
272400012;700;791;795;2;304;423;1;276;13;0;263;28;0;28
272400013;800;805;809;1;370;453;2;345;27;3;315;25;0;25
272400014;500;531;534;1;137;384;3;113;1;6;106;24;1;23
272400015;500;527;527;3;171;343;1;156;12;4;140;15;0;15
272400016;1000;1087;1087;2;333;673;1;326;25;0;301;7;0;7
272400017;1000;1110;1112;6;361;651;1;348;9;2;337;13;0;13
272400018;800;835;846;3;363;455;1;344;22;3;319;19;1;18
272400019;500;593;593;3;223;302;1;197;4;0;193;26;1;25
272400020;500;593;595;3;229;268;4;228;6;3;219;1;0;1
272400021;200;104;104;13;46;153;1;46;1;5;40;0;0;0
272400022;100;20;20;0;20;79;1;20;3;0;17;0;0;0
272400023;100;18;18;0;18;81;1;18;0;0;18;0;0;0
272700001;300;616;629;7;240;143;2;155;7;2;146;85;1;84
272700002;300;669;670;7;213;165;1;134;6;6;122;79;2;77
272700003;300;760;760;7;260;116;9;175;1;4;170;85;2;83
272700004;300;778;779;11;266;138;1;161;4;3;154;105;2;103
272700005;300;614;614;6;207;169;1;130;2;3;125;77;3;74
272700006;300;710;710;7;208;169;1;130;4;2;124;78;2;76
272700007;300;772;775;2;250;151;1;148;6;5;137;102;2;100
272700008;300;790;791;6;288;117;1;182;3;7;172;106;4;102
272700009;300;803;803;6;270;124;1;175;4;4;167;95;4;91
272700010;300;761;763;7;262;134;1;165;5;4;156;97;6;91
272700011;300;795;795;6;196;165;1;134;6;4;124;62;1;61
272700012;300;737;738;8;278;88;1;211;6;9;196;67;1;66
272700013;300;840;842;3;287;115;9;176;8;4;164;111;5;106
272700014;300;619;623;5;227;150;1;149;1;6;142;78;4;74
272700015;300;508;508;3;134;192;4;104;6;2;96;30;4;26
272700016;300;464;466;2;114;212;3;85;2;2;81;29;2;27
272700017;100;65;65;6;29;70;1;29;1;1;27;0;0;0
272700018;300;302;308;4;125;174;1;125;8;0;117;0;0;0
272700019;100;171;171;6;87;12;1;87;3;2;82;0;0;0
272700020;200;179;180;6;98;101;1;98;4;4;90;0;0;0
272700021;100;128;128;6;59;40;1;59;5;2;52;0;0;0
272700022;300;336;336;5;154;167;1;132;9;0;123;22;0;22
272700023;300;312;313;8;135;164;1;135;9;1;125;0;0;0
272700024;300;336;336;6;101;212;1;87;2;3;82;14;1;13
272700025;100;30;30;4;17;82;1;17;0;0;17;0;0;0
272700026;100;38;38;6;16;83;1;16;0;0;16;0;0;0
272700027;100;45;45;8;23;76;1;23;2;0;21;0;0;0
272700028;100;52;52;7;29;70;1;29;1;0;28;0;0;0
272700029;300;470;471;6;167;179;1;120;0;10;110;47;3;44
272700030;100;88;89;6;53;46;1;53;2;0;51;0;0;0
272700031;100;72;72;7;53;45;2;53;1;2;50;0;0;0
272700032;100;47;47;7;22;77;1;22;1;0;21;0;0;0
272700033;300;307;307;5;84;214;2;84;1;2;81;0;0;0
272700034;100;85;85;6;57;42;1;57;3;2;52;0;0;0
272700035;300;325;327;6;148;151;1;148;6;4;138;0;0;0
272700036;300;291;291;6;76;223;1;76;8;0;68;0;0;0
272700037;200;207;207;35;56;143;1;56;6;0;50;0;0;0
272700038;100;13;13;0;13;86;1;13;0;0;13;0;0;0
273100001;500;731;733;7;139;423;1;76;5;3;68;63;5;58
273100002;600;886;888;8;169;511;1;88;5;4;79;81;6;75
273100003;600;915;919;5;205;482;1;117;5;3;109;88;3;85
273100004;500;855;855;6;177;419;2;79;4;2;73;98;4;94
273100005;400;669;670;5;138;313;1;86;7;0;79;52;2;50
273100006;400;677;678;9;218;281;1;118;5;2;111;100;2;98
273100007;500;869;872;8;247;373;1;126;3;2;121;121;3;118
273100008;600;894;894;6;303;445;1;154;6;4;144;149;6;143
273100009;500;759;759;5;202;383;1;116;4;1;111;86;1;85
273100010;500;813;813;7;251;369;1;130;0;2;128;121;8;113
273100011;500;882;882;8;261;350;3;147;6;2;139;114;2;112
273100012;700;1094;1097;7;392;328;8;364;7;18;339;28;2;26
273100013;600;993;993;9;317;436;3;161;7;4;150;156;4;152
273100014;501;730;732;8;264;343;3;155;0;7;148;109;3;106
273100015;500;795;795;7;269;341;1;158;2;5;151;111;5;106
273100016;600;917;919;9;344;425;1;174;5;3;166;170;11;159
273100017;500;724;724;10;229;367;3;130;3;1;126;99;4;95
273100018;500;767;769;6;279;359;1;140;3;7;130;139;4;135
273100019;600;832;832;7;321;436;1;163;3;5;155;158;5;153
273100020;500;773;773;8;241;367;1;132;3;4;125;109;7;102
273100021;500;888;890;7;223;378;1;121;7;3;111;102;3;99
273100022;500;835;837;9;315;332;4;164;6;4;154;151;6;145
273100023;500;762;763;7;268;362;1;137;4;4;129;131;10;121
273100024;400;568;570;9;189;291;1;108;3;4;101;81;4;77
273100025;300;505;505;5;141;218;1;81;3;1;77;60;2;58
273100026;500;792;792;6;246;350;1;149;1;5;143;97;1;96
273100027;500;835;835;11;302;322;1;177;4;10;163;125;6;119
273100028;700;1054;1054;8;339;533;1;166;8;2;156;173;4;169
273100029;600;922;922;8;366;415;8;177;6;4;167;187;10;177
273100030;500;727;728;7;282;340;1;159;3;6;150;123;8;115
273100031;400;697;697;10;265;271;1;128;3;3;122;137;4;133
273100032;500;784;784;8;289;359;1;140;2;3;135;149;5;144
273100033;500;788;788;6;306;349;1;150;3;5;142;156;12;144
273100034;500;852;852;6;314;346;1;153;2;3;148;161;7;154
273100035;500;736;736;4;263;365;1;134;5;4;125;129;9;120
273100036;400;581;581;7;192;301;1;98;0;4;94;94;5;89
273100037;300;528;528;8;205;194;1;105;3;1;101;100;8;92
273100038;500;873;873;9;326;356;3;141;2;7;132;185;13;172
273100039;600;925;926;6;329;442;3;155;7;2;146;174;8;166
273100040;600;893;893;8;333;418;4;178;5;4;169;155;7;148
273100041;500;815;816;8;302;351;2;147;3;4;140;155;12;143
273100042;400;664;665;8;239;282;2;116;6;3;107;123;9;114
273100043;500;785;785;6;315;349;3;148;2;4;142;167;7;160
273100044;500;800;800;8;290;364;1;135;2;3;130;155;2;153
273100045;500;859;861;12;250;367;2;131;3;6;122;119;7;112
273100046;500;830;830;4;261;371;1;128;3;3;122;133;3;130
273100047;500;877;877;3;280;365;1;134;11;6;117;146;6;140
273100048;300;519;519;7;130;234;1;65;2;2;61;65;8;57
273100049;400;597;597;5;187;312;1;87;2;2;83;100;3;97
273100050;500;734;753;6;299;353;1;146;1;2;143;153;7;146
273100051;400;723;723;8;276;263;1;136;6;3;127;140;3;137
273100052;500;876;879;8;371;288;2;210;1;5;204;161;7;154
273100053;500;762;762;6;298;355;1;144;6;4;134;154;7;147
273100054;500;819;819;8;297;332;1;167;4;5;158;130;3;127
273100055;500;783;786;8;327;346;1;153;5;5;143;174;10;164
273100056;600;898;901;7;385;429;1;170;6;6;158;215;8;207
273100057;500;775;777;8;294;366;1;133;1;1;131;161;8;153
273100058;500;811;811;8;304;338;2;160;1;8;151;144;8;136
273100059;300;499;502;11;187;206;1;93;2;0;91;94;1;93
273100060;500;804;804;7;288;381;1;118;1;2;115;171;3;168
273100061;500;784;784;6;248;377;1;122;4;4;114;126;5;121
273100062;400;550;550;9;215;301;1;98;3;3;92;117;5;112
273100063;200;121;121;32;102;97;1;102;12;2;88;0;0;0
273100064;500;862;863;9;295;338;13;149;5;6;138;146;2;144
273100065;600;904;906;8;340;431;1;168;4;3;161;172;10;162
273100066;600;964;964;8;351;410;1;189;4;6;179;162;7;155
273100067;600;995;996;8;370;398;8;194;5;5;184;176;11;165
273100068;400;696;697;10;276;266;3;131;5;2;124;145;3;142
273100069;500;795;795;8;312;348;1;151;4;2;145;161;13;148
273100070;600;964;964;10;321;429;1;170;5;6;159;151;15;136
273100071;600;907;909;8;367;402;2;196;2;4;190;171;6;165
273100072;500;874;874;11;339;352;2;146;2;1;143;193;5;188
273100073;500;726;727;12;245;371;1;128;1;2;125;117;3;114
273100074;500;727;728;7;266;383;2;115;4;2;109;151;8;143
273100075;500;730;733;14;305;340;3;157;2;2;153;147;7;140
273100076;600;929;932;7;407;416;1;183;3;3;177;224;3;221
273100077;500;735;735;6;295;340;1;159;1;2;156;136;7;129
273100078;700;1120;1120;8;444;500;3;197;11;3;183;247;8;239
273100079;500;802;802;9;317;334;1;165;6;3;156;152;9;143
273100080;400;644;665;5;287;284;2;114;3;1;110;173;2;171
273100081;400;543;548;9;222;293;1;106;3;0;103;116;3;113
273100082;500;748;749;7;274;363;2;135;5;4;126;139;4;135
273100083;500;803;803;9;284;350;1;149;3;4;142;134;3;131
273100084;600;935;937;7;358;438;1;161;5;2;154;197;13;184
273100085;400;580;580;6;166;321;1;78;1;2;75;88;2;86
273100086;700;1164;1169;6;382;516;2;182;5;5;172;200;7;193
273100087;600;915;918;7;334;441;1;158;1;7;150;176;4;172
273100088;400;702;702;2;226;310;1;89;1;1;87;137;6;131
273100089;700;1153;1153;8;90;632;2;66;18;0;48;24;1;23
273100090;600;967;967;10;184;426;2;172;11;9;152;12;1;11
273100091;500;759;759;8;294;349;1;150;3;5;142;144;10;134
273100092;500;770;770;6;287;262;1;237;3;11;223;50;3;47
273100093;400;651;651;11;240;276;1;123;3;2;118;117;6;111
273100094;600;885;885;5;322;429;1;170;1;4;165;152;5;147
273100095;600;935;935;6;341;440;1;159;3;3;153;182;13;169
273100096;400;649;651;9;223;278;4;118;4;3;111;105;1;104
273100097;600;989;990;6;376;409;3;188;3;4;181;188;8;180
273100098;400;653;653;8;251;270;2;128;2;3;123;123;4;119
273100099;500;801;801;9;301;345;1;154;5;4;145;147;6;141
273100100;500;751;751;9;294;354;1;145;6;4;135;149;5;144
273100101;400;598;598;6;222;290;1;109;4;4;101;113;7;106
273100102;500;806;808;9;239;369;2;129;9;6;114;110;1;109
273100103;400;598;601;8;180;304;2;94;2;2;90;86;5;81
273100104;300;492;493;9;175;230;1;69;1;4;64;106;1;105
273100105;600;1079;1041;8;390;395;1;204;7;0;197;186;10;176
273100106;300;492;492;8;155;226;1;73;0;1;72;82;6;76
273100107;400;670;671;8;241;277;1;122;1;5;116;119;5;114
273100108;400;608;611;6;237;280;1;119;4;4;111;118;4;114
273100109;600;895;895;9;320;300;1;299;8;15;276;21;0;21
273100110;400;591;591;7;171;309;1;90;2;5;83;81;2;79
273100111;500;847;848;6;283;375;1;124;5;4;115;159;5;154
273100112;400;571;571;10;179;294;1;105;4;4;97;74;1;73
273100113;600;914;914;7;309;452;1;147;4;2;141;162;7;155
273100114;400;650;651;9;209;293;1;106;6;1;99;103;3;100
273100115;600;888;888;9;308;453;1;146;2;3;141;162;5;157
273100116;500;857;858;6;283;367;4;129;3;2;124;154;7;147
273100117;600;918;919;4;310;425;2;173;0;9;164;137;3;134
273100118;500;799;784;15;278;380;2;118;4;2;112;160;11;149
273100119;600;877;881;2;262;443;3;154;2;10;142;108;5;103
273100120;700;1053;1056;4;317;511;4;185;7;5;173;132;8;124
273100121;500;775;780;7;234;369;1;130;5;3;122;104;6;98
273100122;500;784;786;6;276;339;2;159;4;10;145;117;6;111
273100123;500;750;750;11;209;399;1;100;7;3;90;109;5;104
273100124;400;561;562;7;174;318;1;81;2;0;79;93;2;91
273100125;500;783;783;7;270;384;1;115;3;3;109;155;5;150
273100126;500;735;735;6;217;385;1;114;6;4;104;103;4;99
273100127;500;852;852;5;283;355;3;142;4;6;132;141;10;131
273100128;500;738;739;6;211;390;2;108;1;1;106;103;4;99
273100129;500;769;770;6;211;390;1;109;0;2;107;102;9;93
273100130;500;830;831;5;261;297;5;198;2;9;187;63;5;58
273100131;500;832;832;8;217;406;1;93;5;3;85;124;5;119
273100132;700;1119;1120;8;112;585;3;112;17;0;95;0;0;0
273100133;700;1112;1113;7;155;545;5;150;14;2;134;5;0;5
273100134;700;1167;1167;7;273;441;1;258;18;3;237;15;0;15
273100135;700;1169;1169;11;173;533;1;166;22;1;143;7;0;7
273100136;700;1150;1150;8;160;538;2;160;29;0;131;0;0;0
273100137;700;1054;1045;9;68;633;1;66;12;0;54;2;0;2
273100138;700;1174;1175;9;134;577;2;121;22;3;96;13;0;13
273100139;500;841;842;7;296;255;2;243;9;1;233;53;0;53
273100140;500;773;775;5;255;384;3;113;4;3;106;142;6;136
273100141;500;835;835;4;250;364;1;135;4;7;124;115;4;111
273100142;500;803;803;8;238;375;1;124;4;2;118;114;1;113
273100143;500;872;873;4;253;377;1;122;5;3;114;131;6;125
273100144;500;791;792;4;252;374;2;124;2;4;118;128;3;125
273100145;200;42;42;40;63;136;1;63;0;7;56;0;0;0
273100146;600;962;964;4;267;461;1;138;3;6;129;129;3;126
273100147;600;924;924;3;336;429;1;170;5;8;157;166;11;155
273100148;500;830;833;7;242;400;1;99;0;3;96;143;8;135
273100149;500;867;867;1;270;382;4;114;3;5;106;156;9;147
273100150;700;635;637;8;167;548;1;151;17;0;134;16;0;16
273100151;100;54;54;5;49;50;1;49;0;0;49;0;0;0
273100152;200;111;111;5;61;138;1;61;2;4;55;0;0;0
273100153;1000;921;922;4;137;879;1;120;11;1;108;17;1;16
273100154;100;62;62;5;21;78;1;21;0;0;21;0;0;0
273100155;200;137;137;5;76;122;2;76;3;0;73;0;0;0
273100156;700;567;567;5;109;611;1;88;5;4;79;21;0;21
273100157;900;788;788;4;242;692;1;207;34;1;172;35;1;34
273100158;400;310;311;4;119;279;2;119;8;5;106;0;0;0
273100159;600;515;515;0;180;464;1;135;15;4;116;45;1;44
273100160;600;482;483;4;141;523;1;76;3;1;72;65;1;64
273100161;1100;965;967;6;274;881;1;218;11;0;207;56;5;51
273100162;300;211;211;7;96;203;1;96;1;5;90;0;0;0
273100163;100;41;41;6;30;69;1;30;0;1;29;0;0;0
273100164;500;446;446;1;153;402;3;95;2;6;87;58;0;58
273100165;300;236;237;6;141;157;2;141;3;6;132;0;0;0
273100166;200;124;124;7;86;113;1;86;2;8;76;0;0;0
273100167;300;244;244;6;159;140;1;159;3;5;151;0;0;0
273100168;200;110;110;6;80;119;1;80;3;0;77;0;0;0
273100169;200;102;102;8;61;137;2;61;2;1;58;0;0;0
273100170;100;78;78;5;60;39;1;60;0;2;58;0;0;0
273100171;100;66;66;6;56;42;2;56;1;2;53;0;0;0
273100172;300;182;182;6;129;170;1;129;4;6;119;0;0;0
273100173;100;85;86;6;66;33;1;66;0;1;65;0;0;0
273100174;100;81;81;4;72;27;1;72;6;2;64;0;0;0
273100175;500;417;417;5;159;394;2;104;3;0;101;55;3;52
273100176;100;48;48;5;39;60;1;39;1;0;38;0;0;0
273100177;500;451;451;5;195;398;1;101;6;3;92;94;4;90
273100178;700;616;624;2;220;571;3;126;4;5;117;94;11;83
273100179;600;536;537;4;174;508;2;90;3;0;87;84;2;82
273100180;600;492;493;5;95;530;1;69;1;2;66;26;0;26
273100181;400;318;319;3;148;251;1;148;5;3;140;0;0;0
273100182;300;186;186;7;89;210;1;89;3;3;83;0;0;0
273100183;800;747;749;7;234;612;1;187;15;1;171;47;0;47
273100184;400;346;347;7;163;234;3;163;6;6;151;0;0;0
273100185;200;90;90;6;58;141;1;58;1;1;56;0;0;0
273100186;100;52;52;7;46;53;1;46;3;0;43;0;0;0
273100187;200;88;88;7;51;148;1;51;0;0;51;0;0;0
273100188;300;207;207;5;105;194;1;105;7;1;97;0;0;0
273100189;100;30;31;7;16;83;1;16;0;0;16;0;0;0
273100190;200;105;106;5;48;151;1;48;6;2;40;0;0;0
273100191;300;271;271;6;105;193;2;105;3;1;101;0;0;0
273100192;300;200;201;6;78;221;1;78;2;0;76;0;0;0
273100193;300;202;202;3;98;201;1;98;5;1;92;0;0;0
273100194;200;111;111;6;66;133;1;66;3;0;63;0;0;0
273100195;700;612;612;5;204;532;1;167;8;4;155;37;1;36
273100196;500;374;374;4;159;402;1;97;2;3;92;62;3;59
273100197;700;616;616;3;203;568;1;131;8;2;121;72;2;70
273100198;200;186;186;6;76;123;1;76;3;1;72;0;0;0
273100199;200;89;89;5;55;144;1;55;2;3;50;0;0;0
273100200;600;505;506;3;156;475;1;124;3;2;119;32;2;30
273100201;800;747;746;8;292;574;1;225;18;5;202;67;3;64
273100202;300;218;219;4;146;153;1;146;11;4;131;0;0;0
273100203;300;244;244;5;61;238;1;61;9;2;50;0;0;0
273100204;500;728;728;7;251;396;1;103;2;4;97;148;8;140
273100205;600;976;976;4;320;418;1;181;0;7;174;139;3;136
273100206;300;28;28;66;74;225;1;74;5;4;65;0;0;0
273100207;200;30;30;6;31;168;1;31;1;1;29;0;0;0
273100208;100;36;36;37;71;27;2;71;8;6;57;0;0;0
273100209;100;41;41;12;52;47;1;52;8;0;44;0;0;0
273100210;100;22;22;5;27;71;2;27;0;0;27;0;0;0
273600001;500;666;668;5;213;374;1;125;3;2;120;88;4;84
273600002;500;733;735;6;177;394;1;105;5;1;99;72;4;68
273600003;500;770;772;3;186;328;1;171;2;2;167;15;0;15
273600004;500;712;714;6;233;329;1;170;12;2;156;63;0;63
273600005;500;719;724;7;242;331;1;168;7;7;154;74;2;72
273600006;600;660;663;7;304;296;2;302;14;3;285;2;0;2
273600007;800;832;834;7;302;505;2;293;24;1;268;9;0;9
273600008;500;658;660;3;143;408;1;91;10;0;81;52;2;50
273600009;500;704;706;2;178;377;1;122;9;0;113;56;2;54
273600010;500;727;732;2;204;358;3;139;4;1;134;65;2;63
273600011;500;741;741;2;170;418;1;81;10;2;69;89;2;87
273600012;500;584;586;2;192;386;2;112;4;4;104;80;1;79
273600013;500;662;665;1;184;391;1;108;2;3;103;76;4;72
273600014;500;577;577;6;154;403;1;96;3;3;90;58;0;58
273600015;500;703;704;6;198;373;1;126;3;3;120;72;2;70
273600016;500;613;612;2;189;384;2;114;1;1;112;75;4;71
273600017;500;556;556;5;205;381;1;118;4;3;111;87;2;85
273600018;500;859;863;4;175;408;1;91;4;1;86;84;2;82
273600019;100;13;13;3;7;92;1;7;0;0;7;0;0;0
273600020;500;525;525;6;204;310;1;189;15;3;171;15;1;14
273600021;500;170;464;2;172;350;2;148;21;1;126;24;1;23
273600022;200;165;167;6;60;139;1;60;5;1;54;0;0;0
273600023;100;50;51;8;38;61;1;38;1;0;37;0;0;0
273600024;200;107;110;5;34;165;1;34;1;0;33;0;0;0
273600025;500;783;787;9;317;191;2;307;65;2;240;10;0;10
273600026;500;494;495;6;140;374;2;124;11;2;111;16;0;16
273600027;100;69;63;6;28;71;1;28;1;0;27;0;0;0
273600029;100;56;57;6;29;70;1;29;3;4;22;0;0;0
273600030;200;127;127;6;78;121;1;78;0;0;78;0;0;0
273600031;200;122;122;3;88;111;1;88;6;0;82;0;0;0
273600032;600;677;681;7;321;491;2;107;10;0;97;214;0;214
273600033;200;122;122;5;74;125;1;74;2;1;71;0;0;0
273600034;200;148;148;5;79;120;1;79;6;0;73;0;0;0
273600035;400;337;339;4;129;271;1;128;12;6;110;1;0;1
273600036;200;169;171;4;77;122;1;77;1;1;75;0;0;0
273600037;100;93;93;4;58;40;2;58;2;2;54;0;0;0
273600038;100;59;59;5;48;51;1;48;0;0;48;0;0;0
273600040;100;24;24;0;21;79;0;21;0;0;21;0;0;0
273700001;500;732;732;8;223;355;13;132;11;1;120;91;5;86
273700002;500;786;795;4;260;324;3;173;9;3;161;87;2;85
273700003;600;820;820;2;244;392;1;207;13;2;192;37;0;37
273700004;500;608;608;6;181;343;1;156;17;2;137;25;2;23
273700005;600;811;815;6;258;351;1;248;20;3;225;10;1;9
273700006;300;300;300;3;73;245;1;54;6;1;47;19;2;17
273700007;100;25;26;5;14;84;2;14;0;0;14;0;0;0
273700008;100;20;20;8;20;79;1;20;0;0;20;0;0;0
273700009;100;15;15;7;12;86;2;12;2;0;10;0;0;0
273700010;100;15;15;0;14;85;1;14;1;0;13;0;0;0
273700011;100;14;14;1;14;85;1;14;0;0;14;0;0;0
273800001;500;735;743;2;252;302;1;197;8;3;186;55;1;54
273800002;500;447;756;1;200;338;1;161;11;2;148;39;0;39
273800003;600;846;847;2;222;383;1;216;20;1;195;6;0;6
273800004;400;320;320;6;163;236;1;163;5;0;158;0;0;0
273800005;500;620;623;8;251;259;1;240;16;2;222;11;0;11
273800006;400;418;421;6;216;200;1;199;14;1;184;17;0;17
273800007;100;21;21;0;21;78;1;21;0;0;21;0;0;0
280200001;250;623;629;1;196;93;1;156;2;4;150;40;5;35
280200002;250;638;650;1;174;114;1;135;5;4;126;39;1;38
280200003;100;49;49;6;26;73;1;26;0;0;26;0;0;0
280200004;50;19;19;4;17;32;1;17;0;0;17;0;0;0
280200005;50;23;23;4;22;27;1;22;0;0;22;0;0;0
280200006;100;69;70;7;55;44;1;55;3;0;52;0;0;0
280200007;100;48;50;5;34;65;1;34;0;0;34;0;0;0
280200008;50;26;26;6;19;30;1;19;0;0;19;0;0;0
280200009;50;13;19;7;20;29;1;20;1;2;17;0;0;0
280200010;50;20;31;7;27;22;1;27;0;0;27;0;0;0
280200011;100;55;57;4;35;64;1;35;0;1;34;0;0;0
280200012;200;245;247;4;103;96;1;103;9;3;91;0;0;0
280200013;300;330;330;5;85;213;2;85;4;1;80;0;0;0
280200014;100;80;80;3;47;52;1;47;1;0;46;0;0;0
280200015;100;72;72;5;34;65;1;34;1;2;31;0;0;0
280200016;130;124;125;5;67;62;1;67;1;1;65;0;0;0
280200017;50;47;47;5;32;17;1;32;0;0;32;0;0;0
280200018;120;92;92;6;45;74;1;45;2;1;42;0;0;0
280200019;220;285;288;5;126;93;1;126;4;0;122;0;0;0
280200020;100;55;55;7;29;69;2;29;0;0;29;0;0;0
280200021;50;22;22;7;15;33;2;15;0;0;15;0;0;0
280200022;150;170;170;7;74;75;1;74;5;4;65;0;0;0
280200023;150;180;180;6;102;47;1;102;6;1;95;0;0;0
280200024;120;78;78;5;54;65;1;54;4;1;49;0;0;0
280200025;100;59;59;6;32;67;1;32;1;0;31;0;0;0
280200026;160;189;189;5;89;69;2;89;2;3;84;0;0;0
280200027;50;30;30;6;23;26;1;23;1;0;22;0;0;0
280200028;50;19;19;7;20;29;1;20;1;0;19;0;0;0
280200029;200;208;208;3;99;100;1;99;4;8;87;0;0;0
280200030;50;37;37;7;19;30;1;19;1;1;17;0;0;0
280200031;130;118;118;7;61;68;1;61;1;0;60;0;0;0
280200032;300;348;357;3;147;167;1;132;2;3;127;15;0;15
280200033;50;30;30;5;18;31;1;18;0;0;18;0;0;0
280200034;150;188;188;4;99;50;1;99;4;0;95;0;0;0
280200035;350;662;682;2;287;62;1;287;11;1;275;0;0;0
280200036;50;25;25;6;24;25;1;24;1;0;23;0;0;0
280200037;120;84;84;6;61;58;1;61;1;3;57;0;0;0
280200038;120;83;84;4;45;74;1;45;1;0;44;0;0;0
280200039;80;46;46;7;32;47;1;32;1;1;30;0;0;0
280200040;100;70;70;0;70;30;0;70;0;0;70;0;0;0
282200001;500;652;654;4;255;337;1;162;9;5;148;93;7;86
282200002;500;603;605;8;204;356;1;143;6;5;132;61;6;55
282200003;700;967;969;7;301;464;1;235;10;8;217;66;0;66
282200004;500;618;618;7;179;351;1;148;3;0;145;31;1;30
282200005;500;653;653;0;184;366;1;133;2;3;128;51;10;41
282200006;500;572;574;10;137;417;2;81;3;0;78;56;3;53
282200007;600;745;746;7;144;462;2;136;4;1;131;8;0;8
282200008;700;820;822;8;97;610;1;89;10;0;79;8;0;8
282200009;800;1107;1110;8;210;595;2;203;19;1;183;7;0;7
282200010;500;639;640;4;172;372;1;127;6;0;121;45;0;45
282200011;600;730;734;9;132;495;3;102;2;3;97;30;0;30
282200012;700;950;950;6;169;530;2;168;13;4;151;1;0;1
282200013;300;246;246;4;105;189;6;105;5;0;100;0;0;0
282200014;300;337;331;6;114;185;1;114;8;0;106;0;0;0
282200015;600;697;692;5;188;411;1;188;12;1;175;0;0;0
282200016;400;469;464;5;170;229;1;170;2;3;165;0;0;0
282200017;200;132;132;6;64;135;1;64;3;0;61;0;0;0
282200018;300;298;298;8;163;136;1;163;16;4;143;0;0;0
282200019;800;870;870;9;208;615;1;184;17;4;163;24;0;24
282200020;300;347;342;5;131;168;1;131;3;0;128;0;0;0
282200021;400;412;412;7;127;284;1;115;5;1;109;12;0;12
282200022;300;263;263;5;117;182;1;117;1;1;115;0;0;0
282200023;200;163;165;4;79;120;1;79;2;1;76;0;0;0
282200024;200;220;220;6;75;124;1;75;3;1;71;0;0;0
282200025;300;283;283;5;91;208;1;91;0;1;90;0;0;0
282200026;400;418;419;4;197;202;1;197;5;6;186;0;0;0
282200027;200;199;199;6;53;146;1;53;3;1;49;0;0;0
282200028;600;799;791;8;204;396;14;190;13;1;176;14;0;14
282200029;600;681;695;5;277;336;1;263;8;2;253;14;0;14
282200030;200;234;234;6;97;102;1;97;2;0;95;0;0;0
282200031;500;490;490;5;133;366;1;133;7;4;122;0;0;0
282200032;600;647;652;3;140;482;1;117;3;3;111;23;0;23
282200033;600;573;578;6;149;480;2;118;2;4;112;31;0;31
282200034;300;282;282;5;91;208;1;91;18;2;71;0;0;0
282200035;500;587;589;9;193;317;1;182;7;1;174;11;0;11
282200036;300;217;219;9;101;189;10;101;9;0;92;0;0;0
282200037;500;523;524;9;181;319;1;180;17;1;162;1;0;1
282200038;700;828;828;9;261;444;2;254;0;0;254;7;0;7
282200039;400;379;358;5;116;289;1;110;0;2;108;6;0;6
282200040;200;136;137;7;51;148;1;51;2;0;49;0;0;0
282200041;200;163;163;6;70;129;1;70;0;0;70;0;0;0
282200042;700;782;782;7;200;516;1;183;3;4;176;17;2;15
282200043;300;221;221;6;100;199;1;100;3;1;96;0;0;0
282200044;700;711;711;8;228;474;1;225;14;2;209;3;0;3
282200045;300;285;285;4;130;169;1;130;5;2;123;0;0;0
282200046;300;314;314;6;90;211;3;86;1;1;84;4;0;4
282200047;300;131;275;7;138;161;1;138;9;1;128;0;0;0
282200048;100;58;58;7;17;82;1;17;2;0;15;0;0;0
282200049;200;129;129;4;54;145;1;54;4;0;50;0;0;0
282200050;100;71;71;5;36;63;1;36;1;1;34;0;0;0
282200051;700;889;892;7;236;463;1;236;22;8;206;0;0;0
282200052;300;416;416;4;159;141;1;158;8;2;148;1;0;1
282200053;100;22;22;7;20;79;1;20;2;1;17;0;0;0
282200054;100;11;11;1;12;87;1;12;0;0;12;0;0;0
282200055;100;13;13;4;17;82;1;17;0;0;17;0;0;0
282200056;100;22;22;1;23;76;1;23;0;0;23;0;0;0
282300001;500;529;538;6;201;332;2;166;5;5;156;35;2;33
282300002;500;519;531;4;197;302;1;197;6;4;187;0;0;0
282300003;700;726;747;7;290;438;2;260;12;5;243;30;0;30
282300004;300;443;443;5;200;120;2;178;10;3;165;19;0;19
282300005;800;813;826;7;343;461;1;338;12;7;319;5;1;4
282300006;300;351;353;4;176;128;1;171;4;0;167;5;0;5
282300007;400;552;559;8;194;223;1;176;12;0;164;18;0;18
282300008;400;484;485;4;137;264;1;135;10;1;124;2;0;2
282300009;300;301;301;2;131;168;1;131;12;2;117;0;0;0
282300010;400;457;457;5;142;257;1;142;6;2;134;0;0;0
282300011;300;402;405;5;164;133;3;164;6;3;155;0;0;0
282300012;100;65;65;2;67;33;0;67;1;0;66;0;0;0
282400001;600;694;695;5;196;501;1;98;2;3;93;98;6;92
282400002;600;616;617;8;147;522;1;77;3;2;72;70;3;67
282400003;600;715;716;7;183;508;1;91;1;2;88;92;5;87
282400004;500;635;635;10;213;358;1;141;2;3;136;72;3;69
282400005;900;950;950;8;152;803;1;96;4;3;89;56;1;55
282400006;800;855;857;9;210;673;1;126;0;2;124;84;1;83
282400007;700;782;784;9;95;633;1;66;0;0;66;29;0;29
282400008;700;786;786;8;105;610;1;89;6;1;82;16;0;16
282400009;900;910;911;8;236;750;1;149;3;2;144;87;4;83
282400010;700;751;751;8;181;570;1;129;2;5;122;52;7;45
282400011;500;589;589;5;132;425;1;74;1;0;73;58;5;53
282400012;700;771;771;9;208;589;1;110;7;2;101;98;3;95
282400013;700;762;763;9;207;558;1;141;7;4;130;66;3;63
282400014;600;622;624;10;149;503;1;96;1;3;92;53;3;50
282400015;700;739;739;8;192;588;1;111;1;2;108;81;5;76
282400016;700;777;778;6;174;608;1;91;1;0;90;83;2;81
282400017;700;778;778;6;141;615;1;84;4;1;79;57;2;55
282400018;700;732;732;4;180;593;1;106;2;3;101;74;2;72
282400019;200;225;225;8;119;80;1;119;8;4;107;0;0;0
282400020;200;192;194;7;70;129;1;70;1;1;68;0;0;0
282400021;500;507;507;6;81;420;1;79;7;2;70;2;1;1
282400022;100;110;110;9;53;45;2;53;1;1;51;0;0;0
282400023;100;73;73;9;43;55;2;43;2;0;41;0;0;0
282400024;100;87;87;6;46;53;1;46;1;2;43;0;0;0
282400025;500;496;496;4;108;408;1;91;2;2;87;17;0;17
282400026;500;544;545;4;119;403;1;96;5;1;90;23;0;23
282400027;500;509;509;5;109;400;1;99;2;2;95;10;0;10
282400028;200;203;203;8;71;128;1;71;4;3;64;0;0;0
282400029;400;381;382;4;72;341;2;57;2;0;55;15;0;15
282400030;300;61;335;4;65;233;2;65;1;2;62;0;0;0
282400031;100;79;79;8;42;57;1;42;1;0;41;0;0;0
282400032;700;744;744;6;207;513;1;186;8;0;178;21;0;21
282400033;200;178;178;6;91;108;1;91;1;0;90;0;0;0
282400034;100;106;106;6;38;61;1;38;0;1;37;0;0;0
282400035;400;385;385;7;54;351;1;48;4;0;44;6;0;6
282400036;700;693;695;8;42;665;1;34;2;0;32;8;1;7
282400037;500;480;480;2;131;382;1;117;11;4;102;14;0;14
282400038;300;288;288;6;138;161;1;138;6;5;127;0;0;0
282400039;100;26;26;6;14;85;1;14;0;0;14;0;0;0
282400040;700;681;681;8;84;624;1;75;7;2;66;9;0;9
282400041;100;49;49;6;40;59;1;40;0;0;40;0;0;0
282400042;400;430;430;3;152;263;2;135;5;3;127;17;1;16
282400043;100;75;75;7;34;65;1;34;0;0;34;0;0;0
282400044;300;307;307;4;181;118;1;181;5;6;170;0;0;0
282400045;100;124;124;7;53;46;1;53;2;1;50;0;0;0
282400046;600;601;601;3;153;480;1;119;2;1;116;34;1;33
282400047;800;860;865;7;154;669;1;130;8;1;121;24;2;22
282400048;600;689;689;7;123;493;1;106;2;2;102;17;0;17
282400049;200;192;192;6;39;160;1;39;1;0;38;0;0;0
282400050;100;115;115;8;57;42;1;57;2;2;53;0;0;0
283500001;500;753;757;7;265;340;1;159;1;9;149;106;6;100
283500002;400;614;616;8;193;298;1;101;3;5;93;92;2;90
283500003;400;648;648;9;199;277;1;122;6;3;113;77;2;75
283500004;600;903;905;6;288;410;2;188;13;11;164;100;5;95
283500005;400;656;656;9;204;277;1;122;0;6;116;82;3;79
283500006;500;769;769;8;239;337;1;162;6;3;153;77;5;72
283500007;500;710;713;7;231;361;2;137;7;3;127;94;3;91
283500008;500;705;709;7;200;373;1;126;5;5;116;74;5;69
283500009;400;650;653;5;217;239;1;160;7;5;148;57;4;53
283500010;500;753;754;6;207;333;2;165;7;4;154;42;1;41
283500011;600;871;872;9;279;384;1;215;7;6;202;64;1;63
283500012;400;619;621;8;199;266;1;133;3;3;127;66;3;63
283500013;600;930;930;8;300;400;1;199;3;2;194;101;5;96
283500014;600;931;931;6;271;447;1;152;3;0;149;119;6;113
283500015;600;899;900;6;326;412;1;187;5;7;175;139;2;137
283500016;500;778;779;8;246;336;1;163;1;11;151;83;7;76
283500017;500;798;800;6;264;335;1;164;3;0;161;100;3;97
283500018;600;863;864;6;298;419;1;180;2;3;175;118;6;112
283500019;500;758;760;6;323;276;1;223;9;3;211;100;3;97
283500020;400;690;690;9;236;256;2;142;7;3;132;94;7;87
283500021;600;919;920;8;314;410;1;189;1;3;185;125;6;119
283500022;700;974;978;7;364;469;2;229;5;7;217;135;6;129
283500023;600;934;936;7;334;379;1;220;5;10;205;114;9;105
283500024;400;622;623;4;213;255;1;144;10;1;133;69;6;63
283500025;600;922;923;5;280;346;1;253;5;14;234;27;3;24
283500026;400;726;727;9;271;258;1;141;1;5;135;130;5;125
283500027;600;325;883;6;324;363;1;236;7;3;226;88;2;86
283500028;400;577;578;9;206;281;1;118;3;3;112;88;1;87
283500029;400;659;659;6;219;288;1;111;0;0;111;108;4;104
283500030;400;553;553;8;208;288;1;111;2;5;104;97;1;96
283500031;400;667;668;9;239;260;1;139;0;1;138;100;4;96
283500032;500;736;736;8;291;330;1;169;3;3;163;122;2;120
283500033;400;660;661;9;247;259;2;139;2;3;134;108;2;106
283500034;400;754;755;10;255;232;2;166;2;4;160;89;2;87
283500035;500;884;884;9;302;316;1;183;6;2;175;119;5;114
283500036;500;911;911;8;286;314;1;185;5;15;165;101;7;94
283500037;500;686;688;8;234;349;1;150;4;6;140;84;1;83
283500038;500;802;803;3;266;341;1;158;2;3;153;108;0;108
283500039;400;638;639;6;203;247;9;144;8;5;131;59;2;57
283500040;600;935;936;8;270;410;2;188;8;2;178;82;4;78
283500041;400;648;648;5;163;279;1;120;3;0;117;43;2;41
283500042;600;846;848;8;167;439;1;160;12;4;144;7;1;6
283500043;700;1017;1018;6;209;491;1;208;32;8;168;1;0;1
283500044;600;802;802;8;226;457;1;142;2;2;138;84;4;80
283500045;400;477;479;3;128;329;1;70;0;3;67;58;0;58
283500046;400;490;496;4;144;357;1;42;3;0;39;102;3;99
283500047;300;373;373;7;103;215;1;84;8;1;75;19;0;19
283500048;300;264;266;6;136;163;1;136;4;1;131;0;0;0
283500049;100;101;101;7;48;51;1;48;0;2;46;0;0;0
283500050;600;823;823;5;371;247;2;351;15;6;330;20;0;20
283500051;200;151;145;6;70;129;1;70;1;4;65;0;0;0
283500052;300;299;307;8;145;154;1;145;16;1;128;0;0;0
283500053;300;302;302;7;170;294;1;5;0;0;5;165;0;165
283500054;400;493;496;4;168;265;1;134;6;2;126;34;5;29
283500055;500;596;596;9;196;303;1;196;7;1;188;0;0;0
283500056;300;272;272;5;107;192;1;107;1;3;103;0;0;0
283500057;700;892;900;6;308;398;1;301;24;1;276;7;0;7
283500058;400;453;459;6;197;208;1;191;5;3;183;6;0;6
283500059;500;509;528;8;175;324;1;175;6;0;169;0;0;0
283500060;400;387;387;4;169;230;1;169;7;0;162;0;0;0
283500061;100;99;99;8;30;69;1;30;0;0;30;0;0;0
283500062;300;336;338;5;120;192;1;107;5;0;102;13;0;13
283500063;400;396;396;7;201;223;1;176;4;3;169;25;3;22
283500064;400;455;455;8;174;229;1;170;9;0;161;4;0;4
283500065;400;454;458;5;163;238;1;161;4;1;156;2;0;2
283500066;400;408;410;7;112;301;1;98;15;1;82;14;0;14
283500067;500;487;488;7;216;300;1;199;14;0;185;17;0;17
283500068;500;503;503;7;247;252;1;247;16;8;223;0;0;0
283500069;200;217;217;7;136;63;1;136;6;0;130;0;0;0
283500070;100;76;77;7;65;34;1;65;0;0;65;0;0;0
283500071;200;186;186;7;83;116;1;83;7;1;75;0;0;0
283500072;500;553;554;7;153;357;1;142;13;3;126;11;1;10
283500073;400;420;420;5;117;299;1;100;13;0;87;17;2;15
283500074;400;388;392;6;159;259;1;140;11;4;125;19;0;19
283500075;200;239;241;6;133;66;1;133;8;7;118;0;0;0
283500076;500;586;587;5;214;324;1;175;13;5;157;39;0;39
283500077;200;196;197;7;131;68;1;131;4;0;127;0;0;0
283500078;200;139;139;7;82;117;1;82;3;2;77;0;0;0
283500079;100;77;77;8;49;50;1;49;2;1;46;0;0;0
283500080;400;414;416;5;145;276;1;123;4;0;119;22;0;22
283500081;500;653;655;7;361;138;1;361;8;4;349;0;0;0
283500082;50;23;23;7;19;29;2;19;0;0;19;0;0;0
283500083;400;384;384;7;129;274;1;125;6;0;119;4;0;4
283500084;400;441;441;6;157;254;1;145;7;0;138;12;0;12
283500085;400;446;446;5;150;249;1;150;12;2;136;0;0;0
283500086;200;352;352;6;95;104;1;95;2;1;92;0;0;0
283500087;500;527;527;9;134;370;1;129;9;1;119;5;0;5
283500088;200;220;220;6;111;88;1;111;8;1;102;0;0;0
283500089;200;196;196;5;97;102;1;97;5;0;92;0;0;0
283500090;300;365;366;7;132;177;2;121;7;0;114;11;0;11
283500091;100;127;127;8;77;22;1;77;1;0;76;0;0;0
283500092;100;87;87;6;51;48;1;51;1;0;50;0;0;0
283500093;500;618;619;8;252;255;1;244;8;3;233;8;0;8
283500094;200;185;185;4;60;138;2;60;2;0;58;0;0;0
283500095;500;548;549;6;163;339;1;160;14;2;144;3;0;3
283500096;400;451;444;7;148;251;1;148;10;0;138;0;0;0
283500097;300;257;257;5;112;186;2;112;11;2;99;0;0;0
283500098;500;637;637;7;269;256;1;243;24;4;215;26;0;26
283500099;330;122;330;6;125;206;2;122;4;3;115;3;0;3
283500100;300;560;569;9;189;120;1;179;12;0;167;10;0;10
283500101;200;239;239;7;87;112;1;87;2;2;83;0;0;0
283500102;100;76;76;6;42;57;1;42;0;0;42;0;0;0
283500103;600;797;800;7;369;234;1;365;12;3;350;4;0;4
283500104;100;41;41;22;53;46;1;53;1;1;51;0;0;0
283500105;100;60;60;9;57;42;1;57;0;0;57;0;0;0
290900001;400;452;452;4;135;341;1;58;2;0;56;77;3;74
290900002;500;631;633;6;196;398;1;101;2;2;97;95;0;95
290900003;500;621;623;0;214;396;1;103;3;5;95;111;3;108
290900004;300;360;361;5;100;255;3;42;2;1;39;58;1;57
290900005;400;439;440;6;95;354;1;45;1;1;43;50;5;45
290900006;400;515;515;3;146;329;1;70;2;4;64;76;3;73
290900007;400;454;455;6;137;340;1;59;0;1;58;78;3;75
290900008;500;591;591;7;160;426;1;73;4;1;68;87;4;83
290900009;500;609;609;8;164;417;1;82;0;0;82;82;5;77
290900010;400;473;474;3;142;327;1;72;1;2;69;70;4;66
290900011;400;536;536;4;140;313;1;86;3;2;81;54;1;53
290900012;500;614;614;3;153;396;1;103;5;3;95;50;2;48
290900013;600;699;701;3;169;521;1;78;6;3;69;91;6;85
290900014;600;721;721;5;226;468;1;131;1;8;122;95;1;94
290900015;400;471;471;5;156;312;1;87;2;2;83;69;2;67
290900016;500;632;636;1;203;351;1;148;6;2;140;55;1;54
290900017;500;617;617;0;189;401;1;98;3;0;95;91;1;90
290900018;500;638;639;4;228;368;3;129;6;0;123;99;1;98
290900019;500;670;671;4;177;407;2;91;2;4;85;86;3;83
290900020;500;622;622;4;165;425;4;71;4;2;65;94;5;89
290900021;500;643;646;6;175;410;1;89;7;1;81;86;2;84
290900022;500;608;608;5;172;352;1;147;2;2;143;25;0;25
290900023;400;475;476;3;106;360;1;39;0;0;39;67;2;65
290900024;500;651;653;7;167;351;1;148;1;7;140;19;1;18
290900025;600;748;750;5;212;525;1;74;2;6;66;138;6;132
290900026;800;962;962;10;294;675;1;124;4;2;118;170;8;162
290900027;400;515;528;5;150;332;1;67;0;1;66;83;6;77
290900028;500;612;613;9;155;438;1;61;2;4;55;94;9;85
290900029;400;534;535;6;149;341;1;58;1;1;56;91;4;87
290900030;500;613;614;7;157;403;1;96;2;4;90;61;0;61
290900031;500;669;670;5;211;361;1;138;7;1;130;73;2;71
290900032;500;620;622;5;193;412;1;87;3;2;82;106;4;102
290900033;500;577;578;7;179;400;2;98;0;1;97;81;2;79
290900034;400;464;464;2;114;343;1;56;2;0;54;58;0;58
290900035;300;387;387;2;108;264;3;33;2;1;30;75;4;71
290900036;600;828;833;7;253;477;1;122;2;3;117;131;3;128
290900037;800;928;928;8;256;650;1;149;3;1;145;107;2;105
290900038;600;709;709;7;236;480;1;119;8;1;110;117;0;117
290900039;500;601;602;7;166;411;2;87;4;2;81;79;1;78
290900040;400;514;514;9;165;323;1;76;4;2;70;89;3;86
290900041;400;466;466;5;156;327;1;72;4;1;67;84;9;75
290900042;500;585;585;0;186;423;1;76;3;1;72;110;3;107
290900043;500;593;593;6;188;391;2;107;4;3;100;81;3;78
290900044;400;527;528;6;207;311;1;88;3;2;83;119;4;115
290900045;500;679;681;6;212;361;2;137;3;3;131;75;4;71
290900046;500;603;604;8;177;387;1;112;0;5;107;65;3;62
290900047;500;632;632;7;170;426;1;73;2;2;69;97;2;95
290900048;400;512;513;8;121;346;1;53;1;2;50;68;2;66
290900049;700;877;879;2;170;569;1;130;9;6;115;40;1;39
290900050;500;647;649;2;140;398;1;101;10;5;86;39;1;38
290900051;500;636;637;1;125;403;1;96;5;1;90;29;2;27
290900052;300;273;274;3;39;255;6;39;4;2;33;0;0;0
290900053;400;461;461;5;57;355;1;44;5;1;38;13;0;13
290900054;500;622;622;5;98;446;2;52;6;0;46;46;0;46
290900055;400;514;514;5;100;337;1;62;1;0;61;38;1;37
290900056;500;613;614;5;53;448;1;51;4;2;45;2;0;2
290900057;600;797;802;8;93;506;1;93;10;0;83;0;0;0
290900058;600;803;803;8;114;485;1;114;16;0;98;0;0;0
290900059;100;15;15;9;21;78;1;21;0;0;21;0;0;0
290900060;300;351;351;7;138;170;1;129;7;1;121;9;0;9
290900061;100;53;53;6;34;65;1;34;2;0;32;0;0;0
290900062;500;454;455;3;150;389;3;108;2;3;103;42;1;41
290900063;400;397;398;3;133;305;1;94;0;4;90;39;3;36
290900064;300;292;292;7;105;194;1;105;8;1;96;0;0;0
290900065;100;30;31;6;28;71;1;28;0;1;27;0;0;0
290900066;400;419;419;5;177;251;1;148;5;1;142;29;1;28
290900067;500;560;562;3;221;293;1;206;3;9;194;15;0;15
290900068;300;331;331;1;147;151;2;147;6;10;131;0;0;0
290900069;400;376;376;7;88;330;1;69;3;1;65;19;0;19
290900070;600;627;627;6;97;515;2;83;5;1;77;14;1;13
290900071;300;249;249;2;106;192;2;106;4;0;102;0;0;0
290900072;400;401;402;4;175;232;1;167;10;2;155;8;0;8
290900073;200;206;206;7;115;84;1;115;9;3;103;0;0;0
290900074;200;182;182;6;109;89;2;109;5;1;103;0;0;0
290900075;100;53;53;7;45;54;1;45;1;0;44;0;0;0
290900076;400;370;370;3;128;284;1;115;6;0;109;13;0;13
290900077;400;421;424;3;145;276;1;123;2;2;119;22;1;21
290900078;500;527;529;5;113;409;1;90;5;0;85;23;3;20
290900079;200;109;110;8;76;123;1;76;4;6;66;0;0;0
290900080;600;619;620;7;190;431;1;168;9;4;155;22;2;20
290900081;600;594;595;6;200;440;1;159;3;6;150;41;0;41
290900082;700;784;784;7;242;470;1;229;22;3;204;13;1;12
290900083;300;242;242;8;110;189;1;110;7;1;102;0;0;0
290900084;200;120;120;6;65;134;1;65;1;3;61;0;0;0
290900085;200;155;155;3;60;139;1;60;4;0;56;0;0;0
290900086;300;305;305;4;140;159;1;140;12;1;127;0;0;0
290900087;600;792;795;5;275;364;1;235;21;4;210;40;1;39
290900088;200;178;178;5;105;94;1;105;1;3;101;0;0;0
290900089;100;96;96;2;59;40;1;59;2;1;56;0;0;0
290900090;400;537;537;7;211;217;2;181;13;4;164;30;2;28
290900091;200;175;175;3;88;111;1;88;4;7;77;0;0;0
291100001;400;524;530;2;227;260;1;139;5;3;131;88;2;86
291100002;400;565;571;2;227;256;1;143;7;4;132;84;4;80
291100003;500;822;823;5;367;176;1;323;10;8;305;44;2;42
291100004;400;686;691;5;275;168;1;231;7;4;220;44;1;43
291100005;300;382;383;6;182;156;1;143;9;5;129;39;1;38
291100006;200;214;223;5;109;90;1;109;2;3;104;0;0;0
291100007;100;51;54;7;36;63;1;36;2;1;33;0;0;0
291100008;200;180;180;4;67;132;1;67;3;4;60;0;0;0
291100009;100;57;61;6;41;58;1;41;0;0;41;0;0;0
291100010;100;59;59;6;43;56;1;43;1;0;42;0;0;0
291100011;100;96;96;7;28;71;1;28;0;2;26;0;0;0
291100012;100;35;49;6;27;71;2;27;4;0;23;0;0;0
291100013;200;318;318;6;129;74;2;124;1;0;123;5;0;5
291100014;100;36;36;7;26;73;1;26;0;1;25;0;0;0
291100015;100;91;91;5;53;46;1;53;4;0;49;0;0;0
291100016;100;44;81;5;49;50;1;49;1;0;48;0;0;0
291100017;100;100;102;7;59;40;1;59;3;3;53;0;0;0
291100018;200;190;193;6;48;151;1;48;2;0;46;0;0;0
291100019;100;78;176;7;57;42;1;57;5;0;52;0;0;0
291100020;300;392;392;6;88;264;1;35;2;0;33;53;0;53
291100021;200;314;314;7;59;143;1;56;0;0;56;3;0;3
291100022;200;225;226;6;60;139;1;60;3;0;57;0;0;0
291100023;100;78;79;7;27;71;2;27;1;0;26;0;0;0
291100024;100;180;180;6;34;65;1;34;3;0;31;0;0;0
291100025;100;31;81;7;27;69;4;27;1;0;26;0;0;0
291100026;100;109;109;6;24;75;1;24;1;0;23;0;0;0
291100027;50;34;34;0;34;15;1;34;1;0;33;0;0;0
291100028;50;15;15;2;13;36;1;13;1;0;12;0;0;0
291700001;500;532;532;4;215;340;1;159;6;4;149;56;2;54
291700002;600;648;648;4;262;369;1;230;14;1;215;32;0;32
291700003;600;625;625;8;288;374;1;225;15;2;208;63;0;63
291700004;700;695;695;9;337;456;1;243;12;3;228;94;4;90
291700005;550;550;550;3;271;348;1;201;2;5;194;70;6;64
291700006;600;628;631;1;298;350;1;249;8;3;238;49;2;47
291700007;600;619;619;4;302;379;1;220;8;4;208;82;1;81
291700008;400;438;438;0;218;211;1;188;4;2;182;30;2;28
291700009;200;253;253;4;114;85;1;114;8;8;98;0;0;0
291700010;600;589;589;9;207;392;1;207;19;0;188;0;0;0
291700011;400;433;433;5;65;334;1;65;20;0;45;0;0;0
291700012;300;308;308;5;138;161;1;138;20;2;116;0;0;0
291700013;200;211;211;3;147;52;1;147;17;0;130;0;0;0
291700014;200;205;205;2;125;74;1;125;12;0;113;0;0;0
291700015;100;84;84;6;69;30;1;69;6;1;62;0;0;0
291700016;500;487;487;3;277;263;1;236;8;4;224;41;2;39
291700017;100;129;129;6;77;22;1;77;7;0;70;0;0;0
291700018;50;27;27;6;18;31;1;18;0;0;18;0;0;0
291700019;200;161;161;6;101;98;1;101;7;1;93;0;0;0
291700020;100;71;71;6;58;41;1;58;2;0;56;0;0;0
291800001;400;545;551;7;261;182;2;216;11;4;201;45;2;43
291800002;200;171;171;6;102;97;1;102;3;0;99;0;0;0
291800003;100;32;33;6;27;72;1;27;1;0;26;0;0;0
291800004;200;339;349;7;115;84;1;115;0;1;114;0;0;0
291800005;300;438;451;10;147;158;3;139;1;0;138;8;0;8
291800006;100;41;41;3;23;76;1;23;0;1;22;0;0;0
291800007;100;114;114;4;44;55;1;44;1;1;42;0;0;0
291800008;200;469;474;12;108;91;1;108;7;1;100;0;0;0
291800009;100;11;74;7;18;81;1;18;0;0;18;0;0;0
291800010;200;213;215;8;95;104;1;95;1;1;93;0;0;0
291800011;100;197;197;3;54;45;1;54;2;0;52;0;0;0
291800012;100;43;43;7;35;64;1;35;1;0;34;0;0;0
291800013;200;226;226;3;76;123;1;76;1;0;75;0;0;0
291800014;100;110;110;5;29;69;2;29;1;0;28;0;0;0
291800015;100;41;41;3;43;57;0;43;0;0;43;0;0;0
291900001;500;522;526;4;255;326;1;173;11;5;157;82;3;79
291900002;500;512;513;4;225;327;1;172;4;7;161;53;2;51
291900003;400;381;384;9;203;210;1;189;12;1;176;14;1;13
291900004;400;571;571;10;187;212;7;181;6;5;170;6;0;6
291900005;300;273;273;6;152;147;1;152;11;1;140;0;0;0
291900006;200;158;164;5;97;102;1;97;1;0;96;0;0;0
291900007;200;163;163;6;55;144;1;55;3;0;52;0;0;0
291900008;100;85;85;5;48;51;1;48;2;1;45;0;0;0
291900009;200;233;243;4;134;65;1;134;0;5;129;0;0;0
291900010;600;641;666;7;363;235;2;363;1;0;362;0;0;0
291900011;600;746;746;5;274;333;1;266;6;1;259;8;0;8
291900012;500;595;611;13;251;248;1;251;7;2;242;0;0;0
291900013;400;419;419;10;229;170;1;229;6;4;219;0;0;0
291900014;500;504;514;8;255;245;1;254;12;2;240;1;0;1
291900015;600;808;835;9;414;184;2;414;9;2;403;0;0;0
291900016;100;22;22;3;22;77;1;22;1;0;21;0;0;0
291900017;100;35;35;6;40;59;1;40;0;0;40;0;0;0
291900018;100;36;36;5;41;58;1;41;0;0;41;0;0;0
291900019;100;46;46;5;51;48;1;51;0;0;51;0;0;0
292800001;600;625;637;9;247;451;1;148;9;2;137;99;2;97
292800002;600;584;581;3;269;414;1;185;4;3;178;84;4;80
292800003;500;517;518;5;210;366;7;127;6;1;120;83;4;79
292800004;700;693;693;8;312;499;1;200;4;7;189;112;5;107
292800005;600;638;639;6;248;437;2;161;6;1;154;87;7;80
292800006;500;502;503;6;201;360;1;139;4;0;135;62;3;59
292800007;500;536;536;6;247;322;1;177;7;2;168;70;1;69
292800008;500;577;578;7;266;345;1;154;4;3;147;112;7;105
292800009;600;603;603;9;267;418;1;181;4;0;177;86;3;83
292800010;500;527;527;6;233;348;1;151;3;0;148;82;1;81
292800011;500;506;507;5;225;344;1;155;1;2;152;70;1;69
292800012;600;672;673;7;271;429;2;169;7;1;161;102;2;100
292800013;600;602;603;5;259;429;1;170;6;2;162;89;5;84
292800014;500;527;527;2;210;352;2;146;4;2;140;64;1;64
292800015;400;448;448;4;199;267;1;132;7;0;125;67;5;62
292800016;600;580;580;2;240;421;1;178;10;1;167;62;1;61
292800017;500;557;552;5;258;321;2;177;9;1;167;81;6;75
292800018;500;491;491;7;191;344;1;155;7;3;145;36;2;34
292800019;600;607;607;5;276;410;2;188;5;2;181;88;4;84
292800020;500;511;524;5;216;352;3;145;2;3;140;71;2;69
292800021;500;498;513;8;188;311;1;188;28;1;159;0;0;0
292800022;500;502;502;8;174;335;1;164;19;0;145;10;1;9
292800023;500;584;584;1;203;360;1;139;16;0;123;64;0;64
292800024;300;373;373;5;126;218;1;81;5;2;74;45;0;45
292800025;500;516;516;8;214;365;1;134;12;1;121;80;2;78
292800026;600;651;651;4;286;368;1;231;11;2;218;55;4;51
292800027;600;685;685;5;309;328;1;271;32;3;236;38;2;36
292800028;200;105;105;6;62;137;1;62;0;0;62;0;0;0
292800029;200;174;174;2;125;74;1;125;2;2;121;0;0;0
292800030;100;102;102;7;58;41;1;58;1;1;56;0;0;0
292800031;200;168;169;5;110;89;1;110;0;5;105;0;0;0
292800032;100;96;97;3;62;37;1;62;2;3;57;0;0;0
292800033;500;486;486;3;359;191;1;308;4;0;304;51;1;50
292800034;300;233;233;5;146;153;1;146;4;0;142;0;0;0
292800035;300;282;282;4;137;160;3;137;5;1;131;0;0;0
292800036;400;397;397;2;175;223;13;164;14;2;148;11;0;11
292800037;200;102;102;4;41;158;1;41;4;1;36;0;0;0
292800038;50;36;36;8;19;30;1;19;1;0;18;0;0;0
292800039;100;78;79;3;38;61;1;38;4;1;33;0;0;0
292800040;300;210;211;6;91;207;2;91;8;1;82;0;0;0
292800041;200;157;157;4;106;93;1;106;6;1;99;0;0;0
292800042;600;594;598;2;297;363;1;236;14;3;219;61;1;60
292800043;200;113;113;6;56;143;1;56;2;0;54;0;0;0
292800044;50;13;13;13;13;37;0;13;1;0;12;0;0;0
292900001;500;636;636;3;228;289;1;210;11;1;198;18;1;17
292900002;700;867;867;3;314;403;2;295;39;2;254;19;0;19
292900003;400;445;445;2;165;237;1;162;4;0;158;3;0;3
292900004;500;573;574;4;232;319;1;180;6;2;172;52;2;50
292900005;800;855;855;8;282;537;1;262;25;2;235;20;0;20
292900006;800;840;841;6;229;600;1;199;15;1;183;30;0;30
292900007;500;603;603;3;203;327;2;171;15;2;154;32;2;30
292900008;400;506;506;4;209;200;1;199;10;3;186;10;0;10
292900009;300;309;309;2;165;134;1;165;14;1;150;0;0;0
292900010;200;152;152;3;59;140;1;59;1;2;56;0;0;0
292900011;100;67;67;6;50;49;1;50;2;0;48;0;0;0
292900012;300;252;250;5;179;120;1;179;7;0;172;0;0;0
292900013;200;196;196;5;125;74;1;125;10;2;113;0;0;0
292900014;200;174;174;3;121;78;1;121;7;0;114;0;0;0
292900015;100;55;55;7;42;57;1;42;3;0;39;0;0;0
292900016;200;172;172;3;92;107;1;92;10;6;76;0;0;0
293000001;500;827;843;7;286;237;4;259;7;4;248;27;1;26
293000002;300;368;368;9;156;143;1;156;1;1;154;0;0;0
293000003;300;522;522;16;147;152;1;147;19;0;128;0;0;0
293000004;200;378;382;5;85;114;1;85;0;0;85;0;0;0
293000005;200;78;219;4;78;121;1;78;1;0;77;0;0;0
293000006;300;498;500;9;184;115;1;184;4;9;171;0;0;0
293000007;200;380;386;9;85;114;1;85;0;0;85;0;0;0
293000008;300;423;425;7;97;208;0;92;5;2;85;5;0;5
293000009;500;530;535;11;190;307;3;190;4;2;184;0;0;0
293000010;200;330;330;6;88;111;1;88;0;0;88;0;0;0
293000011;500;772;787;15;174;325;1;174;4;1;169;0;0;0
293000012;500;854;854;8;312;229;3;268;10;4;254;44;1;43
293000013;300;252;520;10;157;142;1;157;0;1;156;0;0;0
293000014;200;95;98;6;57;142;1;57;1;0;56;0;0;0
293000015;200;256;267;5;96;103;1;96;2;4;90;0;0;0
293000016;500;416;931;10;262;237;1;262;10;2;250;0;0;0
293000017;300;469;479;11;170;129;1;170;2;1;167;0;0;0
293000018;500;383;887;10;270;229;2;269;4;3;262;1;0;1
293000019;500;547;561;11;194;305;1;194;1;2;191;0;0;0
293000020;500;856;871;19;274;225;1;274;4;1;269;0;0;0
293000021;200;284;287;9;74;125;1;74;0;1;73;0;0;0
293000022;500;668;681;28;237;262;1;237;1;3;233;0;0;0
293000023;300;438;438;13;143;156;1;143;0;1;142;0;0;0
293000024;300;116;360;10;116;183;1;116;2;0;114;0;0;0
293000025;200;152;156;7;99;100;1;99;6;0;93;0;0;0
293000026;300;317;319;3;151;148;1;151;7;2;142;0;0;0
293000027;100;61;61;6;65;33;2;65;2;0;63;0;0;0
293000028;100;66;66;5;71;29;0;71;0;0;71;0;0;0
293000029;100;54;54;7;61;39;0;61;0;1;60;0;0;0
293000030;100;43;43;4;47;53;0;47;2;0;45;0;0;0
293200001;400;536;536;6;206;206;1;193;3;6;184;13;0;13
293200002;500;631;631;3;196;347;1;152;9;3;140;44;1;43
293200003;700;801;801;2;247;530;1;169;9;2;158;78;3;75
293200004;400;539;540;0;190;253;1;146;2;1;143;44;1;43
293200005;400;580;580;3;228;233;1;166;3;0;163;62;0;62
293200006;400;559;560;0;192;207;1;192;6;9;177;0;0;0
293200007;700;826;828;6;356;378;1;321;29;5;287;35;2;33
293200009;100;107;107;4;74;25;1;74;8;0;66;0;0;0
293200010;100;55;56;5;22;77;1;22;1;0;21;0;0;0
293200011;100;62;62;7;26;73;1;26;0;0;26;0;0;0
293200012;100;31;31;7;18;81;1;18;0;0;18;0;0;0
293200013;200;167;167;3;93;105;2;93;11;0;82;0;0;0
293200014;200;260;261;4;124;74;2;124;13;4;107;0;0;0
293200015;400;420;422;1;139;278;1;121;7;1;113;18;0;18
293200016;300;356;356;6;155;154;1;145;10;0;135;10;0;10
293200017;400;471;472;3;181;221;1;178;13;2;163;3;0;3
293200018;100;65;65;6;46;53;1;46;4;1;41;0;0;0
293200019;300;347;347;5;119;195;1;104;10;1;93;15;0;15
293200020;300;295;295;0;145;154;1;145;6;1;138;0;0;0
293200021;300;375;375;3;141;155;16;129;15;2;112;12;0;12
293200022;300;370;370;2;122;171;7;122;6;7;109;0;0;0
293200023;400;389;389;4;173;240;1;159;7;1;151;14;1;13
293200024;100;19;19;6;10;89;1;10;0;0;10;0;0;0
293300001;700;689;689;5;205;563;1;136;3;5;128;69;3;66
293300002;800;771;771;3;221;684;1;115;7;4;104;106;4;102
293300003;750;748;748;4;238;615;1;134;4;4;126;104;7;97
293300004;800;755;756;5;224;667;2;131;7;3;121;93;2;91
293300005;750;771;772;7;185;599;1;150;13;3;134;35;0;35
293300006;900;906;906;4;190;712;1;187;29;0;158;3;0;3
293300007;700;718;722;8;181;525;1;174;31;1;142;7;0;7
293300008;600;619;621;8;148;463;2;135;21;0;114;13;0;13
293300009;800;800;804;5;234;626;1;173;8;7;158;61;2;59
293300010;850;871;873;5;333;623;1;226;3;8;215;107;3;104
293300011;700;794;795;4;246;542;1;157;8;2;147;89;7;82
293300012;700;772;772;5;246;547;1;152;5;1;146;94;4;90
293300013;700;735;737;5;285;493;1;206;5;3;198;79;6;73
293300014;500;530;554;4;205;376;1;123;4;0;119;82;4;78
293300015;800;781;781;3;246;671;6;123;6;4;113;123;13;110
293300016;500;541;541;8;160;410;2;88;3;1;84;72;4;68
293300017;700;738;738;8;234;556;2;142;1;0;141;92;3;89
293300018;650;643;643;7;200;533;3;114;7;2;105;86;3;83
293300019;750;740;814;4;245;619;1;130;1;1;128;115;5;110
293300020;750;843;846;4;229;596;1;153;15;4;134;76;1;75
293300021;700;758;759;7;208;544;1;155;52;1;102;53;1;52
293300022;300;349;350;2;114;239;1;60;2;3;55;54;0;54
293300023;600;620;622;4;275;368;1;231;22;6;203;44;4;40
293300024;300;310;310;3;92;207;1;92;10;1;81;0;0;0
293300025;100;89;89;7;47;52;1;47;8;2;37;0;0;0
293300026;300;310;312;4;169;130;1;169;8;2;159;0;0;0
293300027;300;273;273;5;74;225;1;74;8;3;63;0;0;0
293300028;250;252;253;5;126;123;1;126;8;5;113;0;0;0
293300029;250;232;232;7;92;145;13;92;12;1;79;0;0;0
293300030;150;145;145;6;67;82;1;67;5;0;62;0;0;0
293300031;70;56;56;5;35;33;2;35;2;0;33;0;0;0
293300032;250;243;243;2;73;176;1;73;2;7;64;0;0;0
293300033;100;80;80;4;47;52;1;47;4;2;41;0;0;0
293300034;150;150;150;4;88;61;1;88;7;3;78;0;0;0
293300035;100;82;82;8;40;59;1;40;3;1;36;0;0;0
293300036;170;158;158;3;69;100;1;69;2;0;67;0;0;0
293300037;200;223;223;7;92;107;1;92;4;0;88;0;0;0
293300038;100;94;94;8;36;63;1;36;1;1;34;0;0;0
293300039;600;567;568;7;155;463;1;136;10;5;121;19;1;18
293300040;140;114;122;3;59;80;1;59;2;0;57;0;0;0
293300041;150;129;129;6;73;76;1;73;2;0;71;0;0;0
293300042;70;22;60;7;29;40;1;29;4;0;25;0;0;0
293300043;794;794;794;10;379;414;1;379;26;9;344;0;0;0
293400001;800;851;854;5;228;639;1;160;6;2;152;68;2;66
293400002;800;935;935;3;249;618;1;181;4;3;174;68;2;66
293400003;800;949;950;7;283;639;3;158;6;3;149;125;2;123
293400004;800;930;930;6;229;660;3;137;4;1;132;92;4;88
293400005;800;908;909;5;278;624;1;175;8;6;161;103;0;103
293400006;800;955;955;9;290;638;1;161;6;4;151;129;6;123
293400007;800;856;856;8;291;631;6;163;5;4;154;128;4;124
293400008;600;707;709;6;255;455;1;144;1;4;139;111;6;105
293400009;800;969;969;7;352;612;1;187;0;9;178;165;7;158
293400010;700;742;773;9;248;551;1;148;3;2;143;100;2;98
293400011;600;659;663;6;265;449;2;149;0;7;142;116;9;107
293400012;700;802;802;5;317;520;5;175;4;8;163;142;11;131
293400013;500;508;508;10;173;362;1;137;1;2;134;36;3;33
293400014;500;587;587;8;241;373;1;126;4;2;120;115;1;114
293400015;400;462;463;8;187;290;1;109;5;4;100;78;5;73
293400016;500;535;535;7;179;409;1;90;1;2;87;89;2;87
293400017;400;463;465;5;145;329;1;70;1;5;64;75;1;74
293400018;500;497;498;7;164;415;2;83;1;4;78;81;4;77
293400019;500;546;549;8;171;411;1;88;1;2;85;83;2;81
293400020;800;846;846;7;326;624;1;175;8;6;161;151;5;146
293400021;400;343;344;6;115;336;3;61;2;4;55;54;3;51
293400022;500;505;508;7;217;386;2;112;2;3;107;105;5;100
293400023;400;351;351;4;122;331;1;68;1;1;66;54;2;52
293400024;500;466;467;7;176;417;1;82;2;3;77;94;2;92
293400025;600;597;599;7;205;489;2;109;0;3;106;96;4;92
293400026;700;814;814;5;249;511;5;184;5;8;171;65;0;65
293400027;600;595;596;8;204;474;1;125;4;1;120;79;4;75
293400028;700;714;718;7;266;563;1;136;2;3;131;130;4;126
293400029;500;468;471;7;172;416;1;83;2;2;79;89;1;88
293400030;300;314;314;8;137;224;1;75;1;1;73;62;4;58
293400031;600;677;677;7;218;462;5;133;4;2;127;85;5;80
293400032;600;563;564;8;183;487;2;111;2;4;105;72;0;72
293400033;400;369;369;6;120;322;2;76;1;3;72;44;0;44
293400034;500;495;496;10;183;405;1;94;0;2;92;89;1;88
293400035;500;462;462;7;157;424;1;75;1;5;69;82;3;79
293400036;500;450;450;7;152;410;1;89;0;5;84;63;1;62
293400037;400;381;383;8;136;311;1;88;0;2;86;48;1;47
293400038;600;622;622;7;178;491;1;108;0;1;107;70;3;67
293400039;400;392;392;6;133;333;1;66;3;4;59;67;2;65
293400040;500;459;460;6;109;417;1;82;7;1;74;27;2;25
293400041;500;491;493;8;129;410;1;89;11;1;77;40;4;36
293400042;500;534;535;10;163;383;2;115;8;2;105;48;3;45
293400043;600;636;637;7;181;443;1;156;30;1;125;25;0;25
293400044;400;355;356;7;89;325;1;74;6;1;67;15;0;15
293400045;700;776;777;9;207;524;1;175;19;2;154;32;3;29
293400046;500;530;531;7;128;399;2;99;7;1;91;29;0;29
293400047;600;628;629;6;180;450;1;149;16;4;129;31;0;31
293400048;500;520;522;7;131;422;2;76;6;2;68;55;4;51
293400049;600;579;579;3;140;513;4;83;6;3;74;57;2;55
293400050;600;559;561;7;182;501;1;98;4;2;92;84;4;80
293400051;800;834;834;5;249;655;1;144;1;4;139;105;2;103
293400052;700;799;801;4;275;536;2;162;4;1;157;113;5;108
293400053;700;798;799;5;218;568;1;131;8;3;120;87;1;86
293400054;600;650;650;4;182;424;2;174;1;3;170;8;0;8
293400055;800;917;918;5;210;624;3;173;22;1;150;37;2;35
293400056;600;601;601;6;182;476;1;123;5;6;112;59;4;55
293400057;600;664;664;6;140;502;0;98;6;0;92;42;2;40
293400058;600;624;625;4;151;508;1;91;3;5;83;60;2;58
293400059;600;637;638;7;173;485;1;114;5;1;108;59;3;56
293400060;800;868;869;3;324;475;1;324;55;2;267;0;0;0
293400061;800;947;949;8;268;579;1;220;34;0;186;48;1;47
293400062;800;887;891;5;287;530;1;269;34;2;233;18;0;18
293400063;600;658;658;8;166;475;1;124;6;2;116;42;2;40
293400064;800;1060;1062;10;316;487;1;312;38;0;274;4;0;4
293400065;800;785;935;8;339;471;1;328;27;1;300;11;0;11
293400066;500;478;478;6;150;390;1;109;9;4;96;41;1;40
293400067;600;600;600;6;168;479;1;120;4;0;116;48;0;48
293400068;800;861;861;4;194;635;2;163;6;2;155;31;0;31
293400069;600;690;691;3;227;473;1;126;4;2;120;101;5;96
293400070;700;790;791;7;267;547;1;152;2;6;144;115;4;111
293400071;600;642;642;7;243;448;2;150;4;2;144;93;7;86
293400072;600;606;606;7;227;465;1;134;3;3;128;93;5;88
293400073;500;558;559;9;193;398;2;100;0;7;93;93;4;89
293400074;600;623;623;9;223;455;5;140;3;6;131;83;3;80
293400075;600;596;626;9;213;469;1;130;1;2;127;83;5;78
293400076;600;610;629;5;200;482;1;117;2;4;111;83;6;77
293400077;500;596;598;4;168;395;1;104;8;1;95;64;2;62
293400078;500;578;578;6;193;394;1;105;3;1;101;88;4;84
293400079;600;650;655;26;302;441;1;158;5;3;150;144;6;138
293400080;800;805;807;8;235;653;1;146;2;4;140;89;2;87
293400081;700;737;737;7;204;572;1;127;2;4;121;77;1;76
293400082;700;718;718;4;219;574;1;125;7;5;113;94;1;93
293400083;500;577;580;7;147;390;1;109;1;4;104;38;0;38
293400084;600;654;654;7;188;466;1;133;2;0;131;55;2;53
293400085;600;641;641;8;168;478;1;121;7;1;113;47;1;46
293400086;800;839;841;10;145;657;1;142;9;3;130;3;0;3
293400087;800;844;845;8;158;648;1;151;8;5;138;7;1;6
293400088;800;880;881;6;221;606;1;193;7;3;183;28;0;28
293400089;700;713;713;10;145;588;1;111;3;1;107;34;0;34
293400090;700;729;729;10;161;555;1;144;10;3;131;17;0;17
293400091;700;754;755;9;186;562;1;137;6;1;130;49;1;48
293400092;400;357;359;7;134;314;1;85;2;0;83;49;2;47
293400093;400;412;412;9;184;313;1;86;0;3;83;98;1;97
293400094;500;503;503;7;198;380;1;119;1;1;117;79;2;77
293400095;400;381;383;3;160;331;1;68;0;1;67;92;2;90
293400096;500;438;439;7;204;301;2;197;1;4;192;7;0;7
293400097;500;426;428;6;167;412;2;86;6;5;75;81;3;78
293400098;600;665;666;7;225;479;1;120;5;2;113;105;3;102
293400099;600;599;600;7;235;487;1;112;2;2;108;123;4;119
293400100;500;430;432;6;154;424;1;75;4;1;70;79;6;73
293400101;800;844;845;6;295;605;1;194;5;3;186;101;5;96
293400102;700;785;785;8;257;545;1;154;3;3;148;103;4;99
293400103;700;688;769;4;180;583;1;116;4;5;107;64;4;60
293400104;800;996;997;6;289;584;1;215;7;8;200;74;5;69
293400105;800;871;874;7;249;613;1;186;7;6;173;63;3;60
293400106;800;890;892;6;284;617;1;182;8;2;172;102;5;97
293400107;800;965;967;8;307;562;3;235;11;4;220;72;5;67
293400108;500;435;436;5;180;409;2;89;2;2;85;91;4;87
293400109;400;391;391;5;116;325;1;74;3;2;69;42;1;41
293400110;400;359;359;5;118;328;1;71;1;0;70;47;1;46
293400111;400;317;320;25;153;246;1;153;21;4;128;0;0;0
293400112;200;166;166;5;104;95;1;104;1;0;103;0;0;0
293400113;600;570;570;15;231;368;1;231;4;5;222;0;0;0
293400114;500;429;430;4;244;301;1;198;8;4;186;46;1;45
293400115;600;548;548;4;261;352;1;247;5;3;239;14;3;11
293400116;500;451;453;6;158;359;1;140;6;1;133;18;3;15
293400117;700;747;756;7;252;487;2;211;7;4;200;41;2;39
293400118;200;199;201;6;102;97;1;102;6;2;94;0;0;0
293400119;700;729;730;5;395;319;1;380;38;3;339;15;0;15
293400120;600;587;591;5;330;279;2;319;25;2;292;11;0;11
293400121;200;181;181;6;100;99;1;100;2;1;97;0;0;0
293400122;700;699;699;5;211;491;2;207;20;1;186;4;0;4
293400123;400;388;388;5;136;257;7;136;6;1;129;0;0;0
293400124;400;372;372;8;72;336;1;63;2;0;61;9;0;9
293400125;200;121;121;7;82;117;1;82;1;0;81;0;0;0
293400126;600;568;576;7;187;423;1;176;17;2;157;11;0;11
293400127;200;175;177;6;75;124;1;75;5;7;63;0;0;0
293400128;100;44;44;6;34;65;1;34;0;0;34;0;0;0
293400129;700;725;727;7;213;490;1;209;10;1;198;4;2;2
293400130;400;173;385;4;173;226;1;173;9;1;163;0;0;0
293400131;499;446;446;3;167;346;1;152;7;1;144;15;1;14
293400132;500;505;505;4;182;327;1;172;8;1;163;10;1;9
293400133;400;410;406;4;148;265;1;134;2;1;131;14;0;14
293400134;300;237;237;5;134;164;2;134;13;2;119;0;0;0
293400135;400;111;314;7;118;281;1;118;6;1;111;0;0;0
293400136;300;71;207;5;76;223;1;76;9;1;66;0;0;0
293400137;300;266;266;7;93;206;1;93;5;0;88;0;0;0
293400138;500;528;528;7;236;272;1;227;18;2;207;9;1;8
293400139;700;660;662;5;186;520;1;179;3;1;175;7;0;7
293400140;700;641;642;8;169;538;1;161;9;0;152;8;0;8
293400141;500;424;426;6;163;363;1;136;5;3;128;27;0;27
293400142;400;360;360;3;132;300;1;99;6;4;89;33;2;31
293400143;600;621;622;7;223;376;1;223;4;2;217;0;0;0
293400144;700;643;643;9;241;461;1;238;3;1;234;3;0;3
293400145;700;657;658;12;192;507;1;192;14;0;178;0;0;0
293400146;600;580;583;6;125;494;1;105;5;0;100;20;1;19
293400147;600;585;588;5;267;347;1;252;2;1;249;15;0;15
293400148;800;800;811;10;359;439;2;359;13;5;341;0;0;0
293400149;500;479;479;8;179;320;1;179;1;7;171;0;0;0
293400150;100;47;47;8;55;45;0;55;0;0;55;0;0;0
293400151;100;40;40;8;45;55;0;45;1;1;43;0;0;0
293400152;100;25;25;7;27;72;1;27;5;0;22;0;0;0
293400153;200;105;105;25;42;157;1;42;2;2;38;0;0;0
293400154;100;19;19;12;29;70;1;29;3;1;25;0;0;0
300700001;1000;951;981;4;300;728;1;271;13;4;254;29;1;28
300700002;700;691;691;6;183;532;1;167;14;3;150;16;0;16
300700003;500;97;510;4;97;409;1;90;1;0;89;7;0;7
300700004;1200;1181;1229;7;320;907;1;292;17;6;269;28;1;27
300700005;600;565;585;7;153;446;1;153;11;1;141;0;0;0
300700006;200;226;226;6;66;133;1;66;0;0;66;0;0;0
300700007;500;468;470;2;145;365;1;134;11;0;123;11;0;11
300700008;1200;1223;1223;5;252;957;1;242;21;1;220;10;0;10
300700009;800;794;813;7;216;601;2;197;9;2;186;19;0;19
300700010;600;615;615;6;217;377;15;208;14;1;193;9;1;8
300700011;100;93;93;5;47;52;1;47;0;0;47;0;0;0
300700012;700;686;703;4;221;478;1;221;12;1;208;0;0;0
300700013;700;697;725;3;243;456;1;243;21;4;218;0;0;0
300700014;1000;932;932;2;295;704;1;295;12;7;276;0;0;0
300700015;800;808;835;4;278;521;1;278;24;2;252;0;0;0
300700016;200;126;126;4;125;75;0;125;9;0;116;0;0;0
300700017;200;116;116;0;112;88;0;112;3;1;108;0;0;0
301000001;500;447;447;4;128;385;2;113;4;0;109;15;1;14
301000002;500;560;595;9;216;297;2;201;3;0;198;15;0;15
301000003;700;769;769;5;246;468;1;231;3;1;227;15;0;15
301000004;800;780;811;2;219;630;2;168;5;1;162;51;1;50
301000005;1000;1224;1224;5;272;739;1;260;13;1;246;12;0;12
301000006;1000;1111;1219;7;210;790;1;209;1;0;208;1;0;1
301000007;400;388;405;4;143;261;1;138;7;0;131;5;0;5
301000008;300;255;261;5;103;196;1;103;0;0;103;0;0;0
301000009;400;363;373;3;104;298;1;101;5;2;94;3;0;3
301000010;200;96;96;4;33;166;1;33;0;0;33;0;0;0
301000011;500;432;448;4;125;374;1;125;3;1;121;0;0;0
301000012;400;398;417;5;212;216;1;183;3;3;177;29;0;29
301000013;500;513;571;5;146;353;1;146;1;2;143;0;0;0
301000014;500;491;514;5;123;374;3;123;2;1;120;0;0;0
301000015;500;445;468;4;244;326;1;173;7;0;166;71;0;71
301000016;800;774;804;6;211;588;1;211;6;2;203;0;0;0
301000017;300;356;356;3;125;200;9;91;8;1;82;34;0;34
301000018;773;227;879;3;230;541;2;230;0;0;230;0;0;0
301000019;600;612;649;6;207;392;1;207;3;0;204;0;0;0
301000020;200;170;170;7;174;24;2;174;0;0;174;0;0;0
301000021;200;127;127;7;134;65;1;134;1;1;132;0;0;0
301000022;200;132;132;6;138;61;1;138;0;0;138;0;0;0
301000023;300;208;208;7;210;89;1;210;4;0;206;0;0;0
301100001;400;399;399;4;85;319;1;80;1;0;79;5;0;5
301100002;300;277;277;5;83;216;1;83;6;2;75;0;0;0
301100003;600;585;585;5;93;584;1;15;1;0;14;78;0;78
301100004;400;369;374;4;81;343;1;56;4;0;52;25;0;25
301100005;1000;1078;1082;3;201;835;1;164;7;5;152;37;0;37
301100006;400;400;400;5;81;320;1;79;0;1;78;2;0;2
301100007;400;376;376;7;73;328;1;71;2;0;69;2;0;2
301100008;400;426;426;5;62;337;1;62;4;1;57;0;0;0
301100009;800;809;809;2;131;670;1;129;8;3;118;2;0;2
301100010;600;544;544;5;81;518;1;81;5;1;75;0;0;0
301100011;400;358;358;3;88;315;1;84;6;1;77;4;0;4
301100012;300;226;226;6;58;241;1;58;6;1;51;0;0;0
301100013;500;452;452;3;136;363;1;136;10;4;122;0;0;0
301100014;1500;1491;1534;4;322;1199;1;300;17;3;280;22;1;21
301100015;400;359;359;6;66;328;6;66;5;2;59;0;0;0
301100016;400;312;312;4;63;335;2;63;3;0;60;0;0;0
301100018;700;703;725;5;185;517;1;182;4;2;176;3;0;3
301100019;500;466;466;5;91;421;1;78;7;0;71;13;0;13
301100020;700;788;788;6;143;556;1;143;2;1;140;0;0;0
301100021;400;433;433;4;96;303;1;96;5;2;89;0;0;0
301100022;100;86;86;0;85;14;1;85;1;0;84;0;0;0
301800001;800;751;760;1;185;618;1;181;5;0;176;4;0;4
301800002;1100;1048;1069;3;268;831;1;268;5;2;261;0;0;0
301800003;800;331;778;5;336;463;1;336;5;0;331;0;0;0
301800004;500;513;520;5;158;358;1;141;14;3;124;17;0;17
301800005;400;394;457;4;154;248;1;151;5;0;146;3;0;3
301800006;1100;1050;1061;0;538;562;1;537;1;0;536;1;0;1
301800007;900;856;856;4;158;779;2;119;2;2;115;39;2;37
301800008;700;674;674;6;218;482;1;217;1;0;216;1;0;1
301800009;900;915;915;5;306;593;1;306;3;2;301;0;0;0
301800010;1000;1010;1010;5;189;808;13;179;13;1;165;10;0;10
301800011;1000;992;1018;9;195;827;2;171;7;2;162;24;0;24
301800012;50;23;23;5;20;29;1;20;1;1;18;0;0;0
301800013;700;589;702;2;234;517;1;182;3;1;178;52;0;52
301800014;900;763;768;3;234;677;2;221;10;1;210;13;1;12
301800015;50;16;16;2;16;33;1;16;0;0;16;0;0;0
301800016;900;866;867;2;197;713;1;186;13;0;173;11;2;9
301800017;900;819;822;2;189;710;1;189;8;6;175;0;0;0
301800018;600;493;578;2;191;429;2;169;10;0;159;22;0;22
301800019;900;877;877;1;258;641;1;258;0;1;257;0;0;0
301800020;1000;1046;1051;0;258;767;1;232;19;4;209;26;2;24
301800021;1010;1010;1017;2;193;815;2;193;9;1;183;0;0;0
301800022;1000;766;1010;2;287;711;2;287;0;0;287;0;0;0
301800023;1000;954;959;3;418;587;2;411;0;0;411;7;0;7
301800024;200;174;174;0;174;26;0;174;0;0;174;0;0;0
301900001;500;398;398;3;125;430;2;68;2;2;64;57;1;56
301900002;500;479;480;2;162;389;2;109;1;5;103;53;3;50
301900003;600;720;724;2;166;486;1;113;4;6;103;53;1;52
301900004;600;754;755;6;231;436;1;163;0;8;155;68;3;65
301900005;500;590;594;3;132;375;1;124;17;0;107;8;0;8
301900006;500;677;677;3;169;337;2;161;22;1;138;8;0;8
301900007;200;189;189;1;48;151;1;48;5;4;39;0;0;0
301900008;300;239;240;5;68;230;2;68;2;5;61;0;0;0
301900009;300;376;376;5;101;210;4;86;6;4;76;15;2;13
301900010;500;358;358;0;112;411;1;88;8;5;75;24;4;20
301900011;500;537;537;4;106;411;1;88;9;1;78;18;1;17
301900012;300;296;296;4;90;209;1;90;4;2;84;0;0;0
301900013;300;230;233;5;110;189;1;110;6;8;96;0;0;0
301900014;400;427;427;5;120;281;1;118;8;0;110;2;0;2
301900015;200;159;159;5;61;138;1;61;9;0;52;0;0;0
301900016;300;251;252;7;113;186;1;113;20;0;93;0;0;0
301900017;100;21;21;1;22;76;2;22;1;0;21;0;0;0
302100001;60;44;44;2;31;27;2;31;0;0;31;0;0;0
302100002;900;998;1000;0;358;541;1;358;25;1;332;0;0;0
302100003;900;859;860;1;385;513;2;385;17;1;367;0;0;0
302100004;500;475;475;5;188;311;1;188;6;1;181;0;0;0
302100005;100;101;102;4;52;47;1;52;3;1;48;0;0;0
302100006;500;499;499;4;214;287;2;211;10;0;201;3;1;2
302100007;800;783;783;1;309;554;1;245;33;5;207;64;1;63
302100008;700;708;710;0;235;464;1;235;6;2;227;0;0;0
302100009;500;523;524;0;164;339;2;159;13;1;145;5;0;5
302100010;500;485;487;2;179;320;1;179;13;1;165;0;0;0
302100011;400;350;350;1;195;213;1;186;6;0;180;9;0;9
302100012;400;131;381;2;133;266;1;133;5;1;127;0;0;0
302100013;700;651;670;5;263;437;1;262;20;1;241;1;0;1
302100014;40;15;15;1;16;24;0;16;0;0;16;0;0;0
302200001;900;803;805;9;148;809;1;90;12;3;75;58;1;57
302200002;800;794;794;8;250;549;1;250;24;3;223;0;0;0
302200003;500;504;505;0;112;434;1;65;5;3;57;47;2;45
302200004;600;515;523;5;138;507;1;92;6;1;85;46;1;45
302200005;800;700;706;8;166;674;1;125;9;3;113;41;4;37
302200006;600;576;577;3;173;513;1;86;2;0;84;87;2;85
302200007;500;514;517;8;141;415;2;83;2;1;80;58;0;58
302200008;600;630;632;5;146;500;1;99;4;3;92;47;3;44
302200009;500;492;495;5;97;404;1;95;3;2;90;2;0;2
302200010;600;578;579;6;125;513;1;86;1;0;85;39;3;36
302200011;700;744;748;7;190;582;1;117;5;1;111;73;3;70
302200012;500;475;475;7;119;424;1;75;4;2;69;44;1;43
302200013;500;498;500;0;147;415;1;84;7;4;73;63;7;56
302200014;600;590;591;7;122;507;1;92;3;7;82;30;1;29
302200015;600;589;591;6;167;503;1;96;3;2;91;71;6;65
302200016;400;447;447;6;127;313;1;86;4;0;82;41;3;38
302200017;600;640;642;5;154;487;1;112;3;2;107;42;4;38
302200018;500;591;592;9;148;412;1;87;4;1;82;61;2;59
302200019;1400;228;710;6;232;1176;5;219;12;1;206;13;0;13
302200020;100;58;34;9;38;61;1;38;4;0;34;0;0;0
302200021;1000;1026;1030;10;291;725;1;274;17;2;255;17;0;17
302200022;500;147;511;4;147;356;1;143;10;1;132;4;0;4
302200023;300;323;323;4;85;237;1;62;2;1;59;23;3;20
302200024;200;146;146;4;41;158;1;41;4;1;36;0;0;0
302200025;200;140;140;5;74;125;1;74;1;3;70;0;0;0
302200026;400;423;424;5;128;275;1;124;5;2;117;4;0;4
302200027;300;302;302;6;62;286;1;13;2;0;11;49;0;49
302200028;700;681;681;7;159;546;1;153;9;0;144;6;0;6
302200029;700;787;787;6;165;534;1;165;10;4;151;0;0;0
302200030;100;34;34;6;21;78;1;21;0;0;21;0;0;0
302200031;400;383;383;2;122;279;1;120;4;1;115;2;0;2
302200032;200;174;174;6;87;112;1;87;6;6;75;0;0;0
302200033;100;97;98;6;50;49;1;50;2;0;48;0;0;0
302200034;300;333;327;5;100;222;1;77;7;0;70;23;0;23
302200035;100;62;62;4;26;72;2;26;1;2;23;0;0;0
302200036;100;20;20;0;17;82;1;17;1;0;16;0;0;0
302300001;700;671;672;3;152;604;1;95;5;2;88;57;4;53
302300002;800;749;780;1;141;701;1;98;2;5;91;43;0;43
302300003;700;696;699;6;179;604;1;95;2;2;91;84;0;84
302300004;600;599;600;6;144;519;1;80;1;2;77;64;4;60
302300005;800;798;799;6;165;667;1;132;13;1;118;33;0;33
302300006;900;1007;1011;6;102;823;1;76;5;0;71;26;0;26
302300007;500;485;486;5;93;435;1;64;2;1;61;29;1;28
302300008;700;776;778;7;186;588;1;111;9;4;98;75;5;70
302300009;500;503;504;8;67;442;1;57;2;3;52;10;1;9
302300010;800;831;831;5;182;684;1;115;2;4;109;67;5;62
302300011;700;670;670;5;177;553;1;146;3;2;141;31;2;29
302300012;900;939;939;6;112;804;1;95;12;0;83;17;0;17
302300013;300;294;295;4;77;222;1;77;5;2;70;0;0;0
302300014;500;606;606;4;115;401;1;98;2;3;93;17;0;17
302300015;600;626;627;5;129;500;2;98;8;3;87;31;2;29
302300016;300;310;310;5;106;193;1;106;1;0;105;0;0;0
302300017;300;279;279;4;58;241;1;58;5;0;53;0;0;0
302300018;300;226;226;2;113;184;3;113;4;6;103;0;0;0
302300019;100;78;78;5;40;59;1;40;3;0;37;0;0;0
302300020;600;637;647;5;152;450;1;149;9;1;139;3;0;3
302300021;300;247;247;2;114;185;1;114;4;1;109;0;0;0
302300022;100;17;17;5;22;77;1;22;0;0;22;0;0;0
302300023;100;29;29;9;21;78;1;21;3;0;18;0;0;0
302500001;800;843;844;8;180;690;1;109;4;3;102;71;4;67
302500002;600;717;717;7;171;471;2;127;19;6;102;44;0;44
302500003;900;929;930;6;251;744;1;155;23;2;130;96;2;94
302500004;700;698;698;2;190;562;1;137;8;4;125;53;4;49
302500005;100;36;36;7;23;76;1;23;0;1;22;0;0;0
302500006;200;197;197;6;68;131;1;68;4;2;62;0;0;0
302500007;400;480;480;6;74;336;1;63;2;3;58;11;1;10
302500008;100;41;41;6;16;83;1;16;0;0;16;0;0;0
302500009;100;81;81;5;63;36;1;63;9;4;50;0;0;0
302500010;100;103;103;7;44;55;1;44;5;0;39;0;0;0
302500011;600;627;627;1;95;527;1;72;3;0;69;23;1;22
302500012;100;24;24;7;12;87;1;12;0;0;12;0;0;0
302500013;500;586;587;6;130;389;1;110;6;1;103;20;1;19
303000001;800;839;840;8;185;715;1;84;1;3;80;101;10;91
303000002;800;807;807;7;139;732;1;67;2;0;65;72;2;70
303000003;800;766;767;7;142;726;1;73;1;2;70;69;3;66
303000004;800;828;831;9;139;730;1;69;0;3;66;70;2;68
303000005;900;930;931;7;147;805;1;94;6;0;88;53;2;51
303000006;800;781;781;7;99;751;1;48;1;4;43;51;2;49
303000007;900;884;884;6;124;828;3;69;2;1;66;55;3;52
303000008;900;956;956;8;133;827;1;72;6;0;66;61;3;58
303000009;900;900;901;9;76;854;1;45;2;0;43;31;1;30
303000010;800;822;822;8;52;775;1;24;0;2;22;28;1;27
303000011;800;846;847;7;163;713;1;86;2;2;82;77;1;76
303000012;800;835;837;10;160;700;1;99;4;3;92;61;0;61
303000013;800;806;806;6;127;734;1;65;6;1;58;62;3;59
303000014;800;845;846;8;144;733;2;65;5;0;60;79;6;73
303000015;900;968;968;4;131;836;2;62;1;1;60;69;6;63
303000016;800;817;820;9;164;728;1;71;2;1;68;93;2;91
303000017;900;1004;1005;7;105;847;1;52;1;1;50;53;2;51
303000018;700;678;679;7;178;609;1;90;1;5;84;88;5;83
303000019;700;705;705;6;181;606;1;93;1;2;90;88;2;86
303000020;800;779;779;10;163;723;1;76;1;1;74;87;2;85
303000021;700;738;741;7;204;591;1;108;1;1;106;95;2;93
303000022;700;713;715;4;181;604;1;95;1;2;92;86;4;82
303000023;800;822;823;6;215;677;1;122;4;5;113;93;5;88
303000024;809;771;807;8;199;680;10;119;3;6;110;80;4;76
303000025;700;683;686;2;148;616;1;83;5;5;73;65;6;59
303000026;800;719;776;5;168;725;1;74;0;3;71;94;4;90
303000027;700;740;741;4;155;628;4;68;4;3;61;87;4;83
303000028;700;746;747;3;177;610;1;89;2;7;80;88;3;85
303000029;800;768;770;4;182;687;2;111;0;2;109;71;3;68
303000030;600;636;637;5;152;518;1;81;1;0;80;71;2;69
303000031;900;990;992;7;213;781;1;118;5;1;112;95;3;92
303000032;800;904;909;6;255;645;2;153;1;7;145;102;6;96
303000033;800;905;906;6;232;680;1;119;5;0;114;113;8;105
303000034;800;878;878;9;248;617;1;182;8;8;166;66;0;66
303000035;500;561;562;3;199;403;1;96;5;0;91;103;4;99
303000036;500;543;551;8;149;401;1;98;3;1;94;51;1;50
303000037;900;944;945;5;66;856;1;43;4;0;39;23;1;22
303000038;800;877;880;5;136;723;1;76;3;4;69;60;3;57
303000039;800;826;827;8;125;740;1;59;6;1;52;66;1;65
303000040;700;751;751;10;168;612;1;87;1;0;86;81;4;77
303000041;800;782;782;8;125;736;1;63;4;0;59;62;3;59
303000042;900;924;924;8;94;860;2;38;2;0;36;56;2;54
303000043;800;871;871;8;208;699;1;100;8;3;89;108;6;102
303000044;800;813;813;5;232;567;1;232;11;13;208;0;0;0
303000045;800;726;789;7;241;689;8;103;8;1;94;138;4;134
303000046;900;974;974;7;277;785;1;114;5;2;107;163;7;156
303000047;900;885;887;9;223;789;2;109;2;1;106;114;3;111
303000048;900;968;970;8;294;757;2;141;3;7;131;153;3;150
303000049;600;576;577;10;173;517;1;82;0;1;81;91;5;86
303000050;800;863;864;8;264;678;1;121;6;2;113;143;2;141
303000051;800;806;806;6;234;681;1;118;4;3;111;116;8;108
303000052;700;816;816;6;24;681;1;18;0;0;18;6;0;6
303000053;500;526;526;6;118;442;1;57;2;1;54;61;5;56
303000054;800;864;864;8;243;684;2;114;2;1;111;129;7;122
303000055;800;789;790;8;283;657;1;142;3;1;138;141;5;136
303000056;700;713;714;8;238;586;1;113;0;2;111;125;8;117
303000057;800;808;809;9;251;580;2;218;5;5;208;33;2;31
303000058;900;993;993;9;308;733;1;166;6;3;157;142;6;136
303000059;800;779;779;9;256;664;11;125;7;3;115;131;5;126
303000060;800;766;766;8;273;643;1;156;3;3;150;117;4;113
303000061;800;770;770;7;228;681;1;118;9;1;108;110;4;106
303000062;800;757;757;8;185;705;1;94;1;5;88;91;10;81
303000063;800;736;737;5;250;680;1;119;7;3;109;131;5;126
303000064;800;764;764;6;214;687;1;112;4;0;108;102;3;99
303000065;800;821;823;10;294;669;1;130;1;4;125;164;6;158
303000066;800;794;797;9;296;664;2;134;4;4;126;162;6;156
303000067;800;761;761;9;276;665;2;133;0;0;133;143;1;142
303000068;700;699;700;7;213;594;1;105;0;5;100;108;7;101
303000069;800;827;828;9;276;662;1;137;4;3;130;139;6;133
303000070;700;688;691;9;240;572;1;127;3;7;117;113;4;109
303000071;800;786;788;10;321;660;2;138;0;2;136;183;7;176
303000072;700;681;682;8;222;584;1;115;3;0;112;107;6;101
303000073;800;795;797;7;243;670;1;129;2;2;125;114;4;110
303000074;900;868;869;4;273;754;1;145;1;7;137;128;4;124
303000075;800;829;830;8;282;659;2;139;3;5;131;143;11;132
303000076;900;898;898;9;314;731;1;168;2;7;159;146;2;144
303000077;900;827;828;12;259;755;1;144;5;6;133;115;6;109
303000078;700;715;716;8;252;582;2;116;5;2;109;136;5;131
303000079;800;728;730;12;214;668;1;131;3;6;122;83;6;77
303000080;700;664;664;7;244;599;1;100;1;3;96;144;3;141
303000081;600;639;640;7;225;474;1;125;2;3;120;100;0;100
303000082;700;672;674;11;261;562;1;137;3;4;130;124;4;120
303000083;700;688;692;8;195;619;1;80;3;1;76;119;6;113
303000084;700;675;676;7;217;590;1;109;2;2;105;108;7;101
303000085;800;773;773;9;201;692;1;107;6;3;98;94;2;92
303000086;900;930;933;6;224;788;2;110;7;1;102;114;6;108
303000087;800;770;772;7;275;658;1;141;1;4;136;134;11;123
303000088;900;830;832;7;270;756;3;141;2;3;136;129;7;122
303000089;700;661;662;7;183;591;1;108;1;6;101;75;7;68
303000090;500;495;496;9;159;357;1;142;1;6;135;17;2;15
303000091;800;753;754;6;203;686;1;113;5;3;105;90;3;87
303000092;800;701;762;7;228;693;1;106;2;3;101;122;7;115
303000093;800;756;756;9;225;699;1;100;1;2;97;125;6;119
303000094;700;658;658;8;161;637;1;62;1;3;58;99;5;94
303000095;100;38;38;6;26;72;2;26;7;1;18;0;0;0
303000096;200;111;113;6;64;135;1;64;1;7;56;0;0;0
303000097;200;100;100;8;36;163;1;36;0;0;36;0;0;0
303000098;200;137;138;6;64;135;1;64;0;3;61;0;0;0
303000099;300;180;180;6;85;213;2;85;3;5;77;0;0;0
303000100;300;225;225;5;90;209;1;90;1;2;87;0;0;0
303000101;600;524;524;7;87;531;1;68;4;1;63;19;1;18
303000102;900;832;832;4;146;766;1;133;4;1;128;13;0;13
303000103;800;760;760;6;217;657;1;142;4;3;135;75;1;74
303000104;1000;996;997;3;246;764;3;233;45;2;186;13;0;13
303000105;600;524;524;7;116;493;1;106;12;0;94;10;1;9
303000106;700;624;624;6;127;592;1;107;6;1;100;20;1;19
303000107;400;323;325;6;92;307;1;92;5;5;82;0;0;0
303000108;200;98;98;6;38;161;1;38;3;0;35;0;0;0
303000109;400;325;325;6;106;293;1;106;6;6;94;0;0;0
303000110;100;21;21;6;18;81;1;18;1;0;17;0;0;0
303000111;300;184;184;3;100;198;2;100;4;5;91;0;0;0
303000112;400;369;370;3;98;320;1;79;1;3;75;19;2;17
303000113;500;449;450;7;99;414;1;85;3;5;77;14;1;13
303000114;400;358;358;5;104;329;1;70;4;2;64;34;0;34
303000115;500;500;506;7;101;419;5;76;4;4;68;25;0;25
303000116;200;98;98;7;64;135;1;64;0;2;62;0;0;0
303000117;300;218;218;6;114;185;1;114;3;2;109;0;0;0
303000118;300;192;192;1;88;211;1;88;0;2;86;0;0;0
303000119;600;590;591;6;193;435;1;164;10;1;153;29;0;29
303000120;500;463;463;4;84;421;1;78;2;0;76;6;0;6
303000121;400;385;391;5;109;305;4;91;3;1;87;18;1;17
303000122;600;527;527;4;121;503;1;96;6;3;87;25;0;25
303000123;600;576;576;6;111;516;1;83;1;1;81;28;1;27
303000124;500;493;493;7;104;427;1;72;2;1;69;32;2;30
303000125;200;23;23;35;52;147;1;52;1;3;48;0;0;0
303000126;200;75;75;9;51;145;4;51;5;2;44;0;0;0
303000127;100;21;21;10;29;70;1;29;2;0;27;0;0;0
303000128;100;10;10;0;10;89;1;10;0;1;9;0;0;0
303000129;100;17;17;0;16;83;1;16;1;1;14;0;0;0
303000130;100;19;19;3;22;77;1;22;1;1;20;0;0;0
303000131;100;26;26;2;25;74;1;25;0;0;25;0;0;0
310300001;400;282;287;2;152;247;1;152;14;5;133;0;0;0
310300002;700;622;623;4;317;440;1;259;19;12;228;58;2;56
310300003;100;42;42;7;27;72;1;27;1;0;26;0;0;0
310300004;100;14;15;6;15;84;1;15;0;0;15;0;0;0
310300005;100;31;32;6;24;75;1;24;1;0;23;0;0;0
310300006;200;139;139;3;83;115;2;83;6;1;76;0;0;0
310300007;400;342;349;3;166;233;1;166;14;2;150;0;0;0
310300008;100;43;43;6;33;66;1;33;1;1;31;0;0;0
310300009;100;36;36;5;34;65;1;34;0;1;33;0;0;0
310300010;100;14;14;4;12;87;1;12;0;0;12;0;0;0
310300011;100;11;11;6;9;90;1;9;0;0;9;0;0;0
310300012;200;190;195;5;69;130;1;69;8;0;61;0;0;0
310300013;100;21;21;7;22;77;1;22;0;1;21;0;0;0
310300014;300;250;251;4;124;175;1;124;8;2;114;0;0;0
310300015;100;83;84;5;48;51;1;48;3;1;44;0;0;0
310300016;100;84;86;5;57;42;1;57;2;3;52;0;0;0
310300017;100;57;57;6;36;63;1;36;1;0;35;0;0;0
310300018;100;18;18;5;19;80;1;19;0;0;19;0;0;0
310300019;300;190;219;6;93;206;1;93;7;3;83;0;0;0
310300020;100;24;25;7;17;82;1;17;0;0;17;0;0;0
310300021;100;24;24;2;26;73;1;26;3;0;23;0;0;0
310300022;100;28;28;6;32;67;1;32;4;0;28;0;0;0
310700001;700;624;625;0;195;588;1;111;3;2;106;84;2;82
310700002;700;665;666;6;229;547;1;152;5;6;141;77;2;75
310700003;700;662;662;9;227;540;1;159;4;6;149;68;2;66
310700004;900;862;864;1;218;749;1;150;7;2;141;68;4;64
310700005;800;743;743;0;232;657;1;142;2;3;137;90;1;89
310700006;900;873;873;0;208;769;1;130;8;1;121;78;3;75
310700007;800;750;751;2;199;646;1;153;4;4;145;46;4;42
310700008;900;887;887;0;203;765;1;134;8;3;123;69;2;67
310700009;800;807;807;4;202;660;1;139;6;2;131;63;1;62
310700010;900;879;879;1;178;797;1;102;8;2;92;76;2;74
310700011;800;829;830;0;179;671;1;128;5;1;122;51;1;50
310700012;400;466;467;2;112;303;1;96;9;1;86;16;0;16
310700013;100;55;55;6;26;73;1;26;1;0;25;0;0;0
310700014;100;88;88;5;38;61;1;38;1;0;37;0;0;0
310700015;100;58;58;7;30;69;1;30;2;0;28;0;0;0
310700016;100;50;50;6;35;64;1;35;5;0;30;0;0;0
310700017;300;287;287;4;78;221;1;78;6;2;70;0;0;0
310700018;200;139;139;1;52;146;2;52;3;1;48;0;0;0
310700019;100;54;54;4;28;71;1;28;5;1;22;0;0;0
310700020;100;56;56;5;40;59;1;40;1;0;39;0;0;0
310700021;200;197;197;3;79;120;1;79;11;0;68;0;0;0
310700022;400;416;418;3;69;343;1;56;4;0;52;13;0;13
310700023;300;312;313;3;72;233;1;66;8;1;57;6;0;6
310700024;300;351;352;4;153;181;1;118;6;2;110;35;0;35
310700025;100;110;105;5;29;70;1;29;2;0;27;0;0;0
310700026;400;430;430;7;80;338;1;61;10;0;51;19;1;18
310700027;200;183;183;3;54;145;1;54;5;0;49;0;0;0
310700028;400;410;412;4;76;337;1;62;3;3;56;14;1;13
310700029;300;39;39;5;17;282;1;17;0;0;17;0;0;0
312200001;500;465;466;9;144;415;1;84;3;1;80;60;2;58
312200002;800;829;832;3;214;648;2;150;7;6;137;64;3;61
312200003;700;707;707;1;166;559;2;139;14;3;122;27;1;26
312200004;800;836;836;6;182;660;2;138;12;1;125;44;0;44
312200005;600;555;556;0;135;482;1;117;6;1;110;18;3;15
312200006;500;527;527;3;121;414;1;85;5;1;79;36;0;36
312200007;900;835;835;2;120;779;1;120;9;0;111;0;0;0
312200008;100;91;91;4;43;55;2;43;2;2;39;0;0;0
312200009;200;141;141;5;53;146;1;53;2;1;50;0;0;0
312200010;100;47;47;2;27;72;1;27;0;0;27;0;0;0
312200011;300;299;299;3;123;176;1;123;7;5;111;0;0;0
312200012;300;201;202;3;68;231;1;68;2;4;62;0;0;0
312200013;200;200;201;4;95;104;1;95;3;2;90;0;0;0
312200014;500;472;472;5;143;395;2;103;2;1;100;40;3;37
312200015;900;810;810;4;134;792;1;107;7;4;96;27;0;27
312200016;300;260;261;4;92;207;1;92;6;2;84;0;0;0
312200017;300;288;288;2;82;217;1;82;2;0;80;0;0;0
312200018;100;22;22;4;22;77;1;22;2;2;18;0;0;0
312200019;500;453;454;4;166;372;2;126;15;0;111;40;0;40
312200020;200;134;134;6;70;129;1;70;2;3;65;0;0;0
312200021;200;179;179;3;59;140;1;59;4;2;53;0;0;0
312200022;200;152;152;4;60;139;1;60;7;3;50;0;0;0
312200023;100;73;73;5;39;60;1;39;0;1;38;0;0;0
312200024;200;142;142;2;75;124;1;75;6;5;64;0;0;0
312200025;100;47;47;3;30;69;1;30;2;1;27;0;0;0
312200026;200;128;129;4;56;143;1;56;2;3;51;0;0;0
312200027;200;101;101;5;42;157;1;42;1;2;39;0;0;0
312200028;200;114;114;4;46;153;1;46;3;0;43;0;0;0
312200029;300;210;210;3;84;215;1;84;6;0;78;0;0;0
312500001;100;69;69;4;32;67;1;32;1;1;30;0;0;0
312500002;400;421;421;1;137;297;1;102;3;0;99;35;3;32
312500003;400;432;432;2;141;307;2;91;5;4;82;50;1;49
312500004;600;621;623;2;173;456;1;143;5;2;136;30;0;30
312500005;200;195;196;5;102;97;1;102;5;3;94;0;0;0
312500006;400;484;484;2;111;314;1;85;11;1;73;26;1;25
312500007;400;428;430;2;132;309;1;90;9;4;77;42;2;40
312500008;800;889;889;2;207;665;4;131;4;6;121;76;3;73
312500009;100;19;19;7;22;77;1;22;0;0;22;0;0;0
312500010;500;545;547;4;178;359;1;140;5;5;130;38;1;37
312500011;200;187;196;2;93;106;1;93;1;0;92;0;0;0
312500012;300;222;222;2;92;207;1;92;5;2;85;0;0;0
312500013;200;194;195;3;87;112;1;87;6;1;80;0;0;0
312500014;600;573;573;5;146;471;2;127;3;8;116;19;1;18
312500015;100;48;48;4;23;76;1;23;0;0;23;0;0;0
312500016;100;60;60;5;29;70;1;29;1;0;28;0;0;0
312500017;700;784;790;2;172;542;1;157;7;1;149;15;1;14
312500018;100;95;95;3;59;39;2;59;1;2;56;0;0;0
312500019;700;773;777;3;343;371;1;328;6;10;312;15;0;15
312500020;300;369;371;4;138;201;1;98;6;1;91;40;3;37
312500021;200;187;187;3;90;109;1;90;5;0;85;0;0;0
312500022;300;319;320;2;92;207;1;92;1;3;88;0;0;0
312500023;200;144;145;3;72;127;1;72;2;1;69;0;0;0
312500024;300;387;387;5;125;173;2;125;10;0;115;0;0;0
312500025;500;550;552;6;165;400;1;99;2;2;95;66;0;66
312500026;700;755;756;4;176;569;1;130;8;5;117;46;3;43
312500027;400;514;514;3;192;210;1;189;7;2;180;3;0;3
312500028;200;153;153;4;69;130;1;69;1;2;66;0;0;0
312500029;100;97;97;3;40;59;1;40;3;1;36;0;0;0
312500030;200;167;167;6;62;137;1;62;3;0;59;0;0;0
312500031;300;332;332;3;87;224;1;75;3;1;71;12;0;12
312500032;300;285;286;2;95;200;5;95;4;0;91;0;0;0
312500033;500;486;486;2;137;404;1;95;7;1;87;42;1;41
312500034;400;441;441;3;122;316;1;83;7;3;73;39;1;38
312500035;100;77;77;6;26;73;1;26;1;0;25;0;0;0
312500036;400;438;439;3;127;295;1;104;27;2;75;21;0;21
312500037;500;452;452;2;120;416;1;83;4;1;78;37;1;36
312500038;200;108;108;2;44;155;1;44;7;0;37;0;0;0
312500039;200;180;180;3;94;105;1;94;4;3;87;0;0;0
312500040;400;415;417;2;125;291;1;108;4;2;102;17;1;16
312500041;200;124;124;5;63;136;1;63;5;0;58;0;0;0
312500042;300;292;290;1;136;162;2;136;5;8;123;0;0;0
312500043;600;596;597;5;136;492;1;107;4;2;101;29;3;26
312500044;500;579;579;6;146;379;2;119;3;2;114;27;0;27
312500045;200;123;123;4;72;127;1;72;1;3;68;0;0;0
312500046;500;502;503;4;95;405;1;94;8;6;80;1;0;1
312500047;400;436;439;2;144;295;2;103;3;3;97;41;2;39
312500048;400;428;428;4;114;308;1;91;4;2;85;23;2;21
312500049;300;225;225;3;87;211;2;87;6;5;76;0;0;0
312500050;100;33;33;6;37;61;2;37;0;0;37;0;0;0
312600001;600;628;630;7;232;481;1;118;5;1;112;114;2;112
312600002;500;548;579;7;188;397;1;102;0;0;102;86;2;84
312600003;400;428;428;5;153;313;2;85;4;1;80;68;2;66
312600004;500;517;519;6;146;418;2;80;0;3;77;66;5;61
312600005;500;526;529;5;177;394;1;105;5;2;98;72;2;70
312600006;600;634;640;7;177;513;2;85;2;1;82;92;1;91
312600007;700;696;702;10;257;577;1;122;1;4;117;135;4;131
312600008;700;723;726;2;227;589;3;108;1;4;103;119;5;114
312600009;500;501;505;3;179;416;1;83;1;3;79;96;0;96
312600010;500;569;570;8;209;404;2;94;3;1;90;115;2;113
312600011;500;562;564;6;206;396;1;103;2;4;97;103;5;98
312600012;500;504;505;6;127;435;1;64;0;2;62;63;0;63
312600013;500;540;543;6;184;403;1;96;3;1;92;88;3;85
312600014;900;914;914;5;323;745;3;152;7;6;139;171;7;164
312600015;500;559;559;9;204;387;2;111;4;1;106;93;4;89
312600016;400;471;471;5;167;305;1;94;0;1;93;73;3;70
312600017;700;721;726;7;224;570;1;129;0;0;129;95;4;91
312600018;500;551;554;8;174;405;1;94;2;1;91;80;1;79
312600019;600;661;661;5;257;482;1;117;6;2;109;140;2;138
312600020;700;747;749;6;238;581;1;118;2;1;115;120;3;117
312600021;500;526;529;8;143;420;1;79;2;3;74;64;5;59
312600022;600;651;654;6;207;492;2;106;5;2;99;101;6;95
312600023;600;597;598;5;157;511;1;88;4;2;82;69;3;66
312600024;700;693;695;4;164;602;1;97;5;4;88;67;2;65
312600025;700;695;696;6;185;582;1;117;8;0;109;68;2;66
312600026;600;670;661;4;138;516;1;83;2;4;77;55;1;54
312600027;600;620;623;8;173;505;2;93;3;6;84;80;2;78
312600028;600;632;632;5;184;501;1;98;5;6;87;86;2;84
312600029;700;711;714;10;189;622;2;76;0;3;73;113;0;113
312600030;500;490;466;5;72;456;1;43;1;0;42;29;2;27
312600031;400;367;342;5;124;274;2;124;12;6;106;0;0;0
312600032;500;516;517;6;150;431;1;68;2;2;64;82;5;77
312600033;400;451;455;5;138;330;1;69;4;0;65;69;5;64
312600034;600;591;592;6;209;492;1;107;6;4;97;102;3;99
312600035;500;563;564;5;185;392;1;107;2;3;102;78;2;76
312600036;500;520;520;7;157;432;1;67;3;1;63;90;2;88
312600037;700;767;768;5;237;591;2;107;5;3;99;130;2;128
312600038;600;664;669;9;171;490;7;103;6;0;97;68;1;67
312600039;500;530;533;5;106;432;3;65;3;1;61;41;2;39
312600040;500;556;561;9;175;404;1;95;3;1;91;80;0;80
312600041;700;736;738;8;82;637;1;62;3;0;59;20;1;19
312600042;800;834;838;7;128;681;3;116;14;0;102;12;0;12
312600043;900;983;983;7;139;773;1;126;18;0;108;13;0;13
312600044;900;974;975;5;115;794;1;105;7;0;98;10;1;9
312600045;800;818;820;9;45;763;2;35;2;1;32;10;0;10
312600046;1000;1025;1026;7;48;956;1;43;7;0;36;5;0;5
312600047;1000;983;984;9;25;981;1;18;2;0;16;7;0;7
312600048;1000;1013;1016;9;41;957;2;41;0;1;40;0;0;0
312600049;900;890;892;8;78;822;1;77;7;0;70;1;0;1
312600050;700;692;694;6;115;621;1;78;5;2;71;37;1;36
312600051;700;676;679;2;113;637;1;62;2;0;60;51;0;51
312600052;700;720;720;9;132;623;1;76;7;0;69;56;1;55
312600053;600;656;656;5;94;550;1;49;7;0;42;45;3;42
312600054;400;472;475;5;88;345;1;54;2;2;50;34;1;33
312600055;600;607;607;6;104;530;1;69;0;2;67;35;2;33
312600056;500;520;520;8;89;433;1;66;2;2;62;23;0;23
312600057;500;500;504;5;96;446;1;53;0;1;52;43;1;42
312600058;500;562;562;3;106;441;1;58;1;0;57;48;1;47
312600059;600;649;650;9;246;452;2;146;1;5;140;100;1;97
312600060;700;722;723;6;228;584;1;115;5;3;107;113;4;109
312600061;500;530;532;5;153;410;3;87;1;2;84;66;3;63
312600062;500;517;518;13;178;407;1;92;2;0;90;86;3;83
312600063;600;620;625;6;183;512;1;87;6;4;77;96;5;91
312600064;400;419;422;5;139;330;1;69;3;2;64;70;1;69
312600065;400;464;465;6;136;340;1;59;4;1;54;77;3;74
312600066;500;585;587;9;165;399;1;100;6;3;91;65;2;63
312600067;700;770;770;6;234;550;2;148;3;1;144;86;0;86
312600068;600;599;614;7;175;513;1;86;1;0;85;89;2;87
312600069;400;435;435;4;127;315;1;84;1;1;82;43;1;42
312600070;600;604;605;6;156;505;2;93;4;2;87;63;1;62
312600071;500;568;569;4;125;422;4;74;3;5;66;51;2;49
312600072;600;642;646;6;188;510;1;89;6;1;82;99;5;94
312600073;700;696;696;8;186;594;1;105;7;3;95;81;5;76
312600074;600;612;614;8;156;523;2;75;1;4;70;81;4;77
312600075;400;396;397;5;118;349;1;50;2;0;48;68;3;65
312600076;600;686;686;6;137;519;1;80;4;2;74;57;0;57
312600077;600;643;644;7;163;527;1;72;2;3;67;91;1;90
312600078;500;518;521;7;148;407;2;91;1;3;87;57;2;55
312600079;600;666;669;5;183;471;2;127;2;9;116;56;1;55
312600080;700;722;723;6;226;598;1;101;2;3;96;125;7;118
312600081;700;720;722;7;203;591;1;108;6;6;96;95;12;83
312600082;700;755;756;4;168;619;1;80;1;1;78;88;1;87
312600083;600;605;607;7;142;524;1;75;3;1;71;67;1;66
312600084;600;606;607;6;207;506;1;93;5;2;86;114;6;108
312600085;600;621;621;8;198;480;2;118;5;3;110;80;8;72
312600086;500;551;554;7;153;377;1;122;1;4;117;30;0;30
312600087;600;665;665;9;225;459;2;139;8;5;126;86;2;84
312600088;700;712;712;7;196;590;1;109;2;4;103;87;3;84
312600089;700;730;730;4;228;559;1;140;4;2;134;88;3;85
312600090;500;574;576;3;211;376;1;123;2;4;117;88;2;86
312600091;600;658;661;6;187;506;1;93;3;1;89;94;2;92
312600092;600;653;654;5;211;489;1;110;6;2;102;101;6;95
312600093;600;593;593;5;138;522;1;77;1;1;75;61;2;59
312600094;600;645;646;8;168;486;1;113;7;2;104;55;0;55
312600095;600;618;619;3;186;507;1;92;3;1;88;94;3;91
312600096;600;622;623;6;191;488;1;111;8;9;94;80;5;75
312600097;500;577;577;2;133;412;1;87;8;1;78;46;0;46
312600098;700;769;775;6;175;597;1;102;12;5;85;73;3;70
312600099;500;542;543;4;170;394;1;105;3;2;100;65;3;62
312600100;400;409;411;5;128;314;5;81;4;5;72;47;3;44
312600101;500;532;532;6;191;385;4;111;7;3;101;80;4;76
312600102;100;69;69;5;69;31;0;69;2;2;65;0;0;0
312600103;100;18;18;2;20;80;0;20;0;1;19;0;0;0
312600104;100;10;10;31;41;58;1;41;0;2;39;0;0;0
312600105;100;23;23;16;22;77;1;22;1;3;18;0;0;0
312600106;100;18;18;19;22;77;1;22;1;1;20;0;0;0
320010001;200;0;0;27;27;172;1;27;0;1;26;0;0;0
320010002;300;52;52;17;48;251;1;48;0;1;47;0;0;0
320010003;400;1;1;79;80;319;1;80;1;2;77;0;0;0
320010004;300;1;1;65;66;233;1;66;1;2;63;0;0;0
320010005;400;39;39;97;128;269;3;128;2;2;124;0;0;0
320020006;500;23;23;175;195;304;1;195;5;7;183;0;0;0
320020007;300;5;5;91;96;203;1;96;1;3;92;0;0;0
320020008;800;91;91;535;604;529;1;270;4;10;256;334;14;320
320020009;600;37;37;246;273;467;3;130;7;1;122;143;4;139
320020010;600;26;26;291;312;503;2;95;3;1;91;217;8;209
320020011;600;7;7;260;266;333;1;266;4;6;256;0;0;0
320020012;600;35;35;274;302;297;1;302;6;9;287;0;0;0
320020013;600;25;25;312;337;460;6;134;1;2;131;203;10;193
320020014;600;25;25;244;262;495;2;103;0;0;102;159;6;153
320020015;600;8;8;435;439;411;1;188;0;14;174;251;13;238
320020016;500;24;24;144;167;332;1;167;5;3;159;0;0;0
320020017;600;18;18;218;236;362;2;236;22;6;208;0;0;0
320020018;600;32;32;212;244;354;2;244;6;7;231;0;0;0
320020019;300;3;3;74;76;220;4;76;0;7;69;0;0;0
320020020;600;17;17;187;203;395;2;203;3;4;196;0;0;0
320030021;100;7;7;44;51;48;1;51;1;5;45;0;0;0
320040022;300;6;6;63;68;231;1;68;7;7;54;0;0;0
320040023;300;2;2;9;10;289;1;10;0;1;9;0;0;0
320040024;300;72;72;38;94;204;2;94;1;1;92;0;0;0
320050025;200;3;3;24;27;172;1;27;2;0;25;0;0;0
320090026;200;24;24;29;49;150;1;49;2;1;46;0;0;0
320130027;200;13;13;17;30;169;1;30;0;0;30;0;0;0
320140028;400;10;10;213;222;176;3;221;9;2;210;0;0;0
320140029;400;17;17;162;177;221;2;177;3;3;171;0;0;0
320140030;300;12;12;124;133;166;1;133;2;1;130;0;0;0
320140031;300;24;24;165;184;111;5;184;4;3;177;0;0;0
320140032;300;2;2;225;227;70;3;227;5;4;218;0;0;0
320140033;600;61;61;438;493;413;3;184;4;2;178;309;12;297
320140034;500;98;98;476;555;220;1;279;7;9;263;276;10;266
320140035;600;11;11;323;332;437;2;161;4;3;154;171;3;168
320140036;400;13;13;259;264;134;2;264;15;7;242;0;0;0
320140037;300;13;13;97;109;189;2;109;1;4;104;0;0;0
320140038;400;43;43;185;185;212;3;185;6;3;176;0;0;0
320140039;400;14;14;228;239;160;10;239;9;3;227;0;0;0
320140040;500;10;10;242;251;319;2;179;11;3;165;74;3;71
320140041;400;44;44;189;227;168;5;227;2;2;223;0;0;0
320140042;200;1;1;37;38;161;1;38;1;2;35;0;0;0
320140043;300;13;13;113;125;174;1;125;0;4;121;0;0;0
320180044;200;20;20;16;36;163;1;36;0;3;33;0;0;0
320270045;1000;122;122;243;327;825;1;174;6;4;164;153;2;151
320270046;1000;28;28;465;487;795;3;202;3;10;189;285;7;278
320270047;1000;12;12;347;356;876;2;122;4;5;113;234;9;225
320270048;1000;14;14;389;400;599;9;400;15;8;377;0;0;0
320270049;1000;19;19;386;400;762;1;237;2;9;226;163;1;162
320270050;500;45;45;220;255;244;1;255;6;7;242;0;0;0
320270051;300;0;0;54;54;244;2;54;1;0;53;0;0;0
320270052;400;1;1;34;34;365;1;34;2;6;26;0;0;0
320270053;500;20;20;343;360;308;2;190;4;3;183;170;1;169
320270054;400;0;0;28;28;371;1;28;0;1;27;0;0;0
320270055;400;2;2;151;149;250;1;149;1;4;144;0;0;0
320270056;300;45;45;75;102;195;3;102;1;0;101;0;0;0
320270057;500;13;13;104;114;385;1;114;2;2;110;0;0;0
320270058;600;23;23;274;255;522;6;74;2;2;70;203;2;200
320270059;700;36;36;118;146;551;3;146;11;3;133;0;0;0
320270060;700;18;18;112;125;574;1;125;2;7;116;0;0;0
320270061;700;16;16;115;131;568;1;131;3;5;123;0;0;0
320270062;400;5;5;65;70;329;1;70;0;1;69;0;0;0
320270063;700;11;11;188;196;502;2;196;2;0;194;0;0;0
320270064;300;6;6;98;102;197;1;102;0;6;96;0;0;0
320270065;400;3;3;68;71;328;1;71;3;3;65;0;0;0
320270066;400;27;27;110;132;267;1;132;4;4;124;0;0;0
320270067;500;34;34;225;251;247;2;251;5;6;240;0;0;0
320270068;300;5;5;65;69;230;4;69;3;2;64;0;0;0
320270069;500;12;12;65;77;420;3;77;1;1;75;0;0;0
320270070;500;24;24;165;187;313;0;187;4;9;174;0;0;0
320270071;500;20;20;200;216;415;1;84;2;2;80;132;2;130
320270072;600;4;4;83;87;512;1;87;1;0;86;0;0;0
320270073;500;19;19;151;170;499;1;0;0;0;0;170;4;166
320270074;400;1;1;150;151;247;2;151;5;4;142;0;0;0
320270075;500;40;40;148;184;313;3;184;9;6;169;0;0;0
320270076;300;2;2;105;107;190;3;107;4;3;100;0;0;0
320270077;600;45;45;169;199;400;1;199;2;4;193;0;0;0
320270078;600;15;15;236;247;352;1;247;8;4;235;0;0;0
320270079;500;26;26;250;265;382;1;117;3;2;112;148;2;146
320270080;500;7;7;164;170;420;2;79;1;1;77;91;1;90
320270081;500;13;13;108;119;381;1;119;2;1;116;0;0;0
320270082;400;26;26;307;324;204;2;194;5;5;184;130;5;125
320270083;500;11;11;53;64;435;1;64;2;4;58;0;0;0
320270084;500;52;52;229;279;394;1;105;5;1;99;174;6;168
320270085;500;9;9;255;263;342;1;157;5;3;149;106;4;102
320270086;500;38;38;235;271;226;3;271;13;7;251;0;0;0
320270087;600;48;48;57;72;527;1;72;0;3;69;0;0;0
320270088;500;48;48;248;257;242;1;257;11;2;244;0;0;0
320270089;400;23;23;137;157;237;6;157;1;3;153;0;0;0
320270090;500;39;39;265;302;389;1;110;3;6;101;192;3;189
320270091;500;16;16;382;380;343;2;155;3;3;156;225;7;218
320270092;800;22;22;259;281;613;1;186;5;7;174;95;5;90
320270093;400;25;25;239;259;197;2;201;9;2;190;58;2;56
320270094;500;14;14;202;212;356;1;143;3;3;137;69;2;67
320270095;500;13;13;124;136;362;2;136;2;8;126;0;0;0
320270096;500;13;13;122;133;364;3;133;1;1;131;0;0;0
320270097;500;22;22;265;285;346;1;153;5;1;147;146;6;140
320270098;600;54;54;266;310;444;4;152;4;3;145;158;3;155
320270099;300;6;6;51;55;244;1;55;1;4;50;0;0;0
320270100;400;11;11;163;170;227;3;170;6;3;161;0;0;0
320270101;1200;81;81;524;588;889;7;304;8;7;289;285;7;278
320270102;700;192;192;334;469;526;1;173;4;6;163;296;10;286
320270103;700;21;21;511;518;435;1;264;4;7;253;254;3;251
320270104;700;0;0;382;382;502;11;187;5;4;178;195;3;192
320270105;700;28;28;233;258;440;1;258;3;9;246;0;0;0
320270106;500;47;47;193;203;296;1;203;2;7;194;0;0;0
320270107;500;23;23;126;147;352;1;147;3;10;134;0;0;0
320270108;500;11;11;167;175;323;2;175;5;3;167;0;0;0
320270109;600;40;40;263;295;469;2;129;2;1;126;166;2;164
320270110;600;7;7;257;262;426;2;172;4;3;165;90;3;87
320270111;400;1;1;84;85;314;1;85;1;1;83;0;0;0
320270112;600;14;14;158;170;428;2;170;5;3;162;0;0;0
320270113;500;2;2;154;156;342;2;156;6;1;149;0;0;0
320270114;500;20;20;240;258;240;2;258;3;10;245;0;0;0
320270115;600;28;28;122;147;452;1;147;4;4;139;0;0;0
320270116;400;18;18;67;85;314;1;85;1;0;84;0;0;0
320270117;600;19;19;31;49;549;2;49;0;2;47;0;0;0
320270118;300;3;3;67;70;228;2;70;2;3;65;0;0;0
320270119;500;5;5;135;138;260;3;138;3;5;132;0;0;0
320270120;800;65;65;385;445;552;2;246;8;4;234;199;3;196
320270121;400;35;35;129;157;241;2;157;0;4;153;0;0;0
320270122;500;43;43;192;233;265;2;233;3;2;228;0;0;0
320270123;500;20;20;228;0;413;2;85;0;0;85;160;7;153
320270124;300;3;3;83;86;213;1;86;2;6;78;0;0;0
320270125;600;26;26;191;212;387;1;212;3;6;203;0;0;0
320270126;500;29;29;159;184;315;1;184;1;1;182;0;0;0
320270127;400;2;2;39;39;360;1;39;1;2;36;0;0;0
320270128;400;45;45;288;327;72;1;327;12;11;304;0;0;0
320270129;200;0;0;26;26;173;1;26;1;0;25;0;0;0
320270130;600;84;84;225;289;503;1;96;2;4;90;193;3;190
320270131;600;21;21;333;353;536;1;63;4;2;57;290;5;285
320270132;600;4;4;297;299;283;16;299;3;5;291;0;0;0
320270133;400;3;3;70;73;326;1;73;3;1;69;0;0;0
320270134;600;63;63;201;219;379;2;219;13;6;200;0;0;0
320270135;600;56;56;312;255;507;1;92;2;0;90;163;6;157
320270136;700;38;38;354;354;526;2;172;4;0;168;182;3;179
320270137;500;10;10;111;116;382;2;116;4;4;108;0;0;0
320270138;700;57;57;350;397;532;1;167;4;4;159;230;10;220
320270139;700;6;6;225;230;560;1;139;2;2;135;91;0;91
320270140;0;4;4;176;180;539;2;159;3;2;154;21;3;18
320270141;700;49;49;120;161;534;5;161;5;8;148;0;0;0
320270142;700;10;10;151;161;536;3;161;3;8;150;0;0;0
320270143;400;52;52;36;53;346;1;53;0;2;51;0;0;0
320270144;300;42;42;81;117;179;4;117;3;2;112;0;0;0
320270145;300;1;1;87;88;211;1;88;4;2;82;0;0;0
320270146;600;75;75;298;350;599;1;0;0;0;0;348;11;337
320270147;500;18;18;347;360;136;4;360;16;9;335;0;0;0
320280148;100;22;22;13;31;67;2;31;0;0;31;0;0;0
320290149;500;0;0;77;77;422;1;77;1;5;71;0;0;0
320290150;500;30;30;113;136;357;7;136;1;2;133;0;0;0
320290151;500;2;2;120;120;378;2;120;9;5;106;0;0;0
320290152;600;67;67;415;435;334;1;265;36;3;225;170;2;168
320290153;600;57;57;346;378;411;5;184;19;1;164;195;7;188
320290154;1000;71;71;190;236;763;1;236;0;3;233;0;0;0
320290155;300;43;43;31;46;253;1;46;1;0;45;0;0;0
320290156;300;5;5;46;51;248;1;51;2;2;47;0;0;0
320290157;300;43;43;27;56;242;2;56;1;0;55;0;0;0
320290158;1000;17;17;165;178;821;1;178;1;3;174;0;0;0
320290159;1500;5;5;448;452;1046;2;452;2;15;435;0;0;0
320290160;1500;139;139;496;603;895;2;603;12;21;570;0;0;0
320290161;400;16;16;35;49;350;1;49;0;2;47;0;0;0
320290162;300;20;20;31;48;251;1;48;1;0;47;0;0;0
320290163;300;11;11;43;51;248;1;51;6;2;43;0;0;0
320290164;300;11;11;41;48;251;1;48;0;3;45;0;0;0
320290165;300;7;7;27;30;268;2;30;4;2;24;0;0;0
320290166;300;10;10;57;66;232;2;66;3;1;62;0;0;0
320290167;300;27;27;61;87;212;1;87;0;3;84;0;0;0
320290168;600;17;17;53;70;529;1;70;3;2;65;0;0;0
320290169;600;16;16;102;116;482;2;116;0;8;108;0;0;0
320290170;300;34;34;58;30;211;3;88;2;2;84;0;0;0
320290171;300;15;15;80;94;203;3;94;5;1;88;0;0;0
320290172;600;47;47;157;202;397;1;202;1;11;190;0;0;0
320290173;300;25;25;58;81;218;1;81;1;3;77;0;0;0
320290174;1200;71;71;310;358;840;6;354;4;14;336;4;0;4
320290175;1000;32;32;359;385;612;3;385;2;16;367;0;0;0
320290176;800;41;41;157;166;631;3;166;0;6;160;0;0;0
320300177;500;39;39;188;211;287;2;211;4;1;206;0;0;0
320300178;600;19;19;274;271;532;1;67;3;2;62;224;9;215
320300179;300;19;19;81;98;201;1;98;1;1;96;0;0;0
320300180;200;9;9;59;66;133;1;66;1;1;64;0;0;0
320300181;300;15;15;108;122;177;1;122;0;3;119;0;0;0
320300182;300;8;8;105;113;184;3;113;2;7;104;0;0;0
320300183;300;1;1;127;127;172;1;127;4;1;122;0;0;0
320300184;200;23;23;56;75;123;2;75;3;2;70;0;0;0
320300185;300;13;13;119;132;164;4;132;0;4;128;0;0;0
320370186;200;3;3;43;45;154;1;45;2;3;40;0;0;0
320400187;500;26;26;106;126;373;1;126;3;3;120;0;0;0
320460188;800;77;77;238;297;648;2;150;3;6;141;147;5;142
320460189;500;23;23;128;145;352;3;145;1;3;141;0;0;0
320460190;400;47;47;26;59;340;1;59;0;0;59;0;0;0
320460191;400;30;30;41;68;331;1;68;4;2;62;0;0;0
320460192;400;33;33;70;101;298;1;101;1;6;94;0;0;0
320470193;300;33;33;52;82;215;3;82;0;3;79;0;0;0
320480194;600;50;50;247;286;496;2;102;4;2;96;184;2;182
320480195;600;2;2;236;238;360;2;238;10;2;226;0;0;0
320480196;600;1;1;276;276;321;3;276;10;2;264;0;0;0
320480197;300;26;26;68;90;209;1;90;0;5;85;0;0;0
320480198;400;26;26;183;183;215;2;183;2;4;177;0;0;0
320480199;500;5;5;201;206;293;1;206;2;3;201;0;0;0
320480200;300;6;6;86;91;206;3;91;0;0;91;0;0;0
320480201;400;7;7;167;174;224;2;174;8;1;165;0;0;0
320480202;200;4;4;31;33;165;2;33;0;0;33;0;0;0
320480203;600;116;116;204;302;347;2;251;6;2;242;51;2;49
320480204;600;8;8;374;378;459;1;140;0;4;136;238;3;235
320480205;300;19;19;102;116;183;1;116;5;2;109;0;0;0
320480206;400;28;28;139;160;236;4;160;7;7;146;0;0;0
320480207;1000;73;73;223;286;850;4;146;2;3;141;140;2;138
320480208;1000;15;15;346;354;861;6;133;8;1;124;221;5;216
320480209;600;10;10;327;335;559;1;40;0;1;39;285;4;281
320480210;300;2;2;59;61;238;1;61;0;2;59;0;0;0
320480211;1000;41;41;205;238;818;2;180;3;6;171;59;0;59
320480212;100;0;0;215;215;784;1;215;4;3;208;0;0;0
320480213;300;82;82;0;82;214;4;86;4;0;82;0;0;0
320480214;300;7;7;111;118;178;4;118;5;3;110;0;0;0
320480215;300;21;21;133;153;146;1;153;3;8;142;0;0;0
320480216;300;2;2;106;108;190;2;108;1;5;102;0;0;0
320480217;300;32;32;59;62;237;1;62;1;0;61;0;0;0
320480218;200;4;4;48;52;147;1;52;0;0;52;0;0;0
320480219;400;31;31;174;201;198;1;201;5;5;191;0;0;0
320480220;300;2;2;40;40;259;1;40;1;6;33;0;0;0
320480221;297;79;79;94;158;136;3;158;1;5;152;0;0;0
320480222;600;27;27;245;261;454;4;142;25;0;117;119;3;116
320480223;300;12;12;69;81;218;1;81;2;0;79;0;0;0
320480224;200;44;44;42;71;128;1;71;1;0;70;0;0;0
320480225;300;15;15;44;56;243;1;56;0;4;52;0;0;0
320480226;300;140;140;9;140;159;1;140;2;3;135;0;0;0
320480227;400;26;26;164;183;215;2;183;3;3;177;0;0;0
320480228;600;32;32;222;246;353;1;246;11;2;233;0;0;0
320480229;600;30;30;194;211;386;3;211;7;6;198;0;0;0
320480230;400;14;14;126;137;262;1;137;0;4;133;0;0;0
320480231;500;4;4;197;201;299;1;200;5;3;192;0;0;0
320480232;300;50;50;112;141;157;2;141;4;2;135;0;0;0
320480233;200;7;7;62;69;130;1;69;1;1;67;0;0;0
320480234;300;12;12;43;55;244;1;55;0;1;54;0;0;0
320480235;1000;50;50;240;278;855;10;145;9;2;135;136;4;132
320480236;1000;5;5;246;250;877;1;122;0;0;122;128;0;128
320480237;500;212;212;193;212;500;0;0;0;0;0;212;0;210
320480238;400;6;6;246;252;146;2;252;4;0;248;0;0;0
320480239;200;0;0;84;84;115;1;84;2;1;81;0;0;0
320480240;300;41;41;50;82;217;1;82;1;6;75;0;0;0
320480241;400;24;24;163;159;238;3;159;14;2;143;0;0;0
320480242;200;10;10;46;56;143;1;56;0;0;56;0;0;0
320480243;400;45;45;80;118;280;2;118;3;5;110;0;0;0
320480244;300;18;18;68;84;215;1;84;0;5;79;0;0;0
320480245;300;8;8;67;73;226;1;73;0;1;72;0;0;0
320480246;300;6;6;211;217;80;3;217;4;7;206;0;0;0
320480247;200;0;0;31;31;166;3;31;3;2;26;0;0;0
320480248;300;3;3;53;56;243;1;56;1;2;53;0;0;0
320480249;400;32;32;119;151;248;1;151;2;3;146;0;0;0
320480250;600;16;16;299;311;480;3;117;0;0;117;194;3;191
320480251;300;36;36;73;101;198;1;101;1;2;98;0;0;0
320480252;300;2;2;105;107;192;1;111;4;4;99;0;0;0
320480253;300;47;47;25;57;242;1;57;1;3;53;0;0;0
320480254;300;5;5;55;60;239;1;60;0;0;60;0;0;0
320480255;600;6;6;143;149;449;2;149;3;3;143;0;0;0
320480256;500;0;0;165;165;334;1;165;4;2;159;0;0;0
320480257;700;42;42;337;371;512;2;186;6;1;179;185;3;182
320490258;1000;51;51;130;173;823;4;173;0;8;165;0;0;0
320490259;1000;3;3;145;146;853;1;146;1;5;140;0;0;0
320490260;200;46;46;19;36;163;1;36;0;0;36;0;0;0
320490261;300;40;40;35;62;237;1;62;2;4;56;0;0;0
320490262;300;44;44;38;64;234;2;64;0;1;63;0;0;0
320490263;600;35;35;102;133;465;2;133;0;2;131;0;0;0
320490264;600;33;33;104;127;470;3;127;2;2;123;0;0;0
320490265;600;9;9;93;100;499;1;100;4;3;91;0;0;0
320490266;300;1;1;53;54;244;2;54;1;0;53;0;0;0
320490267;800;64;64;213;255;543;2;255;5;3;247;0;0;0
320490268;700;14;14;223;236;565;1;134;6;2;126;101;5;95
320490269;700;12;12;258;267;575;1;124;4;1;119;143;5;138
320490270;600;43;43;96;134;464;2;134;6;0;128;0;0;0
320490271;600;15;15;101;114;485;1;114;4;3;107;0;0;0
320490272;300;6;6;71;77;222;1;77;0;5;72;0;0;0
320490273;300;36;36;46;75;224;1;75;3;0;72;0;0;0
320490274;400;3;3;70;73;326;1;73;3;2;68;0;0;0
320490275;600;15;15;68;83;515;2;83;2;2;79;0;0;0
320490276;200;43;43;9;25;174;0;25;0;2;23;0;0;0
320490277;300;19;19;29;47;251;2;47;1;3;43;0;0;0
320490278;600;80;80;65;79;520;1;79;3;7;69;0;0;0
320490279;600;69;69;61;101;495;4;101;0;2;99;0;0;0
320490280;600;30;30;85;112;486;2;112;3;5;104;0;0;0
320490281;200;47;47;22;51;147;2;51;2;0;49;0;0;0
320490282;300;7;7;63;68;230;2;68;2;1;65;0;0;0
320490283;200;51;51;17;37;162;1;37;0;1;36;0;0;0
320490284;600;58;58;145;181;413;6;181;8;6;167;0;0;0
320500285;100;9;9;28;37;62;1;37;0;1;36;0;0;0
320540286;400;24;24;186;205;194;1;205;5;0;200;0;0;0
320540287;800;14;14;291;303;727;1;72;1;0;71;231;8;223
320540288;600;45;45;196;228;546;2;52;1;0;51;176;2;174
320540289;500;25;25;181;201;296;3;201;2;2;197;0;0;0
320540290;300;15;15;53;67;232;1;67;2;0;65;0;0;0
320540291;400;18;18;129;145;253;2;145;5;0;140;0;0;0
320540292;200;41;41;10;36;163;1;36;1;0;35;0;0;0
320540293;200;14;14;46;60;137;3;60;0;2;58;0;0;0
320540294;600;55;55;296;345;457;4;139;4;2;133;206;2;204
320540295;500;13;13;205;218;281;1;218;3;0;215;0;0;0
320540296;400;24;24;118;137;260;3;137;1;2;134;0;0;0
320540297;200;13;13;89;96;103;1;96;2;0;94;0;0;0
320540298;300;9;9;120;127;172;1;127;2;3;122;0;0;0
320540299;200;4;4;74;78;120;2;78;1;2;75;0;0;0
320540300;1000;38;38;122;151;874;3;123;10;2;111;28;1;27
320540301;500;7;7;222;225;272;3;225;1;2;222;0;0;0
320550302;300;6;6;48;53;246;1;53;2;3;48;0;0;0
320560303;900;67;67;302;356;698;18;202;18;3;181;153;4;149
320560304;500;16;16;90;96;404;2;96;2;2;92;0;0;0
320560305;500;0;0;62;62;438;6;62;4;0;58;0;0;0
320560306;800;11;11;227;238;781;19;115;16;6;94;123;5;118
320560307;900;24;24;284;302;753;1;146;21;1;124;156;4;152
320560308;800;24;24;227;247;551;1;248;30;3;215;0;0;0
320560309;800;21;21;239;254;543;3;254;25;3;226;0;0;0
320560310;500;0;0;82;82;416;2;82;1;6;75;0;0;0
320570311;100;12;12;24;34;65;1;34;0;2;32;0;0;0
320570312;100;14;14;24;36;63;1;36;0;1;35;0;0;0
320610313;400;94;94;97;184;214;2;184;2;9;173;0;0;0
320640314;200;5;5;53;58;141;1;58;3;2;53;0;0;0
320680315;200;4;4;36;40;159;1;40;0;2;38;0;0;0
320710316;0;79;79;326;391;446;3;152;2;4;147;239;6;233
320710317;400;32;32;221;250;148;2;250;3;4;243;0;0;0
320760318;800;13;13;152;165;635;0;165;4;7;154;0;0;0
320760319;800;34;34;175;204;596;0;204;0;4;200;0;0;0
320770320;100;4;4;28;32;67;1;32;0;1;31;0;0;0
320800321;500;8;8;135;141;357;2;141;37;3;101;0;0;0
320800322;1000;1;1;115;116;883;1;116;6;0;110;0;0;0
320800323;500;1;1;84;85;414;1;85;5;1;79;0;0;0
320800324;500;0;0;25;25;474;1;25;4;0;21;0;0;0
320800325;500;0;0;10;10;489;1;10;0;0;10;0;0;0
320800326;500;0;0;134;134;365;1;134;15;2;117;0;0;0
320800327;500;1;1;75;76;423;1;76;17;1;58;0;0;0
320870328;500;50;50;264;292;296;2;202;4;7;191;90;1;89
320870329;500;4;4;256;257;241;2;257;7;10;240;0;0;0
320870330;500;3;3;162;164;335;1;164;4;10;150;0;0;0
320870331;500;3;3;338;341;159;1;340;23;8;309;0;0;0
320870332;1000;83;83;476;530;828;2;170;4;22;144;360;19;341
320870333;900;80;80;323;374;808;1;91;2;2;87;283;8;275
320870334;800;5;5;292;295;695;1;104;7;4;93;189;4;183
320870335;300;12;12;103;113;185;2;113;0;4;109;0;0;0
320870336;500;63;63;231;275;431;1;68;2;2;64;206;7;200
320870337;600;16;16;111;123;567;1;32;0;2;30;91;12;79
320870338;400;9;9;119;124;275;1;124;1;6;117;0;0;0
320870339;500;66;66;134;200;298;2;200;0;16;184;0;0;0
320870340;300;54;54;129;175;123;2;175;2;5;168;0;0;0
320870341;400;34;34;124;154;243;3;154;6;13;135;0;0;0
320870342;300;45;45;61;63;236;1;63;2;2;58;0;0;0
320870343;200;63;63;61;63;136;1;63;1;2;60;0;0;0
320870344;300;31;31;56;82;217;1;82;0;11;71;0;0;0
320870345;300;29;29;123;149;151;2;149;6;0;143;0;0;0
320870346;300;19;19;65;79;220;1;79;1;4;74;0;0;0
320870347;700;51;51;339;373;570;2;128;7;1;120;245;7;238
320870348;300;55;55;122;163;136;1;163;1;8;154;0;0;0
320870349;500;35;35;175;204;295;1;204;4;3;197;0;0;0
320870350;400;17;17;139;153;246;1;153;1;3;149;0;0;0
320870351;300;6;6;90;94;204;2;94;2;3;89;0;0;0
320890352;400;9;9;95;103;295;2;103;0;4;99;0;0;0
320900353;400;47;47;272;311;89;11;300;4;2;294;0;0;0
320900354;200;5;5;65;69;130;1;69;0;2;67;0;0;0
320900355;200;27;27;18;36;163;1;36;0;4;32;0;0;0
320900356;200;9;9;50;57;142;1;57;0;1;56;0;0;0
320900357;200;7;7;55;62;136;2;62;0;4;58;0;0;0
320900358;300;19;19;118;136;163;1;136;8;5;123;0;0;0
320900359;200;48;48;16;55;144;145;55;0;6;49;0;0;0
320900360;200;11;11;53;63;136;1;63;0;0;63;0;0;0
320900361;200;2;2;44;45;153;2;45;0;3;42;0;0;0
320910362;200;1;1;79;80;118;2;80;2;4;74;0;0;0
320910363;800;26;26;213;228;617;1;182;2;3;177;46;0;46
320920364;300;13;13;80;80;219;1;80;0;5;75;0;0;0
320920365;300;13;13;130;141;157;2;141;3;3;135;0;0;0
320920366;300;17;17;101;118;181;1;118;1;5;112;0;0;0
320920367;200;20;20;53;65;133;2;65;0;5;60;0;0;0
320920368;300;20;20;77;96;203;1;96;2;3;91;0;0;0
320920369;200;13;13;51;60;139;1;60;1;4;55;0;0;0
320920370;400;31;31;202;223;175;2;223;5;6;212;0;0;0
320920371;300;2;2;104;106;193;1;106;1;2;103;0;0;0
320920372;300;17;17;100;114;185;1;114;1;4;109;0;0;0
320920373;0;21;21;123;140;159;1;140;0;6;134;0;0;0
320920374;300;3;3;106;108;191;1;108;7;4;97;0;0;0
320920375;300;28;28;107;128;168;4;128;3;1;124;0;0;0
320920376;500;43;43;247;281;384;3;113;2;3;108;168;1;167
320920377;200;8;8;69;74;125;1;74;1;2;71;0;0;0
320920378;300;2;2;121;123;175;2;123;1;10;112;0;0;0
320920379;400;26;26;165;183;216;1;183;3;3;177;0;0;0
320920380;500;23;23;202;221;438;3;59;1;2;56;162;2;160
320920381;400;19;19;166;178;219;3;178;3;4;171;0;0;0
320920382;300;10;10;135;144;155;1;144;3;3;138;0;0;0
320920383;300;7;7;84;89;210;1;89;1;4;84;0;0;0
320920384;600;48;48;251;288;484;3;113;3;3;107;175;8;167
320920385;300;47;47;124;154;144;2;154;1;10;143;0;0;0
320920386;200;3;3;41;44;155;1;44;0;2;42;0;0;0
320920387;200;20;20;53;70;129;1;70;0;5;65;0;0;0
320920388;300;2;2;105;107;192;1;107;1;5;101;0;0;0
320920389;300;11;11;87;98;197;5;98;2;4;92;0;0;0
320920390;300;12;12;117;127;172;1;127;0;7;120;0;0;0
320920391;500;31;31;250;271;399;4;97;6;3;88;174;7;167
320920392;300;23;23;141;164;135;1;164;2;6;156;0;0;0
320920393;200;4;4;29;32;168;1;32;2;3;27;0;0;0
320920394;500;41;41;224;260;378;2;120;4;2;114;140;4;136
320920395;200;28;28;35;58;141;1;58;0;2;56;0;0;0
320920396;400;55;55;116;161;237;2;161;1;3;157;0;0;0
320920397;200;10;10;69;78;120;2;78;5;1;72;0;0;0
320920398;200;2;2;36;38;161;1;38;0;1;37;0;0;0
320920399;300;9;9;92;101;198;1;101;0;0;101;0;0;0
320920400;300;27;27;127;146;153;1;146;1;3;142;0;0;0
320920401;400;20;20;145;155;244;1;155;0;6;149;0;0;0
320920402;200;4;4;64;67;132;2;67;1;8;58;0;0;0
320920403;500;20;20;342;351;368;2;130;2;1;127;221;5;216
320920404;500;2;2;285;287;409;1;90;2;4;84;198;3;194
320920405;500;2;2;213;213;428;1;71;0;1;70;142;4;138
320920406;500;0;0;190;190;318;8;182;8;2;172;8;4;4
320920407;200;10;10;102;103;94;3;103;1;6;96;0;0;0
320920408;500;57;57;270;318;407;4;89;7;2;80;229;8;221
320920409;400;19;19;220;11;187;1;212;4;5;203;0;0;0
320920410;400;2;2;198;200;197;3;200;1;5;194;0;0;0
320920411;700;41;41;287;314;402;4;294;6;14;274;24;0;13
320920412;300;6;6;72;77;218;5;77;1;0;76;0;0;0
320920413;500;17;17;232;243;405;1;94;2;4;88;149;6;143
320920414;400;36;36;186;209;187;4;209;6;5;198;0;0;0
320920415;400;8;8;182;185;213;2;185;0;3;182;0;0;0
320920416;400;22;22;139;155;244;1;155;4;6;145;0;0;0
320920417;600;37;37;238;269;518;2;80;7;3;70;189;8;181
320920418;500;2;2;239;241;438;1;61;6;3;52;180;3;177
320920419;200;127;127;125;125;72;3;125;5;2;118;0;0;0
320920420;300;19;19;130;146;153;1;146;1;6;139;0;0;0
320920421;500;25;25;217;239;312;2;186;9;8;169;53;3;50
320920422;400;4;4;249;249;358;3;39;4;1;33;211;3;208
320920423;500;30;30;349;371;461;3;36;0;0;36;335;8;327
320920424;500;2;2;206;208;317;3;180;4;7;169;28;0;28
320920425;500;39;39;331;365;395;3;102;2;4;96;263;9;254
320920426;300;8;8;95;99;200;1;99;3;1;95;0;0;0
320920427;400;5;5;294;298;101;1;298;0;5;293;0;0;0
320920428;400;31;31;278;302;374;1;25;1;0;24;277;7;270
320920429;300;6;6;115;118;178;4;118;2;2;114;0;0;0
320920430;400;13;13;160;170;369;1;30;2;4;24;140;4;136
320920431;600;27;27;319;338;562;1;37;0;0;37;301;2;299
320920432;400;5;5;235;237;162;1;237;6;6;225;0;0;0
320920433;400;7;7;173;177;222;1;177;9;4;164;0;0;0
320920434;400;46;46;196;230;168;2;230;3;9;218;0;0;0
320920435;200;9;9;84;93;106;1;93;3;1;89;0;0;0
320920436;300;19;19;233;247;48;5;247;11;9;227;0;0;0
320920437;400;24;24;131;146;252;2;146;4;6;136;0;0;0
320920438;800;112;112;314;386;540;2;258;10;8;240;127;3;124
320920439;800;21;21;339;356;556;1;243;9;5;229;113;3;110
320920440;700;19;19;503;514;320;3;377;5;8;364;136;3;133
320920441;400;16;16;353;363;34;3;363;11;9;343;0;0;0
320920442;300;16;16;130;143;154;3;143;4;3;136;0;0;0
320920443;500;40;40;203;238;493;1;6;0;0;6;232;8;224
320920444;300;15;15;100;115;183;2;115;1;3;111;0;0;0
320920445;500;16;16;260;275;394;2;104;5;4;94;171;8;163
320920446;500;18;18;203;221;440;1;60;1;2;55;163;3;160
320920447;400;59;59;150;189;207;3;189;1;5;183;0;0;0
320920448;400;31;31;226;254;142;4;254;5;3;246;0;0;0
320920449;300;13;13;80;92;207;1;92;0;3;89;0;0;0
320920450;300;25;25;117;140;158;2;140;4;9;127;0;0;0
320920451;400;30;30;193;217;178;5;217;5;4;208;0;0;0
320920452;200;7;7;95;102;97;1;102;1;6;95;0;0;0
320920453;300;11;11;151;162;137;1;162;2;7;153;0;0;0
320920454;200;6;6;70;73;126;1;73;0;1;72;0;0;0
320920455;300;16;16;154;168;132;8;168;6;9;153;0;0;0
320920456;299;7;7;137;144;154;1;144;0;2;142;0;0;0
320920457;200;18;18;77;95;103;2;95;0;12;83;0;0;0
320920458;500;44;44;255;292;440;1;60;1;1;58;232;12;220
320920459;300;47;47;85;120;179;1;120;3;4;113;0;0;0
320920460;400;65;65;194;208;191;1;208;0;8;200;0;0;0
320920461;200;9;9;55;63;136;1;63;0;2;61;0;0;0
320920462;400;20;20;243;257;332;1;67;3;4;60;190;11;179
320920463;200;8;8;85;91;108;1;91;1;4;86;0;0;0
320920464;200;5;5;73;78;120;2;78;3;2;73;0;0;0
320920465;300;24;24;79;99;199;2;99;3;11;85;0;0;0
320920466;300;23;23;114;134;165;1;134;2;6;126;0;0;0
320920467;200;22;22;66;83;115;2;83;2;5;76;0;0;0
320920468;300;29;29;97;124;174;2;124;3;8;113;0;0;0
320920469;300;3;3;158;161;138;1;161;6;4;151;0;0;0
320920470;300;4;4;72;76;223;1;76;1;2;73;0;0;0
320920471;300;12;12;159;168;130;2;168;4;4;160;0;0;0
320920472;300;19;19;153;167;131;2;167;5;7;155;0;0;0
320920473;300;13;13;175;184;115;1;184;4;12;168;0;0;0
320920474;300;13;13;90;103;196;1;103;0;4;99;0;0;0
320920475;400;29;29;199;223;175;2;223;5;7;211;0;0;0
320920476;300;11;11;74;81;218;1;81;0;9;72;0;0;0
320920477;300;12;12;116;128;171;1;128;5;6;117;0;0;0
320920478;500;18;18;301;318;398;2;100;6;1;93;218;5;213
320920479;200;9;9;68;77;122;1;77;2;3;72;0;0;0
320920480;300;24;24;170;190;107;3;190;5;2;183;0;0;0
320920481;300;13;13;75;87;212;1;87;1;5;81;0;0;0
320990482;500;38;38;153;182;317;1;182;1;4;177;0;0;0
320990483;300;22;22;67;88;211;1;88;3;5;80;0;0;0
321000484;600;38;38;197;228;478;1;121;4;4;113;107;4;103
321000485;300;3;3;27;29;270;1;29;1;2;26;0;0;0
321000486;300;8;8;53;60;238;2;60;0;1;59;0;0;0
321010487;200;8;8;28;34;165;1;34;0;1;33;0;0;0
321020488;500;66;66;160;222;277;1;222;1;17;204;0;0;0
321030489;700;49;49;168;217;482;1;217;9;9;199;0;0;0
321030490;200;15;15;33;45;154;1;45;2;0;43;0;0;0
321040491;300;7;7;37;44;255;1;44;0;0;44;0;0;0
321040492;400;37;37;42;70;328;2;70;0;2;68;0;0;0
321040493;600;48;48;150;192;405;3;192;1;3;188;0;0;0
321060494;100;3;3;21;24;75;1;24;1;4;19;0;0;0
321070495;300;1;1;81;82;215;2;82;0;3;79;0;0;0
321070496;500;42;42;418;453;125;6;369;7;4;358;82;1;81
321070497;500;31;31;256;279;483;1;16;1;0;15;263;6;257
321070498;300;10;10;67;74;225;2;74;1;1;72;0;0;0
321070499;500;12;12;179;188;311;1;188;0;8;180;0;0;0
321070500;500;24;24;205;222;431;1;68;0;0;68;154;3;151
321070501;400;23;23;95;110;289;1;110;0;0;110;0;0;0
321070502;200;49;49;17;45;154;1;45;0;1;44;0;0;0
321070503;700;42;42;365;404;370;3;327;3;0;324;77;1;76
321070504;300;43;43;36;63;234;3;63;0;1;62;0;0;0
321070505;300;6;6;68;74;225;1;74;2;1;71;0;0;0
321070506;400;22;22;117;135;262;3;135;2;1;132;0;0;0
321070507;600;12;12;524;534;379;6;220;5;0;215;314;3;311
321070508;600;17;17;140;150;449;1;150;0;3;147;0;0;0
321070509;600;5;5;145;150;449;1;150;0;5;145;0;0;0
321070510;300;0;0;85;85;214;2;85;1;0;84;0;0;0
321070511;300;43;43;27;55;244;1;55;0;2;53;0;0;0
321070512;200;44;44;33;48;150;2;48;1;1;46;0;0;0
321070513;300;4;4;98;102;197;1;102;1;2;99;0;0;0
321070514;600;14;14;288;301;561;4;35;0;0;35;266;4;262
321070515;400;9;9;127;134;265;1;134;3;1;130;0;0;0
321070516;500;17;17;347;362;365;7;132;4;1;127;230;4;225
321070517;500;16;16;169;182;456;3;43;2;1;40;139;0;138
321070518;200;42;42;17;42;156;2;42;1;1;40;0;0;0
321070519;300;87;87;85;87;211;2;87;1;1;85;0;0;0
321070520;300;20;20;128;146;153;2;146;1;24;121;0;0;0
321070521;300;47;47;11;40;259;1;40;0;0;40;0;0;0
321070522;300;4;4;80;84;215;1;84;1;5;78;0;0;0
321070523;300;21;21;83;102;197;1;102;3;0;99;0;0;0
321070524;400;14;14;88;100;298;2;100;0;2;98;0;0;0
321070525;800;50;50;405;428;414;3;383;17;7;359;45;0;45
321070526;500;17;17;94;108;391;1;108;1;0;107;0;0;0
321070527;300;45;45;82;114;185;1;114;0;8;106;0;0;0
321070528;200;56;56;31;70;129;1;70;1;1;68;0;0;0
321070529;300;51;51;25;59;240;1;59;0;0;59;0;0;0
321070530;300;49;49;23;55;244;1;55;0;3;52;0;0;0
321070531;300;53;53;32;72;227;1;72;1;2;69;0;0;0
321070532;300;3;3;61;64;235;1;64;0;0;64;0;0;0
321070533;300;24;24;81;100;199;1;100;6;2;92;0;0;0
321070534;300;12;12;71;83;216;1;83;0;1;82;0;0;0
321070535;300;14;14;75;89;210;1;89;0;5;84;0;0;0
321070536;500;69;69;137;159;340;1;159;3;1;155;0;0;0
321070537;600;34;34;194;221;374;5;221;2;1;218;0;0;0
321070538;300;45;45;46;88;211;6;88;5;0;83;0;0;0
321070539;300;43;43;22;42;257;1;42;3;2;37;0;0;0
321070540;600;22;22;117;136;462;2;136;2;1;133;0;0;0
321070541;300;0;0;32;32;266;2;32;0;2;30;0;0;0
321070542;400;3;3;106;108;291;2;108;1;1;106;0;0;0
321070543;400;12;12;97;109;290;1;109;1;3;105;0;0;0
321070544;300;3;3;89;90;209;1;90;2;1;87;0;0;0
321070545;300;3;3;80;83;214;3;83;1;1;81;0;0;0
321070546;300;7;7;83;90;208;2;90;2;0;88;0;0;0
321070547;300;25;25;73;96;203;1;96;0;4;92;0;0;0
321070548;200;5;5;56;60;136;4;60;1;0;59;0;0;0
321070549;300;12;12;73;83;217;3;83;2;2;79;0;0;0
321080550;500;22;22;112;133;366;1;133;10;0;123;0;0;0
321080551;300;8;8;62;69;228;3;69;17;3;49;0;0;0
321080552;500;42;42;6;12;487;1;12;1;0;11;0;0;0
321080553;300;43;43;33;38;261;1;38;8;0;30;0;0;0
321080554;300;3;3;58;61;237;5;61;3;0;58;0;0;0
321080555;300;2;2;26;27;272;1;27;1;2;24;0;0;0
321090556;300;24;24;37;56;242;2;56;0;0;56;0;0;0
321110557;700;31;31;141;172;527;1;172;3;2;167;0;0;0
321120558;300;21;21;72;91;207;2;91;2;3;86;0;0;0
321150559;500;15;15;73;85;414;1;85;2;9;74;0;0;0
321150560;1000;41;41;162;182;918;1;81;8;2;71;101;3;100
321150561;500;4;4;78;82;417;1;82;4;3;75;0;0;0
321150562;1500;46;46;348;394;1307;25;193;24;2;167;200;7;193
321160563;300;5;5;17;22;277;2;22;1;0;21;0;0;0
321180564;300;45;45;83;115;184;1;115;15;4;96;0;0;0
321180565;600;264;264;222;321;599;1;0;0;0;320;321;1;320
321180566;300;114;114;57;118;181;1;118;3;0;115;0;0;0
321180567;400;92;92;21;75;323;5;75;3;0;72;0;0;0
321180568;400;20;20;77;90;309;1;90;12;0;78;0;0;0
321180569;600;147;147;106;193;405;2;193;20;3;170;0;0;0
321180570;1000;270;270;128;341;999;1;0;0;0;0;341;0;341
321180571;400;114;114;61;135;264;1;135;9;0;126;0;0;0
321180572;1000;131;131;149;233;999;1;0;0;0;0;233;1;232
321180573;1000;150;150;71;163;836;1;163;10;1;152;0;0;0
321180574;1000;49;49;318;348;661;1;338;56;1;281;10;0;10
321180575;1000;27;27;45;72;923;5;72;4;0;68;0;0;0
321180576;1000;107;107;89;159;840;1;159;5;1;153;0;0;0
321180577;1000;88;88;20;51;947;2;51;3;0;48;0;0;0
321180578;1000;411;411;171;411;621;1;378;27;0;351;33;0;33
321180579;1000;265;265;391;498;957;2;41;1;0;40;457;0;457
321180580;1000;84;84;183;226;876;0;124;8;0;116;102;0;102
321180581;1000;19;19;287;306;999;1;0;0;0;0;306;0;306
321180582;1000;46;46;182;190;809;1;190;22;0;168;0;0;0
321180583;1000;77;77;345;369;999;1;0;0;0;0;369;0;369
321180584;1000;50;50;256;271;871;3;126;18;0;108;145;0;145
321180585;1000;99;99;332;433;624;1;375;60;0;315;58;2;56
321180586;900;94;94;216;247;649;4;247;15;2;230;0;0;0
321180587;1000;43;43;55;64;943;3;54;1;0;53;10;0;10
321180588;1000;73;73;253;288;980;3;17;2;0;15;271;0;271
321180589;1000;53;53;296;326;999;1;0;0;0;0;326;0;326
321180590;1000;89;89;356;392;999;1;0;0;0;0;392;1;391
321180591;1000;63;63;289;305;941;2;57;8;0;49;248;2;246
321180592;1000;80;80;312;347;999;1;0;0;0;0;347;0;347
321180593;1000;16;16;287;303;998;1;1;0;0;1;302;1;302
321180594;1000;56;56;384;440;999;1;0;0;0;0;440;0;440
321180595;1000;69;69;193;220;981;1;18;1;0;17;202;0;202
321180596;1000;53;53;173;182;950;1;49;1;0;48;133;0;133
321180597;1000;82;82;286;327;815;2;183;12;0;171;144;0;144
321180598;1000;74;74;255;300;938;1;61;14;0;47;239;0;239
321180599;1000;68;68;277;313;999;1;0;0;0;0;313;0;313
321180600;1000;57;57;243;265;751;7;242;11;0;230;23;2;21
321180601;1000;70;70;436;461;792;2;206;25;0;181;255;0;255
321180602;1000;111;111;243;288;708;4;288;21;1;266;0;0;0
321180603;1000;18;18;143;161;838;1;161;2;3;156;0;0;0
321180604;1000;86;86;364;399;612;4;384;30;1;353;15;0;15
321180605;1000;71;71;118;135;945;2;53;6;0;47;82;0;82
321180606;0;76;76;402;410;997;1;2;0;0;2;408;0;408
321180607;1000;79;79;390;434;951;1;48;1;0;47;386;0;386
321180608;1000;80;80;411;435;894;1;105;18;0;87;330;0;330
321180609;1000;66;66;306;338;963;1;36;8;0;28;302;0;302
321180610;1000;97;97;148;245;931;1;68;11;2;55;177;0;177
321180611;1000;144;144;167;234;988;1;11;0;0;11;223;0;223
321180612;1000;64;64;145;168;828;4;168;6;0;162;0;0;0
321180613;1000;77;77;318;361;965;1;34;3;0;31;327;1;326
321180614;1000;57;57;317;283;716;1;0;0;0;0;0;0;0
321180615;1500;82;82;238;282;1222;1;277;27;0;251;5;0;6
321180616;1000;121;121;438;517;996;1;3;0;0;3;514;0;514
321180617;1000;120;120;323;389;931;1;68;9;0;59;321;0;320
321180618;1000;119;119;327;384;999;1;0;0;0;0;384;1;383
321180619;1000;48;48;55;84;909;7;84;5;0;79;0;0;0
321180620;1000;183;183;138;179;818;3;179;20;1;158;0;0;0
321180621;400;162;162;111;167;232;1;167;18;0;149;0;0;0
321180622;400;416;416;288;451;0;1;0;0;0;0;451;1;450
321180623;1000;133;133;96;167;832;1;167;9;0;158;0;0;0
321180624;1000;320;320;497;564;778;1;221;19;0;202;343;0;343
321180625;1000;167;167;451;523;753;2;245;23;2;220;278;2;276
321180626;1000;387;387;232;336;798;1;201;16;0;185;135;0;135
321180627;400;50;50;110;140;258;2;140;11;0;126;0;0;0
321180628;1000;194;194;418;496;659;1;340;21;0;319;156;0;156
321180629;1000;333;333;194;306;960;1;39;4;0;35;267;0;267
321180630;1000;209;209;264;346;962;1;37;6;0;31;309;0;309
321180631;600;276;276;166;288;500;1;99;23;0;76;189;0;189
321180632;800;271;271;176;282;780;1;19;5;0;14;263;0;263
321180633;600;103;103;259;313;580;1;19;0;0;19;294;0;294
321180634;600;102;102;271;315;594;1;5;0;0;5;310;0;310
321180635;1000;169;169;479;556;742;1;257;27;0;230;299;0;299
321180636;1000;149;149;528;588;691;2;307;22;0;285;281;0;281
321180637;800;317;317;217;408;798;1;1;0;0;1;407;0;407
321180638;800;122;122;307;429;798;2;0;0;0;0;429;0;429
321180639;1000;404;404;395;627;999;1;0;0;0;0;627;0;627
321180640;400;58;58;87;112;287;1;112;15;0;97;0;0;0
321180641;1000;24;24;105;123;876;1;123;8;2;113;0;0;0
321180642;1000;117;117;153;182;816;2;182;28;0;154;0;0;0
321180643;1000;44;44;113;126;873;1;126;11;0;115;0;0;0
321180644;1000;69;69;254;237;999;1;0;0;0;0;237;0;237
321180645;1000;109;109;253;327;765;2;233;31;0;202;94;0;94
321180646;1500;136;136;315;378;1441;2;57;7;0;50;321;0;321
321180647;1000;135;135;296;375;940;1;59;10;0;49;316;1;315
321180648;1000;143;143;259;339;920;3;77;10;0;67;262;2;260
321180649;1000;129;129;315;357;991;1;8;0;1;7;349;0;349
321180650;1000;107;107;400;433;942;1;57;11;1;45;376;0;376
321180651;1500;65;65;228;266;1480;4;266;3;0;263;247;0;263
321180652;1000;43;43;169;185;814;1;185;9;0;176;0;0;0
321180653;1000;52;52;379;414;999;1;0;0;0;0;414;0;414
321180654;1500;52;52;367;398;1351;1;148;18;0;126;251;4;247
321180655;1000;157;157;270;357;736;2;262;44;0;218;95;0;95
321180656;1000;115;115;141;206;875;1;124;5;0;119;82;0;82
321180657;1000;52;52;240;270;969;1;30;1;0;29;240;1;239
321180658;1000;47;47;281;289;710;1;289;38;0;251;0;0;0
321180659;1000;167;167;210;310;783;0;217;28;0;189;93;0;93
321180660;1000;165;165;269;350;998;1;1;0;0;1;349;1;348
321180661;1500;46;46;100;113;1383;4;113;11;0;102;0;0;0
321180662;1500;30;30;95;107;1392;1;107;11;0;96;0;0;0
321180663;1000;50;50;112;121;878;1;121;14;0;107;0;0;0
321180664;1000;59;59;148;181;816;3;181;22;0;159;0;0;0
321180665;1000;90;90;99;145;853;2;145;15;0;130;0;0;0
321180666;1000;68;68;180;198;801;1;198;7;0;191;0;0;0
321180667;1500;183;183;298;433;1447;1;52;0;0;52;381;0;381
321180668;1000;65;65;99;122;877;1;122;22;1;99;0;0;0
321180669;1000;146;146;133;197;900;1;99;5;0;94;98;0;98
321180670;1000;141;141;154;201;948;1;51;8;0;43;150;0;150
321180671;1000;143;143;346;432;608;1;391;23;1;367;41;0;41
321180672;1000;63;63;174;208;890;1;109;11;0;98;99;0;99
321180673;1000;48;48;254;283;716;1;283;11;0;272;0;0;0
321180674;1000;96;96;26;94;904;2;94;3;0;91;0;0;0
321180675;1000;188;188;200;256;762;1;237;24;0;213;19;0;19
321180676;1000;181;181;215;271;730;5;265;15;1;249;6;0;6
321180677;1000;65;65;138;192;805;3;192;11;0;181;0;0;0
321180678;1500;198;198;238;273;1446;1;53;3;0;50;220;0;220
321180679;1500;0;0;236;236;1263;1;236;27;0;209;0;0;0
321180680;1500;43;43;158;180;1317;3;180;15;1;164;0;0;0
321180681;300;75;75;20;80;219;1;80;5;0;75;0;0;0
321180682;1500;385;385;204;407;1114;1;385;16;0;369;22;0;22
321180683;1500;90;90;90;118;1381;1;118;21;0;97;0;0;0
321180684;1500;164;164;157;248;1222;30;248;30;0;218;0;0;0
321180685;1500;55;55;109;136;1362;2;136;14;1;121;0;0;0
321180686;200;65;65;21;54;145;1;54;2;0;52;0;0;0
321180687;1500;157;157;493;521;1000;1;499;20;0;479;22;0;22
321180688;1500;157;157;403;428;1086;2;412;14;2;396;16;0;16
321180689;700;128;128;191;264;673;2;25;1;0;24;239;0;239
321180690;700;95;95;162;196;503;13;196;12;0;184;0;0;0
321180691;700;255;255;159;334;365;1;334;14;0;320;0;0;0
321180692;300;44;44;24;55;244;1;55;0;0;55;0;0;0
321180693;400;72;72;16;88;309;3;88;5;0;83;0;0;0
321180694;1500;420;420;124;285;1490;1;9;1;0;8;276;0;276
321180695;1000;266;266;257;443;998;1;1;0;0;1;442;1;441
321180696;1000;157;157;135;234;999;1;0;0;0;0;234;2;232
321180697;1000;108;108;136;211;787;2;211;5;1;205;0;0;0
321180698;1000;63;63;33;73;926;1;73;7;0;66;0;0;0
321180699;1000;183;183;68;187;812;1;187;13;1;173;0;0;0
321180700;1000;115;115;479;543;999;1;0;0;0;0;543;1;542
321180701;0;117;117;90;155;999;1;0;0;0;0;155;0;155
321180702;900;277;277;223;415;899;1;0;0;0;0;415;0;415
321180703;1000;55;55;82;110;888;2;110;6;0;104;0;0;0
321180704;1500;360;360;145;106;1476;5;23;4;0;19;228;0;228
321180705;1500;359;359;208;312;1390;1;109;8;0;101;203;0;203
321180706;1500;113;113;148;202;1292;6;202;14;0;188;0;0;0
321180707;1500;637;637;137;276;1314;7;179;15;0;164;97;0;97
321180708;1500;119;119;203;245;1262;1;237;21;0;216;8;0;8
321180709;1500;9;9;84;90;1409;1;90;9;4;77;0;0;0
321180710;1500;179;179;591;626;1305;1;194;5;0;189;432;3;429
321180711;1500;130;130;217;248;1499;1;0;0;0;0;248;0;248
321180712;1500;346;346;324;486;1227;1;272;38;0;234;214;1;213
321180713;400;53;53;12;51;348;1;51;4;1;46;0;0;0
321180714;1000;57;57;128;168;831;1;168;4;1;163;0;0;0
321180715;1000;49;49;81;108;891;1;108;9;0;99;0;0;0
321180716;1500;101;101;262;305;1499;1;0;0;0;0;305;0;305
321180717;1500;267;267;319;379;1499;1;0;0;0;0;378;0;378
321180718;1500;275;275;296;353;1499;1;0;0;0;0;353;0;353
321180719;1500;260;260;248;296;1499;1;0;0;0;0;296;0;296
321180720;1500;254;254;246;307;1447;1;52;9;0;43;255;0;255
321180721;1500;430;430;373;505;1037;6;457;59;1;397;48;0;48
321180722;1500;327;327;455;528;1316;4;180;31;0;149;348;0;348
321180723;1500;323;323;175;264;1499;1;0;0;0;0;264;0;264
321180724;1500;308;308;169;267;1267;1;232;21;1;210;35;1;34
321180725;1500;358;358;144;239;1364;2;134;12;0;122;105;1;104
321180726;1000;248;248;157;340;999;1;0;0;0;0;340;1;339
321180727;1000;263;263;128;304;0;0;0;0;0;0;304;0;304
321180728;1000;93;93;29;89;910;1;89;0;0;89;0;0;0
321180729;1000;171;171;169;308;999;1;0;0;0;0;308;0;308
321210730;700;23;23;221;238;460;2;238;3;7;228;0;0;0
321240731;200;7;7;32;38;161;1;38;1;2;35;0;0;0
321240732;400;45;45;174;216;181;3;216;3;3;210;0;0;0
321240733;200;8;8;67;75;124;1;75;1;6;68;0;0;0
321250734;900;101;101;339;418;766;4;130;1;3;126;288;6;282
321250735;900;11;11;443;445;744;5;151;1;1;149;294;5;289
321250736;900;10;10;243;251;793;2;105;9;3;93;147;2;145
321250737;700;29;29;136;156;541;3;156;5;6;145;0;0;0
321250738;500;16;16;68;83;416;1;83;1;2;80;0;0;0
321250739;500;11;11;56;67;432;1;67;0;2;65;0;0;0
321250740;800;41;41;220;257;690;2;108;0;1;107;143;0;143
321250741;700;20;20;164;182;517;0;182;3;8;171;0;0;0
321250742;500;5;5;68;73;426;1;73;1;0;72;0;0;0
321250743;800;39;39;272;311;657;1;142;9;5;128;169;3;166
321250744;500;5;5;64;69;430;1;69;0;2;67;0;0;0
321250745;600;17;17;126;143;456;1;143;2;8;133;0;0;0
321250746;500;27;27;214;238;260;2;238;3;2;233;0;0;0
321250747;700;22;22;65;84;615;1;84;3;0;81;0;0;0
321250748;700;18;18;138;150;549;1;150;2;5;143;0;0;0
321270749;1000;31;31;66;96;903;1;96;1;4;91;0;0;0
321290750;100;10;10;10;19;80;1;19;0;2;17;0;0;0
321300751;800;110;110;212;305;777;1;22;0;0;22;283;6;277
321300752;800;17;17;292;309;480;11;309;9;8;292;0;0;0
321300753;800;59;59;192;202;596;2;202;6;6;190;0;0;0
321320754;400;18;18;220;230;169;1;230;3;2;225;0;0;0
321320755;400;14;14;202;211;187;2;211;3;5;203;0;0;0
321320756;700;55;55;263;307;519;1;180;3;4;173;127;2;125
321320757;400;2;2;45;47;352;1;47;0;5;42;0;0;0
321320758;300;12;12;113;123;176;1;123;2;3;118;0;0;0
321320759;300;4;4;38;40;257;3;40;0;1;39;0;0;0
321320760;300;10;10;75;85;212;3;85;2;1;82;0;0;0
321320761;300;8;8;60;67;232;1;67;0;3;64;0;0;0
321320762;300;30;30;131;157;141;2;157;3;7;147;0;0;0
321320763;600;81;81;331;397;576;3;22;1;0;21;375;6;369
321320764;600;3;3;197;199;400;1;199;3;2;194;0;0;0
321330765;900;46;46;244;288;791;1;108;2;0;106;180;1;179
321330766;500;31;31;121;146;349;5;146;1;1;144;0;0;0
321330767;500;16;16;118;133;365;2;133;0;0;133;0;0;0
321360768;200;20;20;46;64;135;1;64;0;2;62;0;0;0
321360769;100;21;21;14;24;74;2;24;0;4;20;0;0;0
