section_id;distributed_ballots;pre_registered_voters;registered_voters;onsite_listed_voters;voted_voters;unused_paper_ballots;destroyed_paper_ballots;urn_paper_ballots;invalid_paper_ballots;support_noone_paper_ballots;valid_paper_votes_for_parties;urn_machine_ballots;support_noone_machine_ballots;valid_machine_votes_for_parties
010100001;600;625;625;4;310;445;1;154;6;6;142;156;10;146
010100002;500;545;544;1;283;365;1;134;2;7;125;149;8;141
010100003;500;515;513;0;218;364;1;135;2;7;126;83;1;82
010100004;500;586;587;1;286;358;1;141;3;4;134;145;10;135
010100005;500;478;478;2;254;364;1;135;4;6;125;119;3;116
010100006;500;472;472;2;238;338;1;161;6;4;151;77;7;70
010100007;500;562;562;1;269;339;1;160;5;5;150;109;6;103
010100008;500;493;494;2;255;375;1;124;3;9;112;131;5;126
010100009;500;627;627;0;269;369;1;130;2;4;124;139;7;132
010100010;600;701;703;4;282;459;1;140;4;7;129;142;6;136
010100011;600;690;693;4;272;370;2;228;14;2;212;44;2;42
010100012;600;642;642;1;317;434;1;165;3;3;159;152;8;144
010100013;800;882;884;5;372;640;1;159;8;4;147;213;13;200
010100014;500;643;643;4;304;357;1;142;5;1;136;162;8;154
010100015;500;614;614;3;281;306;1;193;8;6;179;88;5;83
010100016;500;442;442;3;207;333;1;166;2;5;159;41;3;38
010100017;600;593;593;4;268;435;3;162;5;2;155;106;1;105
010100018;100;24;24;5;20;79;1;20;2;0;18;0;0;0
010100019;100;29;29;5;20;79;1;20;0;0;20;0;0;0
010100020;100;71;71;4;51;48;1;51;2;2;47;0;0;0
010100021;200;129;129;4;69;130;1;69;3;0;66;0;0;0
010100022;200;187;187;4;106;93;1;106;3;4;99;0;0;0
010100023;500;530;530;2;260;263;14;223;13;1;209;37;3;34
010200001;500;587;587;0;269;290;1;209;7;2;200;60;5;55
010200002;500;831;831;1;447;68;1;431;29;5;397;16;0;16
010200003;600;708;711;3;382;303;1;296;5;4;287;86;2;84
010200004;500;553;555;0;310;204;1;295;7;3;285;15;0;15
010200005;600;621;627;5;452;155;1;444;17;18;409;8;0;8
010200006;700;715;747;7;491;285;1;414;32;1;381;77;1;76
010200007;700;701;723;6;449;383;1;316;10;4;302;133;3;130
010200008;600;646;646;6;417;272;1;327;16;1;310;90;3;87
010200009;900;884;963;4;661;237;2;661;13;7;641;0;0;0
010200010;200;159;159;5;142;57;1;142;5;0;137;0;0;0
010200011;600;599;599;7;485;349;1;250;5;0;245;235;0;235
010200012;50;30;30;5;22;27;1;22;0;0;22;0;0;0
010200013;200;187;187;6;160;39;1;160;6;0;154;0;0;0
010200014;200;174;174;3;155;44;1;155;2;0;153;0;0;0
010200015;200;199;199;4;199;0;1;199;2;0;197;0;0;0
010200016;150;117;117;5;96;53;1;96;1;0;95;0;0;0
010200017;50;65;65;4;35;14;1;35;1;0;34;0;0;0
010200018;100;87;87;0;83;16;1;83;1;0;82;0;0;0
010200019;150;132;132;0;129;21;0;129;2;0;127;0;0;0
010300001;500;566;568;8;216;399;1;100;1;3;96;116;6;110
010300002;300;343;344;12;145;218;1;81;1;2;78;64;4;60
010300003;400;487;487;5;197;309;1;90;3;1;86;107;7;100
010300004;500;550;550;6;184;417;1;82;3;1;78;102;3;99
010300005;600;633;634;9;245;484;1;115;1;2;112;130;6;124
010300006;500;602;603;8;186;395;1;104;8;1;95;82;1;81
010300007;600;642;643;10;187;429;1;170;18;0;152;17;1;16
010300008;600;668;668;8;216;461;1;138;10;3;125;78;4;74
010300009;600;678;679;4;214;427;2;171;12;1;158;43;5;38
010300010;600;674;674;6;237;436;2;162;8;1;153;75;2;73
010300011;500;595;596;5;218;349;1;150;4;6;140;68;8;60
010300012;500;585;585;7;233;383;1;116;2;4;110;117;7;110
010300013;500;562;562;7;206;383;1;116;1;3;112;90;4;86
010300014;500;547;547;6;237;386;1;113;3;2;108;124;3;121
010300015;400;475;476;6;202;286;3;111;4;0;107;91;4;87
010300016;500;583;584;6;293;367;1;132;3;3;126;161;6;155
010300017;500;504;504;9;184;413;1;86;2;4;80;98;11;87
010300018;500;596;597;7;235;382;3;115;2;5;108;120;10;110
010300019;500;525;526;7;143;432;1;67;3;0;64;76;5;71
010300020;500;540;541;5;220;394;1;105;5;1;99;115;2;113
010300021;400;388;388;5;156;342;1;57;0;2;55;99;6;93
010300022;500;534;534;7;197;397;1;102;2;3;97;95;7;88
010300023;600;626;626;5;246;484;1;115;1;1;113;131;5;126
010300024;500;522;523;9;212;380;1;119;3;5;111;93;4;89
010300025;500;589;590;7;212;400;1;99;0;0;99;113;4;109
010300026;600;722;722;6;268;491;1;108;2;3;103;160;4;156
010300027;600;642;642;11;245;504;1;95;2;4;89;150;3;147
010300028;500;617;618;8;261;390;1;109;1;4;104;152;6;146
010300029;500;622;622;8;281;361;1;138;1;5;132;143;12;131
010300030;600;699;699;4;259;477;1;122;5;2;115;137;6;131
010300031;600;677;677;6;260;485;1;114;0;1;113;146;10;136
010300032;300;310;311;8;122;241;1;58;2;2;54;64;2;62
010300033;800;880;881;13;395;578;1;221;2;5;214;174;13;161
010300034;600;630;633;4;285;470;1;129;4;3;122;156;5;151
010300035;500;568;569;12;204;396;1;103;1;1;101;101;4;97
010300036;600;721;722;7;322;452;4;144;2;5;137;178;5;173
010300037;600;635;636;9;267;489;1;110;3;0;107;157;7;150
010300038;400;476;476;3;195;306;1;93;0;1;92;102;6;96
010300039;500;591;591;7;278;386;1;113;2;4;107;165;3;162
010300040;600;715;717;9;301;470;1;129;5;2;122;172;7;165
010300041;500;533;537;8;203;409;1;90;4;3;83;113;5;108
010300042;500;616;616;9;253;372;1;127;2;6;119;125;2;123
010300043;600;723;725;6;276;448;5;147;2;3;142;129;6;123
010300044;400;460;462;15;179;305;1;94;2;6;86;85;5;80
010300045;400;404;407;6;162;330;1;69;1;2;66;93;8;85
010300046;500;613;615;9;263;373;1;126;2;5;119;137;7;130
010300047;600;646;648;18;263;461;1;138;5;5;128;125;10;115
010300048;600;630;631;7;257;492;1;107;2;4;101;150;6;144
010300049;500;605;606;6;227;412;1;87;4;3;80;140;7;133
010300050;400;429;429;6;183;272;1;127;1;2;124;56;2;54
010300051;600;630;630;7;261;489;2;109;1;5;103;152;7;145
010300052;400;412;412;8;172;318;4;78;2;3;73;94;4;90
010300053;500;569;569;8;212;364;3;133;1;4;128;79;2;77
010300054;500;585;587;4;200;403;1;96;0;2;94;104;7;97
010300055;500;525;525;5;171;415;1;84;3;2;79;87;4;83
010300056;500;581;582;6;206;399;2;99;3;2;94;107;11;96
010300057;500;613;615;3;246;372;2;126;4;3;119;120;9;111
010300058;500;605;608;6;229;389;1;110;0;2;108;119;13;106
010300059;500;618;618;8;239;360;1;139;4;5;130;100;6;94
010300060;500;554;560;6;188;381;1;118;6;1;111;70;2;68
010300061;500;521;522;6;232;391;1;108;1;3;104;124;5;119
010300062;400;440;440;5;154;307;1;92;2;0;90;62;0;62
010300063;400;468;469;5;145;311;1;88;1;1;86;57;5;52
010300064;500;589;589;7;212;380;1;119;5;1;113;93;4;89
010300065;477;477;477;2;155;385;1;91;5;8;78;64;5;59
010300066;500;544;544;5;200;394;1;105;1;4;100;95;6;89
010300067;500;565;565;8;195;386;1;113;0;5;108;82;4;78
010300068;500;532;532;6;199;382;1;117;5;1;111;82;7;75
010300069;500;573;573;2;173;394;1;105;1;5;99;68;5;63
010300070;500;604;604;3;206;377;1;122;1;3;118;84;6;78
010300071;500;586;588;7;241;348;2;150;2;4;144;91;2;89
010300072;520;520;520;7;201;420;1;99;1;4;94;102;2;100
010300073;500;558;561;6;224;365;3;132;5;2;125;92;3;89
010300074;500;532;532;4;172;415;3;82;1;2;79;90;6;84
010300075;500;574;574;4;236;407;1;92;1;2;89;144;4;140
010300076;400;413;413;8;179;305;2;93;7;2;84;86;3;83
010300077;500;613;614;0;245;354;1;145;3;5;137;100;4;96
010300078;500;543;543;7;226;369;1;130;3;7;120;96;5;91
010300079;500;521;523;6;211;348;1;151;2;2;147;60;2;58
010300080;400;483;483;4;199;279;2;119;1;4;114;80;3;77
010300081;400;441;441;5;155;311;1;88;3;2;83;67;6;61
010300082;500;603;603;5;203;382;2;116;5;2;109;87;4;83
010300083;500;590;590;7;189;376;1;123;3;1;119;66;2;64
010300084;500;601;601;5;259;349;1;150;2;8;140;109;5;104
010300085;500;507;507;6;200;389;1;110;2;0;108;90;2;88
010300086;500;540;540;9;210;406;1;93;0;7;86;117;6;111
010300087;400;500;500;10;161;313;2;85;0;3;82;76;2;74
010300088;500;578;579;8;194;415;1;84;0;3;81;110;3;107
010300089;500;566;567;8;198;391;1;108;2;3;103;90;3;87
010300090;500;529;529;7;177;404;1;95;1;3;91;82;1;81
010300091;400;451;451;5;181;306;1;93;2;4;87;88;0;88
010300092;500;606;607;11;232;390;1;109;2;4;103;123;7;116
010300093;600;645;649;8;247;496;1;103;5;0;98;144;6;138
010300094;500;513;514;8;174;423;1;76;3;5;68;98;3;95
010300095;700;753;754;8;313;549;1;150;3;2;145;163;9;153
010300096;800;930;930;7;416;621;1;178;2;4;172;238;8;230
010300097;400;400;400;6;149;344;1;55;3;1;51;94;4;90
010300098;500;623;624;9;267;373;2;125;1;1;123;142;7;135
010300099;500;575;575;8;252;284;2;214;23;3;188;38;1;37
010300100;600;657;657;9;239;436;1;163;8;1;154;76;6;70
010300101;500;521;521;5;219;386;1;113;1;5;107;106;5;101
010300102;500;541;541;9;188;411;2;87;1;2;84;101;3;98
010300103;300;352;354;5;93;258;1;41;2;1;38;52;4;48
010300104;600;702;703;6;335;429;2;169;3;10;156;166;4;162
010300105;400;496;496;7;204;290;1;109;1;2;106;95;1;94
010300106;300;374;374;5;138;240;1;59;0;3;56;79;6;73
010300107;400;426;426;4;160;342;1;57;2;0;55;103;5;98
010300108;500;584;586;8;252;370;2;128;13;2;113;124;9;115
010300109;400;482;483;5;165;301;1;98;0;2;96;67;5;62
010300110;400;443;444;5;172;311;1;88;2;2;84;84;7;77
010300111;500;572;572;6;219;365;1;134;3;8;123;85;3;82
010300112;600;630;632;4;248;488;1;111;2;2;107;137;10;127
010300113;500;564;564;3;205;337;3;160;6;5;149;45;1;44
010300114;500;502;502;5;172;399;1;100;1;4;95;72;2;70
010300115;500;600;601;6;259;379;1;120;1;1;118;139;6;133
010300116;500;563;563;9;38;463;1;36;0;0;36;2;0;2
010300117;500;513;513;8;37;462;1;37;1;0;36;0;0;0
010300118;100;80;80;8;16;83;1;16;1;0;15;0;0;0
010300119;600;662;663;7;247;477;1;122;2;1;119;125;5;120
010300120;500;608;608;7;329;214;1;285;7;3;275;44;1;43
010300121;2300;2828;2828;8;353;1948;3;349;2;10;337;4;1;3
010300122;100;28;28;3;21;78;1;21;0;1;20;0;0;0
010300123;400;443;444;8;146;274;1;125;5;1;119;21;1;20
010300124;500;555;554;10;48;460;1;39;1;0;38;9;0;9
010300125;600;710;710;7;23;576;1;23;1;2;20;0;0;0
010300126;100;48;48;8;10;89;1;10;0;0;10;0;0;0
010300127;1100;1373;1373;9;66;1042;2;56;1;1;54;10;0;10
010300128;800;918;918;9;34;771;1;28;0;0;28;6;0;6
010300129;9300;11923;11923;5;242;9128;1;171;3;2;166;71;4;67
010300130;900;1051;1051;4;335;703;1;196;2;8;186;139;4;135
010300131;500;617;617;6;84;433;1;66;3;1;62;18;0;18
010300132;200;203;203;5;87;112;1;87;2;2;83;0;0;0
010300133;700;757;757;8;96;628;1;71;1;1;69;25;0;25
010300134;400;380;380;8;36;364;1;35;1;0;34;1;0;1
010300135;300;305;305;4;111;187;2;111;0;2;109;0;0;0
010300136;200;153;153;7;57;142;1;57;2;1;54;0;0;0
010300137;4000;6085;6085;6;97;3902;1;97;0;2;95;0;0;0
010300138;100;63;63;6;33;66;1;33;0;0;33;0;0;0
010300139;400;473;474;6;107;347;3;50;3;1;46;57;1;56
010300140;100;10;10;7;16;82;2;16;2;1;13;0;0;0
010300146;100;16;16;5;21;78;1;21;1;0;20;0;0;0
010300147;100;54;54;8;40;59;1;40;4;1;35;0;0;0
011100001;800;942;942;0;420;577;2;221;1;14;206;199;13;186
011100002;800;843;846;0;304;603;1;196;6;10;180;108;4;104
011100003;800;908;928;4;383;557;7;236;5;9;222;147;3;144
011100004;700;700;712;0;334;483;3;214;2;7;205;120;12;108
011100005;600;643;651;1;265;451;1;148;4;7;137;117;7;110
011100006;700;705;740;5;361;523;1;176;7;1;168;185;6;179
011100007;600;542;542;4;235;463;2;135;3;1;131;100;3;97
011100008;800;827;829;5;402;570;1;229;6;8;215;173;2;171
011100009;700;712;721;6;319;513;1;186;1;3;182;133;3;130
011100010;600;578;578;4;250;434;1;165;3;2;160;85;4;81
011100011;600;605;622;5;258;453;2;145;2;5;138;113;3;110
011100012;800;768;779;3;363;586;1;213;8;4;201;150;3;147
011100013;700;702;704;3;305;517;1;182;2;2;178;123;6;117
011100014;800;845;844;3;314;607;8;185;7;4;174;129;5;124
011100015;800;824;838;4;254;648;2;150;0;3;147;104;7;97
011100016;800;799;812;0;302;646;1;153;3;4;146;149;8;141
011100017;900;970;971;0;294;726;1;173;8;1;164;121;4;117
011100018;900;999;1000;0;248;720;2;178;5;3;170;70;5;65
011100019;900;1116;1136;3;219;694;1;205;14;2;189;14;0;14
011100020;700;693;696;5;264;547;1;152;5;3;144;112;8;104
011100021;800;801;847;4;365;587;2;211;3;6;202;154;17;137
011100022;800;839;842;5;374;577;1;222;5;9;208;152;6;146
011100024;700;652;655;0;261;513;3;184;3;11;170;77;4;73
011100025;600;614;606;2;226;445;3;152;5;7;140;74;5;69
011100026;500;474;474;1;198;361;1;138;5;4;129;60;3;57
011100027;500;466;470;4;193;352;2;146;4;6;136;47;10;37
011100028;500;438;441;3;179;353;1;146;2;4;140;33;2;31
011100029;500;467;470;2;211;337;1;162;6;5;151;49;4;45
011100030;500;392;393;0;179;339;1;160;3;3;154;19;1;18
011100031;800;869;869;7;550;256;4;540;8;9;523;10;0;10
011100032;700;718;728;3;435;264;2;434;8;4;422;1;0;1
011100033;700;697;697;7;446;259;1;440;20;6;414;6;0;6
011100034;800;841;841;4;483;317;1;482;11;7;464;1;0;1
011100035;800;803;811;7;466;333;1;466;7;4;455;0;0;0
011100036;500;540;545;7;195;354;1;145;6;1;138;50;0;50
011100037;600;624;626;6;225;408;1;191;3;1;187;34;0;34
011100038;700;735;735;7;239;484;1;215;4;1;210;24;2;22
011100039;800;834;834;6;429;413;1;386;4;0;382;43;1;42
011100040;800;713;746;6;324;479;1;320;10;1;309;4;0;4
011100041;50;20;20;8;16;33;1;16;0;0;16;0;0;0
011100042;50;26;27;7;18;32;0;18;0;0;18;0;0;0
011100043;200;92;92;0;89;111;0;89;0;0;89;0;0;0
011100044;100;55;55;0;54;46;0;54;1;0;53;0;0;0
011300001;800;823;824;3;567;265;4;531;0;0;531;36;2;34
011300002;700;708;711;0;347;481;1;218;5;7;206;129;9;120
011300003;200;153;153;0;69;130;1;69;3;0;66;0;0;0
011300004;900;860;860;3;410;528;1;371;11;16;344;39;1;38
011300005;800;772;772;2;538;339;1;460;9;10;441;78;6;72
011300006;700;656;656;0;447;285;1;414;14;6;394;33;1;32
011300007;600;630;630;4;415;221;1;378;7;6;365;37;0;37
011300008;1000;1036;1036;1038;589;452;1;547;9;13;525;42;2;40
011300009;900;954;978;1;438;502;2;404;9;2;393;34;1;33
011300010;800;841;858;1;410;429;1;370;13;3;354;40;2;38
011300011;100;48;48;0;29;70;1;29;0;1;28;0;0;0
011300012;200;206;206;3;102;97;1;102;0;0;102;0;0;0
011300013;200;136;136;2;85;114;1;85;0;3;82;0;0;0
011300014;600;647;650;1;341;353;1;246;11;6;229;95;1;94
011300015;700;739;739;4;426;414;1;285;24;6;255;141;3;138
011300016;200;157;157;3;97;102;1;97;1;1;95;0;0;0
011300017;400;299;443;3;302;97;1;302;3;1;298;0;0;0
011300018;900;909;915;4;645;264;12;624;9;17;598;21;0;21
011300019;700;731;734;6;507;221;1;478;1;8;469;29;2;27
011300020;700;714;715;1;508;224;1;475;18;14;443;33;3;30
011300021;200;226;226;1;173;26;1;173;0;1;172;0;0;0
011300022;1000;1073;1073;3;453;546;1;453;16;0;437;0;0;0
011300023;100;22;22;1;22;75;3;22;0;0;22;0;0;0
011300024;100;48;48;0;48;52;0;48;1;0;47;0;0;0
012800001;600;561;561;3;257;421;1;178;5;2;171;79;0;79
012800002;600;593;593;1;240;431;1;168;3;2;163;72;2;70
012800003;600;517;526;1;279;449;1;150;6;7;137;129;7;122
012800004;600;573;577;1;310;371;2;227;6;6;215;83;1;82
012800005;600;592;592;2;266;436;1;163;7;2;154;103;5;98
012800006;400;379;379;4;171;261;2;137;1;3;133;34;2;32
012800007;400;481;488;7;260;211;1;188;3;1;184;72;0;72
012800008;400;460;470;2;244;190;3;207;4;0;203;37;2;35
012800009;100;50;50;4;28;71;1;28;0;0;28;0;0;0
012800010;100;68;68;6;60;38;2;60;1;1;58;0;0;0
012800011;100;42;42;0;41;58;1;41;4;0;37;0;0;0
013300001;900;868;868;7;266;753;1;146;3;2;141;120;4;116
013300002;900;847;848;3;262;769;1;130;2;0;128;132;6;126
013300003;900;923;923;4;268;748;2;150;6;1;143;118;3;115
013300004;900;918;918;4;263;756;1;143;0;3;140;120;6;114
013300005;900;967;967;6;272;761;1;138;5;0;133;134;10;124
013300006;800;870;871;5;286;645;1;154;8;6;140;132;6;126
013300007;900;894;892;6;279;720;1;179;11;1;167;100;2;98
013300008;900;922;923;6;312;718;7;175;0;2;173;137;4;133
013300009;900;928;928;0;306;726;3;171;7;7;157;135;2;133
013300010;900;979;979;6;306;710;1;189;5;5;179;117;2;115
013300011;900;977;977;5;247;786;1;113;3;2;108;134;6;128
013300012;900;1002;1005;5;222;786;1;113;5;4;104;109;6;103
013300013;800;863;864;5;279;615;2;183;18;1;164;96;4;92
013300014;900;877;877;3;300;698;1;201;1;2;198;99;7;92
013300015;900;925;926;4;174;800;3;97;9;2;86;77;5;72
013300016;900;916;915;0;289;734;1;165;7;1;157;124;7;117
013300017;900;898;899;7;259;759;0;141;7;3;131;118;2;116
013300018;900;972;972;3;300;732;1;167;11;2;154;133;1;132
013300019;900;947;947;3;225;727;1;172;3;3;166;53;0;53
013300020;900;1054;1054;7;354;545;1;354;3;13;338;0;0;0
013300021;900;970;971;5;259;752;1;147;2;2;143;112;9;103
013300022;900;987;987;7;293;719;2;179;8;5;166;114;3;111
013300023;800;793;793;7;316;625;1;174;3;4;167;142;4;138
013300024;800;810;810;8;258;664;1;135;1;1;133;123;5;118
013300025;900;923;923;6;278;766;1;133;4;0;129;145;6;139
013300026;900;973;973;8;323;719;1;180;4;4;172;143;4;139
013300027;900;993;993;1;218;791;1;108;5;4;99;110;5;105
013300028;900;938;938;2;310;733;1;166;7;1;158;144;3;141
013300029;800;789;790;0;227;689;1;110;5;1;104;117;5;112
013300030;900;907;908;4;282;627;1;272;0;20;252;10;0;10
013300031;700;782;784;4;307;393;1;306;28;0;278;1;1;0
013300032;900;916;919;6;335;572;1;327;42;1;284;8;0;8
013300033;900;931;932;4;265;692;1;207;12;1;194;58;1;57
013300034;900;889;891;5;293;751;1;148;4;6;138;145;5;140
013300035;900;919;919;5;243;777;1;122;9;2;111;121;5;116
013300036;800;804;804;5;237;667;2;131;3;5;123;106;4;102
013300037;400;438;438;6;250;236;2;162;8;4;150;88;6;82
013300038;500;564;577;8;331;245;4;251;0;0;251;80;2;78
013300039;300;329;329;7;115;209;1;90;4;3;83;25;1;24
013300040;200;231;231;1;116;83;1;116;5;0;111;0;0;0
013300041;500;502;502;1;231;342;1;157;1;5;151;74;3;71
013300042;500;546;546;1;246;336;2;162;4;1;157;84;2;82
013300043;100;100;100;4;76;23;1;76;2;1;73;0;0;0
013300044;200;149;143;5;84;115;1;84;4;2;78;0;0;0
013300045;100;108;108;6;56;42;2;56;1;2;53;0;0;0
013300046;500;553;553;4;251;296;0;204;7;5;192;47;0;47
013300047;600;632;632;7;291;395;1;204;5;4;195;87;7;80
013300048;100;87;87;4;47;52;1;47;0;0;47;0;0;0
013300049;300;259;259;6;95;203;2;95;2;1;92;0;0;0
013300050;200;173;175;4;110;89;1;110;2;1;107;0;0;0
013300051;800;806;806;5;307;568;3;229;8;0;221;78;0;78
013300052;600;590;590;3;236;432;1;167;2;0;165;69;3;66
013300053;400;421;425;5;169;270;1;129;3;3;123;40;1;39
013300054;400;386;390;5;189;250;1;149;2;4;143;40;2;38
013300055;500;447;447;5;162;354;1;145;2;2;141;17;0;9
013300056;800;867;867;4;339;512;1;287;5;1;281;52;4;48
013300057;100;110;110;4;42;57;1;42;0;0;42;0;0;0
013300058;600;616;616;5;225;481;1;118;2;2;114;107;2;105
013300059;600;583;583;6;202;472;0;128;3;2;123;74;0;74
013300060;600;573;574;4;224;458;1;141;3;2;136;83;2;81
013300061;600;578;578;5;206;463;1;136;5;2;129;70;0;70
013300062;600;577;577;7;206;486;1;113;3;2;108;93;5;88
013300063;700;725;725;8;423;305;1;394;16;0;378;29;0;29
013300064;600;555;555;4;274;369;1;230;7;1;222;44;1;43
013300065;300;328;328;4;105;209;1;90;3;1;86;15;0;14
013300066;100;102;104;6;52;47;1;52;1;0;51;0;0;0
013300067;100;79;79;6;46;52;2;46;1;0;45;0;0;0
013300068;100;61;61;9;28;71;1;28;5;0;23;0;0;0
013300069;200;141;141;4;74;123;3;74;3;1;70;0;0;0
013300070;200;181;181;5;95;104;1;95;2;0;93;0;0;0
013300071;200;117;117;4;46;153;1;46;0;1;45;0;0;0
013300072;300;328;328;3;171;153;1;146;6;0;140;25;0;25
013300073;100;76;76;7;35;65;0;35;0;1;34;0;0;0
013300074;100;73;73;7;41;58;1;41;0;0;41;0;0;0
013300075;100;37;37;7;20;79;1;20;0;1;19;0;0;0
013300076;200;170;170;7;84;115;1;84;2;0;82;0;0;0
013300077;500;507;509;5;206;370;1;129;2;0;127;77;3;74
013300078;500;470;474;4;216;356;1;143;2;0;141;73;0;73
013300079;600;592;592;2;226;425;0;175;7;3;165;51;2;49
013300080;600;564;565;1;250;364;1;235;4;12;219;15;3;12
013300081;600;543;543;1;187;467;0;133;2;6;125;54;3;51
013300082;700;744;744;8;324;481;1;218;2;1;215;106;4;102
013300083;300;241;241;4;106;193;1;106;0;2;104;0;0;0
013300084;900;855;854;5;374;573;1;326;13;2;311;48;1;47
013300085;900;832;834;2;295;679;1;220;6;2;212;75;1;74
013300086;800;752;752;4;187;679;0;121;5;2;114;66;1;65
013300087;500;468;467;3;129;416;0;84;8;2;74;45;1;44
013300088;800;793;793;7;209;622;2;176;6;5;165;33;0;33
013300089;100;22;22;0;18;82;0;18;0;0;18;0;0;0
013300090;100;21;21;0;20;80;0;20;0;0;20;0;0;0
013300091;100;22;22;9;20;80;0;20;1;0;19;0;0;0
013700001;600;644;644;0;356;365;1;234;7;6;221;122;4;118
013700002;600;598;601;1;316;416;1;183;1;8;174;133;7;126
013700003;700;704;705;3;393;454;1;245;4;6;235;148;6;142
013700004;600;681;683;0;401;199;3;398;10;14;374;3;0;3
013700005;600;621;622;0;301;452;1;147;10;4;133;154;7;147
013700006;600;656;657;0;397;326;1;273;10;13;250;124;12;112
013700007;500;541;542;0;327;303;1;196;5;6;185;131;9;122
013700008;700;703;704;4;433;418;1;281;4;0;277;152;4;148
013700009;600;673;676;3;372;406;1;193;3;2;188;179;8;171
013700010;700;748;747;1;376;454;1;245;9;10;226;131;3;128
013700011;500;547;548;1;318;312;2;186;5;5;176;132;2;130
013700012;600;659;659;2;377;369;3;228;7;10;211;149;6;143
013700013;500;529;532;3;270;243;1;256;10;6;240;14;1;13
013700014;600;596;597;1;341;387;1;212;5;1;206;129;1;128
013700015;700;777;777;4;492;206;3;491;45;0;446;1;0;1
013700016;700;709;709;3;432;284;1;415;19;2;394;17;0;17
013700017;600;658;658;3;346;349;1;250;3;3;244;96;0;96
013700018;600;657;657;1;295;399;1;200;4;5;191;95;6;89
013700019;400;407;407;5;222;209;1;190;3;2;185;32;1;31
013700020;800;806;806;1;408;511;1;288;0;4;284;120;4;116
013700021;700;747;747;0;400;416;1;283;9;2;272;117;4;113
013700022;800;672;792;1;673;165;1;634;7;1;626;39;1;38
013700023;500;508;508;3;335;233;2;265;19;1;245;70;0;70
013700024;700;741;741;4;384;321;2;377;3;3;371;7;0;7
013700025;400;480;480;2;280;170;1;229;13;5;211;51;2;49
013700026;500;573;575;0;331;206;1;293;8;4;281;38;5;33
013700027;500;503;504;3;255;305;1;194;5;4;185;61;3;58
013700028;100;42;42;0;41;58;1;41;1;0;40;0;0;0
013700029;100;12;12;10;15;85;0;15;0;0;15;0;0;0
014000001;500;776;776;5;304;328;1;171;2;3;166;133;5;128
014000002;500;733;733;5;276;324;1;175;2;4;169;101;2;99
014000003;500;803;805;4;294;340;1;159;1;4;154;135;2;133
014000004;500;872;872;7;297;346;1;153;3;2;148;144;7;137
014000005;500;784;784;10;287;368;1;131;2;4;125;156;10;146
014000006;500;848;849;6;280;320;7;173;6;6;161;107;5;102
014000007;500;843;844;8;327;350;1;149;4;5;140;178;11;167
014000008;500;687;687;4;248;373;1;126;5;3;118;122;7;115
014000009;500;434;435;5;173;413;1;86;3;3;80;87;6;81
014000010;500;488;488;4;168;388;1;111;3;1;107;57;1;56
014000011;500;788;788;3;293;336;2;162;6;5;151;131;4;127
014000012;500;730;730;8;271;352;1;147;6;6;135;124;4;120
014000013;500;834;834;7;293;366;1;133;2;2;129;160;9;151
014000014;500;826;826;0;301;198;1;301;3;9;289;0;0;0
014000015;500;688;688;4;261;299;1;200;0;4;196;61;1;60
014000016;500;794;794;4;312;337;2;161;5;3;153;151;8;143
014000017;500;753;753;9;288;310;1;189;5;0;184;99;2;97
014000018;500;895;896;5;373;286;3;211;7;7;197;162;3;159
014000019;500;821;821;5;317;328;4;168;1;5;162;149;6;143
014000020;500;785;785;4;314;342;1;157;6;7;144;157;8;149
014000021;500;707;708;6;319;346;1;153;4;2;147;166;11;155
014000022;500;507;507;8;195;426;3;71;2;4;65;124;2;122
014000023;500;727;728;9;245;362;2;136;2;2;132;109;5;104
014000024;500;589;589;7;192;379;1;120;2;4;114;72;3;69
014000025;500;889;889;8;298;349;2;149;3;3;143;149;8;141
014000026;500;848;848;4;252;333;1;166;7;2;157;86;5;81
014000027;500;911;911;4;402;259;2;239;4;4;231;163;3;160
014000028;500;938;938;5;251;362;1;137;10;8;119;114;5;109
014000029;500;949;949;8;266;294;1;205;12;2;191;61;3;58
014000030;500;987;988;3;282;285;1;214;22;1;191;68;0;68
014000031;500;939;941;6;203;335;1;164;6;2;156;39;1;38
014000032;500;495;495;3;280;233;1;266;0;4;262;14;1;13
014000033;300;319;319;4;174;145;1;154;7;0;147;20;0;20
014000034;400;482;482;7;182;231;1;168;5;0;163;14;0;14
014000035;300;313;313;3;146;186;1;113;0;1;112;33;5;28
014000036;200;241;241;5;124;73;3;124;3;2;119;0;0;0
014000037;100;44;44;7;20;79;1;20;0;1;19;0;0;0
014000038;500;588;589;7;237;365;1;134;4;3;127;103;4;99
014000039;400;454;454;4;183;291;2;107;0;1;106;76;0;76
014000040;500;571;572;3;179;339;2;159;14;1;144;20;2;18
014000041;500;626;627;4;231;330;1;169;3;2;164;62;0;62
014000042;400;453;453;3;130;289;1;110;4;2;104;20;0;20
014000043;500;564;564;4;204;337;1;162;4;2;156;42;2;40
014000044;500;507;507;3;187;358;2;140;2;3;135;47;4;43
014000045;300;393;393;5;133;199;1;100;2;2;96;33;0;33
014000046;500;638;638;6;126;398;1;101;10;0;91;25;1;24
014000047;400;468;469;5;150;301;1;98;1;1;96;52;0;52
014000048;200;148;148;7;52;147;1;52;0;2;50;0;0;0
014000049;100;26;26;9;19;80;1;19;2;1;16;0;0;0
014000050;100;74;74;6;30;69;1;30;0;1;29;0;0;0
014000051;100;59;59;6;26;73;1;26;1;1;24;0;0;0
014000052;100;48;48;6;20;79;1;20;1;0;19;0;0;0
014000053;100;69;69;7;28;70;2;28;0;0;28;0;0;0
014000054;100;42;42;8;19;80;1;19;0;1;18;0;0;0
014000055;100;148;149;5;45;51;4;45;3;3;39;0;0;0
014000056;400;533;533;3;214;273;1;126;5;6;115;88;5;83
014000057;200;167;167;6;85;114;1;85;1;2;82;0;0;0
014000058;100;67;67;8;48;51;1;48;2;0;46;0;0;0
014000059;500;556;556;3;188;337;1;162;4;5;153;26;0;26
014000060;500;469;469;3;168;365;1;134;3;3;128;34;0;34
014000061;100;95;95;7;42;57;1;42;0;1;41;0;0;0
014000062;300;371;372;5;152;182;2;116;4;1;111;36;0;36
014000063;100;138;138;7;60;39;1;60;0;1;59;0;0;0
014000064;100;60;60;6;29;70;1;29;0;1;28;0;0;0
014000065;100;123;123;3;57;41;2;57;6;0;51;0;0;0
014000066;100;30;30;8;19;79;2;19;2;0;17;0;0;0
014000067;100;76;76;6;49;50;1;49;0;2;47;0;0;0
014000068;100;36;37;7;25;74;1;25;0;0;25;0;0;0
014000069;100;34;34;32;63;33;4;63;0;5;58;0;0;0
014200001;300;386;386;3;305;122;1;177;0;1;176;128;4;124
014200002;500;518;529;1;224;277;1;222;9;2;211;2;0;2
014200003;400;488;515;5;219;201;1;198;3;7;188;21;2;19
014200004;600;723;723;0;323;340;1;259;7;1;251;64;0;64
014200005;700;731;767;0;342;400;2;298;1;0;297;44;1;43
014200006;700;721;738;3;361;390;2;308;5;2;301;53;1;52
014200007;600;699;742;3;307;319;1;280;10;1;269;27;0;27
014200008;300;303;306;3;148;172;1;127;0;2;125;21;0;21
014200009;300;292;296;0;155;144;1;155;3;9;143;0;0;0
014200010;800;880;911;0;353;510;1;289;0;4;285;64;0;64
014200011;800;807;849;0;341;560;1;239;8;4;227;102;1;101
014200012;900;1028;1028;1;438;572;2;326;0;6;320;112;3;109
014200013;300;325;325;1;236;100;0;200;0;0;200;36;0;36
014200014;400;476;496;0;249;160;1;239;0;0;239;10;0;10
014200015;800;824;838;3;423;394;1;405;10;6;389;18;2;16
014200016;700;737;746;4;394;363;2;335;2;4;329;59;3;56
014200017;1000;979;994;1;467;601;3;396;5;8;383;71;5;66
014200018;900;926;943;0;423;569;1;330;8;5;317;93;4;89
014200019;900;853;908;3;307;678;1;221;1;3;217;86;1;85
014200020;900;897;947;5;347;645;1;254;7;5;242;93;2;91
014200021;700;693;720;2;419;309;1;390;0;4;386;29;2;27
014200022;400;392;392;8;270;144;1;255;2;1;252;15;0;15
014200023;100;86;86;2;88;12;0;88;0;0;88;0;0;0
014200024;200;149;149;0;146;54;0;146;2;1;143;0;0;0
014200025;100;67;67;0;67;33;0;67;0;2;65;0;0;0
014200026;200;173;173;0;172;27;1;172;0;0;172;0;0;0
014400001;600;636;652;1;387;284;1;315;3;4;308;72;1;71
014400002;600;715;722;0;463;246;2;352;13;8;331;111;3;108
014400003;500;556;561;2;395;197;1;302;6;4;292;93;6;87
014400004;700;885;892;1;515;233;1;466;24;3;439;49;6;43
014400005;700;759;759;3;489;279;1;420;16;8;396;69;2;67
014400006;500;595;617;3;387;182;1;317;6;2;309;70;5;65
014400007;600;640;640;3;350;369;1;230;7;4;219;120;7;113
014400008;500;579;601;1;362;233;2;265;8;5;252;97;3;94
014400009;500;565;567;2;390;152;2;346;3;7;336;44;8;36
014400010;300;299;305;4;158;140;2;158;4;3;151;0;0;0
014400011;300;328;336;2;239;81;1;218;8;4;206;21;0;21
014400012;800;838;838;0;560;284;2;514;8;8;498;46;1;45
014400013;400;416;416;0;282;117;1;282;7;3;272;0;0;0
014400014;100;123;125;6;79;20;1;79;2;2;75;0;0;0
014400015;200;240;249;4;147;52;1;147;2;4;141;0;0;0
014400016;100;29;29;5;26;72;2;26;1;1;24;0;0;0
014400017;600;659;677;6;441;236;2;362;3;10;349;79;0;79
014400018;600;665;665;1;391;235;9;356;8;4;344;35;1;34
014400019;500;504;509;1;348;213;1;286;14;4;268;62;4;58
014400020;100;24;24;6;19;80;1;19;0;0;19;0;0;0
014400021;500;605;607;0;377;201;2;297;4;6;287;80;8;72
014400022;500;532;541;0;345;193;3;304;2;0;302;41;2;39
014400023;100;75;75;5;66;33;1;66;0;0;66;0;0;0
014400024;100;26;26;6;14;85;1;14;0;0;14;0;0;0
014400025;400;493;493;3;348;172;1;227;5;1;221;121;1;120
014400026;400;384;386;5;212;240;2;158;5;3;150;54;3;51
014400027;100;47;47;0;47;52;1;47;1;0;46;0;0;0
014400028;100;40;40;3;42;58;0;42;0;0;42;0;0;0
014400029;100;36;36;0;35;64;1;35;1;0;34;0;0;0
014400030;100;40;40;4;44;55;1;44;6;1;37;0;0;0
014900001;300;343;343;4;177;161;1;138;5;1;132;39;0;39
014900002;300;357;358;1;172;173;1;126;6;2;118;46;0;46
014900003;300;368;368;0;197;141;1;158;4;3;151;39;1;38
014900004;300;321;321;2;184;134;1;165;3;1;161;19;1;18
014900005;500;555;555;5;364;144;1;355;20;0;335;9;1;8
014900006;500;544;544;1;353;155;1;344;12;3;329;9;0;9
014900007;300;297;297;5;141;158;1;141;1;0;140;0;0;0
014900008;300;321;321;1;136;191;4;105;4;0;101;31;0;31
014900009;100;29;29;7;26;73;1;26;1;0;25;0;0;0
014900010;200;46;136;5;51;148;1;51;0;2;49;0;0;0
014900011;200;137;137;6;77;122;1;77;0;2;75;0;0;0
014900012;100;60;60;6;35;64;1;35;0;0;35;0;0;0
014900013;200;236;236;8;97;102;1;97;6;0;91;0;0;0
014900014;100;53;53;7;22;77;1;22;1;3;18;0;0;0
014900015;100;103;103;8;59;40;1;59;3;1;55;0;0;0
014900016;100;114;114;7;34;65;1;34;1;0;33;0;0;0
014900017;100;100;100;7;38;61;1;38;2;0;36;0;0;0
015200001;500;729;729;2;297;317;1;182;3;6;173;115;4;111
015200002;500;714;714;9;316;307;1;192;1;2;189;124;6;118
015200003;500;808;808;2;356;262;1;237;9;8;220;119;4;115
015200004;500;674;674;3;193;326;1;173;6;1;166;20;0;20
015200005;200;139;139;2;80;117;3;80;3;5;72;0;0;0
015200006;300;388;388;1;164;185;1;114;3;3;108;50;5;45
015200007;500;609;609;2;174;359;1;140;7;3;130;34;1;33
015200008;300;318;318;5;126;264;1;35;1;1;33;91;4;87
015200009;100;38;38;6;28;71;1;28;0;0;28;0;0;0
015200010;100;46;46;5;25;74;1;25;2;1;22;0;0;0
015200011;500;627;627;2;234;335;1;164;3;8;153;70;3;67
015200012;500;449;449;1;159;381;2;117;3;2;112;42;1;41
015200013;500;876;876;4;441;136;3;361;2;4;355;80;5;75
015200014;500;735;735;2;334;212;1;287;0;10;277;47;1;46
015200015;500;705;705;4;356;204;2;294;3;6;285;62;0;62
015200016;100;60;60;3;29;70;1;29;0;0;29;0;0;0
015200017;100;23;23;4;12;87;1;12;0;0;12;0;0;0
015200018;100;109;109;6;52;47;1;52;8;0;44;0;0;0
015200019;200;327;327;0;123;111;4;85;0;0;85;38;1;37
015300001;600;702;702;1;415;203;1;396;16;2;378;19;0;19
015300002;400;470;470;2;277;133;1;266;12;2;252;11;1;10
015300003;600;603;604;4;321;337;1;262;7;5;250;59;3;56
015300004;800;810;811;0;717;117;1;682;0;0;682;35;1;34
015300005;600;637;635;3;441;229;0;371;5;11;355;70;5;65
015300006;600;673;674;1;439;200;1;399;12;9;378;40;3;37
015300007;600;677;677;1;390;239;1;360;14;3;343;30;3;27
015300008;500;561;561;5;348;162;3;335;9;2;324;13;0;13
015300009;400;445;445;5;256;157;1;242;3;1;238;14;2;12
015300010;400;428;428;7;287;112;1;287;6;2;279;0;0;0
015300011;700;795;795;6;698;29;2;669;10;2;657;29;0;29
015300012;400;366;366;6;271;127;2;271;11;3;257;0;0;0
015300013;300;346;346;3;254;47;0;253;8;0;245;1;0;1
015300014;900;964;964;7;718;183;1;716;12;5;699;2;0;2
015300015;200;141;141;0;138;62;0;138;0;0;138;0;0;0
015300016;100;87;87;0;87;11;2;87;2;0;85;0;0;0
020100001;500;790;792;0;298;315;1;184;1;0;183;114;9;105
020100002;400;613;614;2;159;286;1;113;4;4;105;46;0;46
020100003;500;884;884;0;259;337;1;162;7;2;153;97;3;94
020100004;200;374;375;4;156;97;4;99;3;1;95;57;3;54
020100005;300;444;445;2;177;208;1;91;0;2;89;86;5;81
020100006;300;638;635;0;225;173;3;124;3;2;119;101;2;99
020100007;300;403;405;1;163;213;2;85;2;4;79;78;4;74
020100008;300;499;497;0;186;198;2;100;1;2;97;86;2;84
020100009;500;797;797;1;296;351;1;148;2;1;145;148;4;144
020100010;300;495;495;0;185;185;1;114;2;2;110;71;3;68
020100011;300;411;412;1;166;222;1;77;2;0;75;89;3;86
020100012;400;592;592;3;208;282;1;117;3;0;114;91;6;85
020100013;300;628;632;7;233;66;1;233;3;4;226;0;0;0
020100014;300;481;481;1;168;222;1;77;3;3;71;91;2;89
020100015;300;388;388;3;140;231;1;68;2;0;66;72;1;71
020100016;500;702;702;7;206;370;1;129;1;4;124;77;3;74
020100017;400;647;648;10;184;260;1;139;3;3;133;45;2;43
020100018;500;707;709;7;238;374;1;125;0;4;121;113;2;111
020100019;400;502;502;0;147;310;2;88;2;0;86;59;2;57
020100020;500;801;801;3;157;376;1;123;13;1;109;34;1;33
020100021;500;800;801;1;137;362;1;137;15;0;122;0;0;0
020100022;400;581;582;5;130;312;2;86;3;0;83;44;1;43
020100023;400;604;602;1;234;284;1;115;3;4;108;119;7;112
020100024;500;731;733;0;255;374;1;125;5;1;119;130;4;126
020100025;500;711;710;5;152;356;1;143;22;0;121;9;0;9
020100026;400;668;669;0;52;347;1;52;12;0;40;0;0;0
020100027;300;576;576;5;208;149;1;150;3;1;146;58;2;56
020100028;500;709;710;1;199;382;1;117;0;5;112;82;2;80
020100029;500;858;858;3;123;374;3;123;33;2;88;0;0;0
020100030;500;803;806;8;106;394;1;105;19;0;86;1;0;1
020100031;200;130;130;6;84;114;2;84;3;2;79;0;0;0
020100032;200;245;245;5;129;70;1;129;2;1;126;0;0;0
020100033;300;513;513;8;221;78;1;221;3;1;217;0;0;0
020100034;400;737;739;6;215;185;3;212;21;2;189;3;0;3
020100035;300;328;328;6;172;126;2;172;1;2;169;0;0;0
020100036;500;623;623;7;240;257;3;240;17;0;223;0;0;0
020100037;200;175;175;6;90;109;1;90;6;0;84;0;0;0
020100038;500;774;774;5;371;140;2;358;18;6;334;13;0;13
020100039;300;404;404;5;212;87;1;212;4;5;203;0;0;0
020100040;400;517;518;5;273;183;3;214;10;0;204;59;2;57
020100041;500;742;742;4;254;292;2;206;3;2;201;48;1;47
020100042;300;394;394;6;215;88;1;211;10;3;198;4;0;4
020100043;400;551;551;6;224;175;1;224;16;1;207;0;0;0
020100044;400;524;524;4;262;160;3;237;6;2;229;25;0;25
020100045;200;118;118;5;66;133;1;66;0;3;63;0;0;0
020100046;300;389;389;7;200;143;1;156;5;1;150;44;4;40
020100047;100;11;11;6;13;86;1;13;2;0;11;0;0;0
020100048;400;644;645;8;257;181;5;214;10;2;202;43;1;42
020100049;400;584;584;4;261;137;2;261;9;2;250;0;0;0
020100050;300;430;431;3;184;152;5;143;5;0;138;41;1;40
020100051;100;14;14;0;9;90;1;9;0;0;9;0;0;0
020400001;600;586;586;8;234;532;1;67;1;0;66;167;5;162
020400002;600;569;570;7;238;507;1;92;1;2;89;146;6;140
020400003;600;582;582;16;285;485;2;113;0;3;110;172;7;165
020400004;500;487;487;11;177;411;2;87;0;3;84;90;1;89
020400005;600;585;585;9;243;509;1;90;0;2;88;153;5;148
020400006;600;571;571;5;250;512;1;87;3;2;82;163;3;160
020400007;600;572;573;8;222;489;1;110;1;5;104;112;5;107
020400008;600;534;534;9;208;530;1;69;0;1;68;139;9;130
020400009;600;620;619;7;269;477;1;122;0;3;119;147;8;139
020400010;600;618;618;9;238;499;1;100;1;1;98;138;2;136
020400011;600;637;638;7;265;509;1;90;1;4;85;175;12;163
020400012;500;568;568;4;247;399;2;99;0;4;95;148;0;148
020400013;600;592;592;5;218;516;1;83;0;1;82;135;6;129
020400014;500;568;567;6;204;430;1;69;0;0;69;135;5;130
020400015;600;658;658;7;259;509;1;90;0;7;83;169;5;164
020400016;600;586;587;5;234;509;1;90;1;1;88;144;8;136
020400017;500;568;567;10;232;420;1;79;0;1;78;153;8;145
020400018;500;547;547;5;210;423;1;76;0;1;75;134;4;130
020400019;600;599;600;8;234;512;1;87;2;2;83;147;5;142
020400020;400;437;438;6;176;328;1;71;1;1;69;105;3;102
020400021;600;607;606;9;272;490;2;108;1;1;106;164;8;156
020400022;500;498;497;7;237;396;1;103;4;2;97;134;7;127
020400023;500;463;463;8;213;412;3;85;2;3;80;128;7;121
020400024;500;516;517;6;227;394;1;105;1;2;102;122;5;117
020400025;400;428;428;5;209;300;2;98;0;1;97;111;1;110
020400026;500;506;507;6;206;422;2;76;1;1;74;130;3;127
020400027;400;391;393;5;161;337;1;62;1;0;61;99;2;97
020400028;500;524;525;8;227;401;3;96;1;4;91;131;4;127
020400029;500;550;552;6;247;410;1;89;2;1;86;158;8;150
020400030;500;539;539;8;227;403;1;96;0;2;94;131;5;126
020400031;600;592;592;8;255;499;2;99;1;3;95;156;6;150
020400032;600;600;601;5;245;511;1;88;0;2;86;157;5;152
020400033;400;369;370;9;147;345;1;54;0;3;51;93;7;86
020400034;500;495;497;6;198;403;2;95;1;1;93;103;2;101
020400035;400;436;436;3;169;335;1;64;1;2;61;105;7;98
020400036;400;461;464;17;208;326;1;73;1;1;71;135;5;130
020400037;500;558;549;9;239;423;1;76;0;2;74;163;10;153
020400038;500;551;551;8;236;416;1;83;3;3;77;153;6;147
020400039;500;513;514;8;227;401;1;98;1;1;96;129;6;123
020400040;400;370;368;7;151;339;1;60;1;1;58;91;4;87
020400041;400;460;462;5;210;324;2;74;0;1;73;136;16;120
020400042;500;556;556;10;220;404;3;93;0;2;91;127;11;116
020400043;500;501;500;7;204;421;3;76;0;7;69;128;3;125
020400044;500;511;512;5;209;418;1;81;2;3;76;128;2;126
020400045;500;455;456;5;192;423;2;75;1;5;69;117;4;113
020400046;500;524;524;7;243;408;1;91;0;2;89;152;6;146
020400047;500;552;552;5;203;379;2;119;6;2;111;84;2;82
020400048;600;603;603;5;256;462;1;137;0;2;135;119;3;116
020400049;500;557;557;7;234;297;2;201;1;6;194;33;1;32
020400050;600;590;591;7;278;326;1;273;3;5;265;5;0;5
020400051;600;618;618;8;251;495;2;103;4;3;96;148;5;143
020400052;600;583;583;7;237;516;1;83;1;3;79;154;12;142
020400053;600;628;628;4;268;480;1;119;0;6;113;149;8;141
020400054;500;559;560;4;254;393;1;106;0;8;98;148;5;143
020400055;500;669;668;7;275;414;1;85;0;2;83;190;9;181
020400056;600;603;603;6;252;507;1;92;0;4;88;160;4;156
020400057;600;579;579;9;236;509;1;90;0;4;86;146;10;136
020400058;500;562;562;4;237;405;1;94;4;2;88;143;12;131
020400059;500;551;551;13;227;412;1;87;2;4;81;140;7;133
020400060;600;573;573;5;242;506;1;93;2;1;90;149;8;141
020400061;600;639;642;9;305;477;1;122;1;5;116;183;7;176
020400062;600;627;627;9;249;507;1;92;2;5;85;157;13;144
020400063;600;585;585;7;203;531;1;68;1;2;65;135;7;128
020400064;500;489;490;6;203;417;2;81;0;3;78;122;8;114
020400065;500;538;539;8;212;401;1;98;2;0;96;114;6;108
020400066;600;601;601;7;246;491;1;108;0;2;106;138;4;134
020400067;500;477;477;8;182;418;1;81;0;5;76;101;3;98
020400068;400;379;380;4;165;337;1;62;2;1;59;103;2;101
020400069;400;439;439;5;170;340;1;59;0;5;54;111;4;107
020400070;500;477;477;6;189;446;2;52;0;1;51;137;4;133
020400071;500;543;544;2;207;432;1;67;0;2;65;140;10;130
020400072;400;379;379;6;155;321;2;77;1;4;72;78;1;77
020400073;400;372;372;4;187;288;4;108;4;0;104;79;2;77
020400074;400;369;369;6;118;310;1;89;10;2;77;29;1;28
020400075;300;333;334;8;122;234;1;65;4;3;58;57;4;53
020400076;700;703;705;12;138;584;1;115;9;2;104;23;1;22
020400077;600;636;637;5;109;505;1;94;11;1;82;15;0;15
020400078;600;664;666;7;133;465;3;132;24;0;108;1;0;1
020400079;600;626;626;12;119;501;1;98;10;0;88;21;1;20
020400080;600;635;636;8;103;507;1;92;7;0;85;11;0;11
020400081;600;594;594;6;103;524;1;75;6;0;69;28;0;28
020400082;600;592;592;6;130;499;2;99;11;0;88;31;2;29
020400083;600;634;634;8;88;529;1;70;3;0;67;18;3;15
020400084;600;627;627;7;209;492;1;107;1;1;105;102;6;96
020400085;500;499;499;7;175;441;1;58;4;1;53;117;10;107
020400086;400;468;468;7;151;328;2;70;0;0;70;81;3;78
020400087;200;154;154;6;62;137;1;62;1;4;57;0;0;0
020400088;500;562;562;5;177;333;1;166;0;10;156;11;2;9
020400089;500;559;561;4;135;408;1;91;4;1;86;44;2;42
020400090;600;623;625;7;108;507;2;91;7;3;81;17;1;16
020400091;500;508;509;8;161;424;1;75;2;5;68;86;4;82
020400092;500;522;522;8;210;390;1;109;2;5;102;101;8;93
020400093;600;602;602;3;167;507;1;92;3;2;87;75;3;72
020400094;500;553;553;7;158;404;1;95;1;3;91;63;0;63
020400095;600;575;575;0;179;505;1;94;5;4;85;85;4;81
020400096;500;532;532;7;144;426;3;71;0;5;66;73;0;73
020400097;600;600;591;5;223;480;1;119;0;7;112;104;7;97
020400098;700;709;709;5;250;567;1;132;3;6;123;118;6;112
020400099;500;502;502;2;169;432;1;67;2;5;60;102;2;100
020400100;500;539;537;2;187;418;1;81;7;5;69;106;6;100
020400101;600;590;590;6;191;513;1;86;3;4;79;105;6;99
020400102;600;587;588;5;181;505;3;92;0;3;89;89;4;85
020400103;500;499;497;12;181;414;2;84;0;3;81;97;5;92
020400104;500;469;469;11;139;436;1;63;1;0;62;76;4;72
020400105;500;470;470;7;146;430;1;69;4;3;62;77;0;77
020400106;600;581;586;7;176;526;1;73;3;1;69;103;6;97
020400107;500;558;558;5;161;426;1;73;0;2;71;88;6;82
020400108;600;621;623;6;180;516;1;83;1;4;78;97;3;94
020400109;600;578;577;6;196;508;1;91;2;7;82;105;3;102
020400110;500;482;482;4;190;411;1;88;0;1;87;102;9;93
020400111;500;497;498;5;175;432;1;67;1;1;65;108;5;103
020400112;500;537;537;9;190;415;2;83;0;0;83;107;5;102
020400113;500;494;495;5;169;425;1;74;0;1;73;95;1;94
020400114;500;471;473;3;164;416;1;83;0;2;81;81;2;79
020400115;600;607;607;7;211;530;1;69;2;3;64;142;6;136
020400116;500;547;548;7;163;434;1;65;1;3;61;98;6;92
020400117;500;493;492;0;173;403;2;95;2;5;88;78;9;69
020400118;500;512;512;5;183;401;2;97;2;1;94;86;4;82
020400119;600;571;572;6;197;509;1;90;0;5;85;107;7;100
020400120;500;542;543;6;188;413;1;86;2;0;84;102;4;98
020400121;500;463;463;3;175;426;1;73;1;4;68;102;4;98
020400122;500;568;569;12;202;402;1;97;3;2;92;105;6;99
020400123;600;602;602;6;206;516;1;83;0;5;78;123;8;115
020400124;500;517;517;6;180;406;1;93;2;4;87;87;3;84
020400125;500;514;514;7;215;414;1;85;0;0;85;130;6;124
020400126;500;548;550;8;191;410;1;89;2;1;86;102;6;96
020400127;500;559;559;6;218;399;1;100;5;3;92;118;7;111
020400128;500;494;494;7;163;433;3;64;2;3;59;99;5;94
020400129;600;581;583;4;177;510;2;88;4;5;79;89;4;85
020400130;500;558;558;3;213;395;1;104;1;5;98;109;4;105
020400131;600;604;604;3;207;505;2;93;1;4;88;114;4;110
020400132;600;602;603;5;190;510;1;89;3;0;86;101;6;95
020400133;600;664;665;4;242;356;2;242;0;7;235;0;0;0
020400134;600;606;606;4;194;511;1;88;0;2;86;106;6;100
020400135;600;632;632;10;249;495;1;104;4;2;98;145;8;137
020400136;600;627;628;6;192;507;1;92;5;2;85;100;6;94
020400137;500;558;559;6;167;418;1;81;2;2;77;86;1;85
020400138;600;591;592;5;169;502;1;97;6;3;88;72;4;68
020400139;700;674;674;7;160;616;2;82;1;1;80;78;2;76
020400140;700;673;673;2;197;609;1;90;3;6;81;107;7;100
020400141;600;640;640;5;219;490;1;109;1;1;107;110;3;107
020400142;600;602;602;5;172;519;1;80;0;1;79;92;2;90
020400143;600;607;607;3;156;518;1;81;3;0;78;75;3;72
020400144;600;194;611;0;194;520;1;79;1;0;78;115;6;109
020400145;600;619;620;2;183;508;1;91;0;2;89;92;7;85
020400146;800;775;776;3;227;700;1;99;2;1;96;128;6;122
020400147;600;632;633;7;179;517;1;82;1;2;79;97;5;92
020400148;600;629;631;8;109;503;4;93;18;2;73;16;1;15
020400149;600;653;654;7;148;468;2;130;13;1;116;18;0;18
020400150;600;601;602;8;154;513;1;86;8;1;77;68;3;65
020400151;600;566;566;9;231;507;1;92;5;1;86;139;4;135
020400152;600;567;568;8;206;499;1;100;3;1;96;106;3;103
020400153;500;515;515;6;181;416;1;83;0;4;79;98;2;96
020400154;500;514;517;6;182;390;3;107;3;2;102;75;3;72
020400155;700;687;689;6;254;591;2;107;1;0;106;147;9;138
020400156;500;566;566;7;209;403;1;96;1;4;91;113;5;108
020400157;500;554;556;8;207;402;1;97;0;6;91;110;4;106
020400158;600;616;616;5;239;503;4;93;3;2;88;146;4;142
020400159;500;533;535;7;212;418;1;81;3;1;77;131;0;131
020400160;600;652;652;9;234;493;2;105;1;4;100;129;3;126
020400161;600;583;584;7;203;523;1;76;0;1;75;127;2;125
020400162;600;563;563;6;219;481;2;117;0;2;115;102;1;101
020400163;500;558;558;7;228;394;2;104;1;2;101;124;8;116
020400164;500;490;491;7;220;414;1;85;2;2;81;135;3;132
020400165;500;521;522;7;223;390;1;109;2;5;102;114;6;108
020400166;600;585;585;23;254;487;1;112;4;5;103;142;13;129
020400167;600;585;585;10;244;489;3;108;1;6;101;136;6;130
020400168;500;497;498;15;191;426;2;72;0;2;70;119;7;112
020400169;500;483;482;7;177;436;2;62;0;4;58;115;3;112
020400170;500;493;493;7;199;402;1;97;0;3;94;102;6;96
020400171;500;526;527;6;181;427;2;71;2;1;68;110;5;105
020400172;500;535;535;8;204;426;1;73;0;1;72;131;9;122
020400173;600;581;581;5;221;502;1;97;0;3;94;124;5;119
020400174;500;471;471;6;170;413;1;86;2;5;79;84;3;81
020400175;500;459;460;6;167;427;1;72;1;5;66;95;5;90
020400176;500;550;550;6;211;410;1;89;1;3;85;122;3;119
020400177;600;608;608;4;226;495;1;104;2;4;98;122;6;116
020400178;600;590;591;2;176;524;2;74;4;0;70;102;9;93
020400179;600;583;584;9;196;511;1;88;3;0;85;108;3;105
020400180;600;574;574;6;199;512;1;87;1;1;85;112;3;109
020400181;600;570;570;5;188;521;1;78;5;2;71;110;2;108
020400182;500;489;489;6;193;424;1;75;2;1;72;118;5;113
020400183;500;477;478;15;164;379;1;120;5;1;114;44;1;43
020400184;500;507;508;6;176;419;1;80;2;2;76;96;5;91
020400185;500;531;532;8;167;424;1;75;1;1;73;92;7;85
020400186;600;631;630;17;246;503;2;95;2;0;93;151;4;147
020400187;600;580;580;8;225;495;2;103;2;5;96;122;3;119
020400188;600;523;521;5;177;515;1;84;1;2;81;93;7;86
020400189;600;586;590;8;183;517;1;82;2;3;77;101;5;96
020400190;601;224;595;7;225;507;1;93;1;1;91;132;4;128
020400191;500;552;552;6;182;392;1;107;3;1;103;75;6;69
020400192;600;578;578;5;223;508;1;91;1;3;87;132;4;128
020400193;500;532;532;7;196;417;1;82;3;3;76;114;4;110
020400194;500;523;523;5;200;410;2;88;2;4;82;112;3;109
020400195;600;576;576;6;236;505;2;93;1;4;88;143;8;135
020400196;500;528;528;5;196;414;1;85;3;2;80;111;5;106
020400197;500;471;471;3;179;396;1;103;2;3;98;76;4;72
020400198;500;545;545;3;207;407;1;92;0;8;84;115;3;112
020400199;600;600;600;7;216;491;1;108;0;3;105;108;3;105
020400200;600;575;575;5;212;487;1;112;1;4;107;100;7;93
020400201;400;454;454;8;187;316;1;83;3;3;77;104;6;98
020400202;600;642;647;8;212;498;1;101;1;2;98;111;5;106
020400203;700;691;697;6;253;573;1;126;1;5;120;127;9;118
020400204;600;624;630;6;234;482;1;117;3;6;108;117;4;113
020400205;200;230;230;8;137;62;1;137;0;3;134;0;0;0
020400206;600;565;566;9;225;493;1;106;2;3;101;119;3;116
020400207;500;521;523;7;177;417;2;81;0;1;80;96;1;95
020400208;500;529;531;7;192;398;2;100;1;1;98;92;6;86
020400209;500;453;455;6;175;407;1;92;3;5;84;83;3;80
020400210;500;530;531;5;212;413;1;86;0;0;86;126;6;120
020400211;600;598;600;6;242;522;1;77;1;3;73;165;8;157
020400212;500;521;521;8;180;415;1;84;1;1;82;96;6;90
020400213;600;605;606;7;268;502;1;97;0;3;94;171;8;163
020400214;500;535;534;8;200;416;2;82;3;4;75;118;4;114
020400215;500;499;500;5;179;419;1;80;1;2;77;99;4;95
020400216;500;218;545;7;225;401;1;98;3;2;93;127;6;121
020400217;500;532;533;8;203;411;2;87;3;2;82;116;5;111
020400218;500;536;536;7;209;394;1;105;4;2;99;104;8;96
020400219;500;542;542;9;217;413;1;86;1;3;82;131;11;120
020400220;600;632;632;9;196;479;1;120;5;5;110;76;4;72
020400221;500;501;502;9;189;415;2;83;3;1;79;106;2;104
020400222;600;591;591;4;215;492;2;106;1;3;102;109;6;103
020400223;500;528;530;8;229;401;4;95;1;9;85;134;12;122
020400224;600;625;625;10;239;491;1;108;2;4;102;131;5;126
020400225;600;593;594;7;253;484;1;115;3;2;110;138;8;130
020400226;500;534;534;8;195;405;2;93;2;4;87;102;2;100
020400227;600;611;611;6;266;480;1;119;5;3;111;147;7;140
020400228;600;605;605;4;284;495;1;104;0;3;101;180;5;175
020400229;700;753;753;6;337;558;1;141;1;3;137;196;9;187
020400230;600;587;589;6;264;469;2;129;0;1;128;135;7;128
020400231;600;598;598;7;223;516;1;83;1;2;80;140;8;132
020400232;600;578;579;10;253;478;2;120;3;8;109;133;6;127
020400233;600;634;634;7;267;525;1;74;0;0;74;193;10;183
020400234;600;575;576;10;208;518;1;81;0;4;77;127;5;122
020400235;500;551;551;9;210;402;1;97;2;7;88;113;6;107
020400236;600;572;572;3;230;507;1;92;0;2;90;138;8;130
020400237;500;476;476;6;191;413;1;86;5;1;80;105;2;103
020400238;600;609;609;8;248;485;2;113;5;3;105;135;5;130
020400239;600;563;563;5;227;510;1;89;1;2;86;138;6;132
020400240;500;505;505;8;162;443;1;56;1;0;55;106;7;99
020400241;500;521;521;9;171;426;1;73;1;0;72;98;3;95
020400242;500;496;497;6;167;426;1;73;2;4;67;94;10;84
020400243;500;536;536;7;196;428;1;71;1;1;69;125;5;120
020400244;500;471;471;5;178;406;1;93;0;3;90;85;5;80
020400245;600;584;585;10;208;511;1;88;2;4;82;120;6;114
020400246;600;604;603;6;237;485;1;114;5;1;108;123;4;119
020400247;600;655;657;8;228;519;1;80;4;3;73;148;6;142
020400248;500;541;542;4;183;436;1;63;2;2;59;120;7;113
020400249;600;591;592;8;210;505;1;94;0;1;93;116;3;113
020400250;500;516;517;7;213;412;1;87;1;1;85;126;4;122
020400251;500;540;540;8;201;347;1;152;3;3;146;49;2;47
020400252;200;184;184;6;71;128;1;71;0;3;68;0;0;0
020400253;800;768;769;5;292;506;3;291;1;11;279;1;0;1
020400254;800;812;813;3;321;647;1;152;1;5;146;169;4;165
020400255;700;720;720;3;270;588;1;111;1;3;107;159;17;142
020400256;900;956;958;7;370;532;1;367;8;17;342;3;0;3
020400257;800;794;795;7;317;697;3;100;2;0;98;217;15;202
020400258;600;606;608;6;190;493;1;106;4;3;99;84;5;79
020400259;500;553;555;6;146;415;1;84;3;1;80;62;3;59
020400260;700;719;719;6;100;598;2;100;7;2;91;0;0;0
020400261;700;674;674;7;104;603;1;96;7;1;88;8;0;8
020400262;500;546;546;6;75;440;1;59;1;0;58;16;0;16
020400263;600;571;571;4;134;496;2;102;3;1;98;32;1;31
020400264;600;608;608;4;118;523;1;76;2;3;71;42;2;40
020400265;500;542;544;2;141;409;1;90;5;0;85;51;5;46
020400266;500;543;543;6;215;388;3;109;4;6;99;106;5;101
020400267;700;673;673;9;302;570;1;129;2;4;123;173;9;164
020400268;500;549;549;7;223;406;2;92;3;5;84;131;5;126
020400269;600;621;622;7;246;459;1;140;0;3;137;106;3;103
020400270;600;617;619;4;304;482;1;117;2;3;112;187;10;177
020400271;600;652;653;9;312;479;1;120;1;2;117;192;5;187
020400272;600;614;614;8;265;474;1;125;4;2;119;140;7;133
020400273;600;597;598;6;227;498;1;101;4;1;96;126;4;122
020400274;600;572;572;6;240;489;1;110;0;5;105;130;6;124
020400275;600;598;598;6;226;495;1;104;2;2;100;122;6;116
020400276;600;643;644;7;259;506;2;92;2;3;87;167;9;158
020400277;500;520;520;7;242;397;1;102;1;8;93;140;7;133
020400278;600;586;586;9;239;471;1;128;2;5;121;111;5;106
020400279;600;611;613;7;229;484;1;115;2;5;108;114;4;110
020400280;500;476;476;7;170;420;1;79;0;1;78;91;4;87
020400281;600;640;640;22;289;471;1;128;4;0;124;161;9;152
020400282;700;679;679;6;277;594;1;105;1;2;102;172;9;163
020400283;700;700;700;6;316;598;1;101;4;6;91;215;8;207
020400284;600;586;586;6;221;523;1;76;0;3;73;145;6;139
020400285;700;664;664;7;246;618;1;81;1;4;76;165;7;158
020400286;600;591;591;7;256;509;1;90;1;3;86;166;8;158
020400287;700;705;705;7;331;579;1;120;5;3;112;211;10;201
020400288;500;534;534;6;238;420;2;78;1;1;76;160;2;158
020400289;600;649;649;9;274;378;3;219;2;2;215;55;1;54
020400290;500;543;543;7;219;402;1;97;1;1;95;122;8;114
020400291;600;560;565;5;208;512;1;87;3;0;84;121;2;119
020400292;500;549;549;6;202;421;1;78;5;1;72;124;4;120
020400293;600;618;618;0;290;504;1;95;5;2;88;195;8;187
020400294;600;276;633;6;276;465;1;134;4;3;127;142;6;136
020400295;600;568;568;6;248;493;0;107;0;6;101;141;6;135
020400296;500;553;554;5;220;406;1;93;1;5;87;127;2;125
020400297;600;654;653;6;270;511;1;88;0;4;84;182;10;172
020400298;500;535;535;7;188;432;1;67;0;2;65;121;2;119
020400299;600;593;593;7;208;507;2;91;7;2;82;117;2;115
020400300;600;596;595;8;216;497;1;102;4;3;95;114;2;112
020400301;500;516;516;6;193;429;1;70;0;0;70;123;2;121
020400302;500;542;544;2;226;411;1;88;0;4;84;138;5;133
020400303;600;590;595;6;259;524;1;75;2;2;71;184;10;174
020400304;600;645;647;8;259;499;1;100;1;3;96;159;5;154
020400305;600;569;569;8;233;508;1;91;2;1;88;142;2;140
020400306;600;586;586;7;276;505;1;94;3;1;90;182;2;180
020400307;500;555;555;7;245;416;1;83;1;3;79;162;8;154
020400308;500;516;516;8;204;299;2;199;1;2;196;5;0;5
020400309;600;653;653;3;184;500;1;99;0;3;96;85;1;84
020400310;600;641;641;4;181;498;1;101;4;0;97;80;8;72
020400311;600;628;628;0;213;506;1;93;8;1;84;120;7;113
020400312;600;594;588;3;163;517;1;82;4;2;76;81;1;80
020400313;600;605;606;0;157;509;1;90;2;4;84;67;1;66
020400314;600;596;597;4;139;516;1;83;0;6;77;56;1;55
020400315;500;557;557;5;147;438;1;61;6;0;55;86;4;82
020400316;200;104;104;5;71;127;2;71;1;2;68;0;0;0
020400317;400;237;237;6;132;267;1;132;2;0;130;0;0;0
020400318;700;743;743;5;226;557;2;141;4;3;134;85;3;82
020400319;800;855;855;5;202;676;2;122;4;6;112;80;4;76
020400320;200;147;147;6;96;102;2;96;2;5;89;0;0;0
020400321;500;417;417;8;216;291;1;208;10;0;198;8;0;8
020400322;500;415;409;3;169;388;1;111;2;3;106;58;5;53
020400323;500;362;362;3;203;377;1;122;2;0;120;81;0;81
020400324;900;926;928;7;326;705;1;194;6;3;185;132;6;126
020400325;100;69;69;5;31;68;1;31;0;1;30;0;0;0
020400326;700;685;685;7;156;608;1;91;13;0;78;65;2;63
020400327;600;560;560;0;114;515;1;84;4;3;77;30;0;30
020400328;500;383;382;6;159;413;1;86;5;2;79;73;1;72
020400329;100;26;5;6;25;74;1;25;1;1;23;0;0;0
020400330;200;98;98;35;94;104;2;94;0;3;91;0;0;0
020400331;200;25;25;7;13;185;2;13;2;0;11;0;0;0
020400332;200;20;20;76;95;104;1;95;0;3;92;0;0;0
020400333;200;18;18;71;72;127;1;72;2;3;67;0;0;0
020400334;200;21;21;41;41;157;2;41;3;2;36;0;0;0
020400335;200;38;38;19;44;155;1;44;1;0;43;0;0;0
020400336;200;140;140;30;158;41;1;158;14;7;137;0;0;0
020400337;200;12;12;41;51;147;2;51;7;0;44;0;0;0
020400340;500;16;16;97;98;400;2;98;1;4;93;0;0;0
020400341;100;27;27;3;30;69;1;30;0;0;30;0;0;0
020400342;100;32;32;6;38;62;0;38;0;0;38;0;0;0
020400343;100;33;33;0;29;71;0;29;1;0;28;0;0;0
020400344;100;25;25;1;26;73;1;26;1;3;22;0;0;0
020600001;300;407;406;6;149;209;1;90;3;3;84;59;1;58
020600002;400;564;564;6;173;278;2;120;5;0;115;53;4;49
020600003;300;415;415;4;130;216;1;83;1;1;81;47;4;43
020600004;300;503;503;6;190;194;1;105;2;6;97;85;4;81
020600005;500;681;681;10;234;352;1;147;5;5;137;87;8;79
020600006;500;844;844;9;337;243;2;255;16;2;237;82;5;77
020600007;500;741;741;9;190;351;1;148;17;1;130;42;1;41
020600008;400;494;494;3;153;303;1;96;1;2;93;57;2;55
020600009;100;19;19;8;23;76;1;23;0;1;22;0;0;0
020600010;100;16;16;7;21;78;1;21;0;1;20;0;0;0
020600011;100;56;56;7;42;57;1;42;0;0;42;0;0;0
020600012;100;32;32;6;26;72;2;26;2;0;24;0;0;0
020600014;100;49;49;8;42;57;1;42;0;0;42;0;0;0
020600015;100;73;73;3;52;47;1;52;2;2;48;0;0;0
020600016;100;17;17;5;16;83;1;16;0;0;16;0;0;0
020600017;500;658;658;4;265;306;5;189;9;1;179;76;3;73
020600018;500;722;722;4;253;297;2;201;34;1;166;52;0;52
020600019;100;21;21;6;25;74;1;25;1;0;24;0;0;0
020600020;100;30;30;7;22;77;1;22;0;0;22;0;0;0
020600021;300;326;326;5;177;121;2;177;6;0;171;0;0;0
020600022;200;214;214;6;118;81;1;118;2;1;115;0;0;0
020600023;200;182;182;4;108;91;1;108;6;0;102;0;0;0
020600024;200;182;182;5;94;104;2;94;5;1;88;0;0;0
020600025;100;33;33;8;31;68;1;31;0;0;31;0;0;0
020600028;100;34;34;7;32;67;1;32;0;0;32;0;0;0
020600029;100;50;50;5;36;63;1;36;4;1;31;0;0;0
020600030;300;287;287;6;175;124;1;175;5;3;167;0;0;0
020600031;100;34;34;7;23;76;1;23;1;1;21;0;0;0
020600032;100;25;25;8;28;71;1;28;0;1;27;0;0;0
020600033;100;33;33;8;22;77;1;22;0;2;20;0;0;0
020600034;200;132;132;6;102;97;1;102;1;0;101;0;0;0
020600035;100;87;87;10;38;60;2;38;2;0;36;0;0;0
020600038;100;52;52;7;33;66;1;33;2;0;31;0;0;0
020600039;300;279;278;4;132;167;1;132;1;3;128;0;0;0
020600040;800;1087;1087;8;530;324;5;471;45;3;423;59;3;56
020600041;400;537;537;8;152;308;1;91;1;2;88;61;2;59
020600042;500;689;689;5;257;336;1;163;0;3;160;94;6;88
020600043;300;214;214;7;84;215;1;84;2;1;81;0;0;0
020800001;500;716;715;2;213;373;1;126;4;2;120;87;4;83
020800002;500;804;802;8;119;380;1;119;9;4;106;0;0;0
020800003;500;910;910;5;100;431;1;68;6;0;62;32;0;32
020800004;500;712;713;6;183;377;2;121;13;1;107;62;3;59
020800005;500;760;760;1;282;336;1;163;10;7;146;119;2;117
020800006;500;537;537;3;165;393;2;105;4;5;96;60;2;58
020800007;500;716;716;6;110;407;1;92;9;1;82;18;1;17
020800008;200;122;122;5;28;171;1;28;0;0;28;0;0;0
020800009;200;176;176;7;90;109;1;90;5;1;84;0;0;0
020800010;500;672;672;7;93;419;2;79;16;0;63;14;1;13
020800011;200;142;143;3;67;132;1;67;2;2;63;0;0;0
020800012;200;273;274;5;142;57;1;142;1;4;137;0;0;0
020800013;300;296;296;1;151;148;1;151;5;4;142;0;0;0
020800014;300;310;310;5;91;235;0;65;1;0;64;26;1;25
020800015;300;373;374;3;71;237;1;62;6;0;56;9;0;9
020800016;300;342;342;6;89;225;1;74;10;0;64;15;4;11
020800017;200;274;274;6;158;41;1;158;7;8;143;0;0;0
020800018;300;425;425;7;93;206;1;93;4;0;89;0;0;0
020800019;500;660;661;0;114;385;1;114;7;4;103;0;0;0
020800020;500;511;512;4;184;326;1;173;1;6;166;11;0;11
020900001;500;551;554;2;210;369;1;130;1;2;127;80;3;77
020900002;500;527;527;0;185;384;2;114;3;1;110;71;7;64
020900003;500;460;460;3;157;413;2;85;2;2;81;72;5;67
020900004;500;580;580;0;226;359;1;140;0;3;137;86;3;83
020900005;500;634;635;0;180;387;1;112;2;3;107;68;7;61
020900006;500;739;739;4;78;434;1;65;6;2;57;13;0;13
020900007;500;654;657;0;235;372;1;127;2;3;122;108;6;102
020900008;500;466;467;0;177;424;1;75;2;2;71;102;5;97
020900009;500;600;600;1;212;337;1;162;3;5;154;50;2;48
020900010;500;424;424;5;158;413;1;86;2;0;84;72;5;67
020900011;500;438;436;1;206;356;2;142;2;6;134;64;1;63
020900012;500;581;583;0;194;378;1;121;5;4;112;73;6;67
020900013;600;737;738;0;248;470;3;127;2;3;122;121;4;117
020900014;500;579;579;2;211;377;2;121;2;3;116;90;7;83
020900015;500;520;520;1;161;420;1;79;5;2;72;82;1;81
020900016;500;384;385;2;135;418;1;81;1;6;74;54;6;48
020900017;500;387;388;0;100;451;1;48;3;0;45;52;4;48
020900018;700;819;820;1;53;661;1;38;0;2;36;15;1;14
020900019;700;775;777;1;100;640;2;58;5;1;52;42;1;41
020900020;700;809;810;2;49;659;1;40;5;0;35;9;0;9
020900021;500;532;532;2;116;421;1;78;7;1;70;38;1;37
020900022;600;647;648;4;104;536;1;63;4;1;58;41;1;40
020900023;200;162;163;1;44;155;1;44;1;4;39;0;0;0
020900024;600;712;713;0;156;487;1;112;2;3;107;44;2;42
020900025;600;785;785;1;54;549;1;50;7;1;42;4;1;3
020900026;500;488;489;0;139;411;1;88;3;4;81;51;0;51
020900027;300;326;326;0;116;252;1;47;4;1;42;69;4;65
020900028;300;329;329;6;84;249;1;50;4;1;45;34;1;33
020900029;300;400;400;6;29;278;1;21;2;0;19;8;0;8
020900030;300;395;396;6;82;222;1;77;5;0;72;5;0;5
020900031;100;33;79;6;33;66;1;33;0;1;32;0;0;0
020900032;100;86;86;8;34;65;1;34;4;0;30;0;0;0
020900033;100;54;54;6;25;74;1;25;3;1;21;0;0;0
020900034;100;73;73;7;25;74;1;25;2;2;21;0;0;0
020900035;100;101;101;4;46;53;1;46;3;3;40;0;0;0
020900036;100;62;62;6;36;63;1;36;0;1;35;0;0;0
020900037;100;31;31;7;20;79;1;20;0;1;19;0;0;0
020900038;300;348;348;8;133;175;1;124;7;0;117;9;0;9
020900039;100;55;55;7;43;56;1;43;4;0;39;0;0;0
020900040;200;121;121;5;69;130;1;69;2;2;65;0;0;0
020900041;100;42;42;7;20;79;1;20;2;1;17;0;0;0
020900042;300;290;290;5;148;150;2;148;1;3;144;0;0;0
020900043;300;265;266;6;101;198;1;101;0;1;100;0;0;0
020900044;100;47;47;7;29;70;1;29;1;0;28;0;0;0
020900045;200;165;165;7;28;171;1;28;2;0;26;0;0;0
020900046;600;808;818;7;356;275;1;324;5;10;309;32;3;29
020900047;300;237;237;6;67;232;1;67;2;0;65;0;0;0
020900048;100;12;12;9;11;88;1;11;0;0;11;0;0;0
020900049;100;57;57;6;39;60;1;39;0;0;39;0;0;0
020900050;200;99;99;6;56;143;1;56;3;1;52;0;0;0
020900051;200;173;173;8;50;149;1;50;2;0;48;0;0;0
020900052;100;110;110;8;34;65;1;34;2;1;31;0;0;0
020900053;100;68;68;7;37;62;1;37;0;2;35;0;0;0
020900054;100;86;87;6;33;66;1;33;0;2;31;0;0;0
020900055;200;143;143;7;70;129;1;70;3;0;67;0;0;0
020900056;500;426;426;7;102;423;1;76;2;3;71;26;1;25
020900057;100;24;24;7;16;82;2;16;0;1;15;0;0;0
020900058;100;74;74;7;34;65;1;34;2;0;32;0;0;0
020900059;100;25;25;0;24;75;1;24;1;0;23;0;0;0
021200001;300;351;352;4;92;231;1;68;7;2;59;24;0;24
021200002;500;518;518;6;146;398;1;101;3;6;92;45;1;44
021200003;500;505;505;2;136;419;1;80;5;5;70;56;3;53
021200004;400;371;372;0;108;325;1;74;3;1;70;34;0;34
021200005;50;23;23;8;24;25;1;24;0;1;23;0;0;0
021200007;200;194;194;2;142;57;1;142;3;0;139;0;0;0
021200008;50;17;17;7;19;30;1;19;0;0;19;0;0;0
021200009;50;26;26;8;27;22;1;27;0;0;27;0;0;0
021200011;50;39;39;3;28;20;2;28;0;1;27;0;0;0
021200012;50;39;39;7;35;14;1;35;3;1;31;0;0;0
021200013;300;310;310;8;150;149;1;150;10;4;136;0;0;0
021200016;50;36;36;5;26;23;1;26;0;0;26;0;0;0
021300001;400;459;460;4;182;281;1;118;1;3;114;64;3;61
021300002;600;664;665;7;264;448;1;151;3;9;139;113;3;110
021300003;600;629;632;2;247;437;1;162;2;1;159;85;4;81
021300004;600;724;725;4;301;426;2;172;2;4;166;129;4;125
021300005;300;356;356;2;169;200;3;97;1;4;92;72;3;69
021300006;700;755;775;5;345;435;2;263;7;2;254;82;2;80
021300007;800;958;957;4;536;366;1;433;15;9;409;103;3;100
021300008;300;182;265;6;188;111;1;188;13;1;174;0;0;0
021300009;50;18;18;6;21;28;1;21;1;0;20;0;0;0
021300010;400;476;476;4;265;202;1;197;6;2;189;68;5;63
021300011;100;65;65;7;45;54;1;45;0;2;43;0;0;0
021300012;100;38;38;6;31;68;1;31;0;0;31;0;0;0
021300013;500;464;464;0;247;314;1;185;8;3;174;62;4;58
021300014;500;549;549;4;246;332;1;167;1;4;162;79;2;77
021300015;100;39;39;4;34;65;1;34;2;1;31;0;0;0
021300016;300;285;285;5;192;107;1;192;5;2;185;0;0;0
021300017;200;174;174;4;76;123;1;76;0;5;71;0;0;0
021300018;200;148;148;4;57;141;2;57;1;0;56;0;0;0
021300019;200;216;216;7;144;55;1;144;1;7;136;0;0;0
021300020;50;30;30;8;19;30;1;19;1;0;18;0;0;0
021500001;400;469;469;7;224;308;2;90;0;3;87;134;9;125
021500002;400;470;470;5;232;311;1;88;1;4;83;144;8;136
021500003;400;420;420;4;187;314;2;84;1;2;81;103;4;99
021500004;600;694;694;7;263;475;1;124;3;2;119;139;4;135
021500005;700;787;787;6;333;558;1;141;3;7;131;192;11;181
021500006;700;713;713;4;280;554;1;145;5;6;134;135;5;130
021500007;600;624;623;4;235;476;1;123;2;6;115;112;7;105
021500008;600;681;682;1;230;466;1;133;3;1;129;97;2;95
021500009;700;765;765;0;336;500;1;199;4;5;190;137;11;126
021500010;600;683;682;6;262;461;1;138;4;4;130;124;12;112
021500011;700;723;723;5;292;547;1;152;4;2;146;140;1;139
021500012;500;490;491;5;148;433;1;66;2;2;62;82;1;81
021500013;900;918;920;8;306;721;1;178;9;5;164;128;5;123
021500014;200;149;149;3;92;107;1;92;1;0;91;0;0;0
021500015;800;850;851;2;355;610;1;189;11;5;173;166;3;163
021500016;700;695;696;4;267;578;1;121;3;3;115;146;7;139
021500017;900;987;988;4;283;767;1;132;2;6;124;151;1;150
021500018;500;495;494;3;104;402;2;96;2;2;92;8;0;8
021500019;300;322;322;6;118;222;1;77;2;2;73;41;1;40
021500020;500;520;519;6;172;386;1;113;9;2;102;59;4;55
021500021;400;395;395;2;173;293;1;106;2;6;98;67;0;67
021500022;500;543;545;4;219;386;4;110;4;2;104;109;1;108
021500023;500;512;514;0;221;363;4;133;3;1;129;88;5;83
021500024;600;679;679;1;275;465;1;134;4;2;128;141;9;132
021500025;100;38;38;5;33;66;1;33;1;0;32;0;0;0
021500026;100;37;37;6;32;67;1;32;0;2;30;0;0;0
021500027;400;411;412;3;120;311;1;88;1;2;85;32;2;30
021500028;600;683;684;3;309;306;1;293;22;2;269;16;0;16
021500029;100;54;54;6;33;66;1;33;0;1;32;0;0;0
021500030;600;675;675;4;254;490;1;109;1;3;105;145;7;138
021500031;600;661;661;2;258;478;1;121;2;4;115;137;2;135
021500032;400;436;436;4;161;294;2;104;1;0;103;57;3;54
021500033;500;539;539;4;181;385;2;113;4;0;109;68;0;68
021500034;1100;1116;1116;2;455;918;3;179;2;3;174;276;11;265
021500035;1000;1046;1044;6;298;830;12;158;4;4;150;140;0;140
021500036;600;581;581;4;215;489;2;109;0;6;103;106;4;102
021500037;200;151;151;24;144;55;1;144;4;0;140;0;0;0
021700001;100;69;69;3;40;59;1;40;1;1;38;0;0;0
021700002;500;489;489;4;202;384;1;115;2;4;109;87;5;82
021700003;400;416;416;5;161;285;2;113;2;4;107;48;1;47
021700004;400;453;453;4;167;302;1;97;11;2;84;70;6;64
021700005;400;413;412;4;163;292;1;107;1;2;104;56;2;54
021700006;500;507;508;4;163;364;1;135;8;1;126;28;1;27
021700007;400;437;437;2;127;290;1;109;16;1;92;18;1;17
021700008;400;414;414;5;224;191;1;208;5;4;199;16;1;15
021700009;500;541;541;8;261;242;1;257;5;4;248;4;0;4
021700010;500;552;552;5;107;406;1;93;6;0;87;14;0;14
021700011;500;513;514;4;145;374;1;125;8;2;115;20;0;20
021700012;400;416;416;5;132;287;1;112;0;0;112;20;0;20
021700013;300;219;211;5;83;216;1;83;3;4;76;0;0;0
021700014;600;651;653;7;167;470;1;129;3;3;123;38;1;37
021700015;400;464;464;3;98;312;1;87;1;2;84;11;0;11
021700016;500;544;544;4;186;395;1;104;0;1;103;82;5;77
021700017;500;585;585;4;192;362;1;137;3;4;130;55;1;54
021700018;500;586;586;8;250;368;1;131;0;5;126;119;7;112
021700019;400;372;372;4;155;324;4;72;1;3;68;83;3;80
021700020;500;492;494;3;180;398;4;98;3;1;94;82;1;81
021700021;400;408;410;6;155;322;1;77;2;2;73;78;0;78
021700022;400;465;469;1;186;335;1;64;0;1;63;122;6;116
021700023;500;507;508;6;218;402;1;97;3;4;90;121;5;116
021700024;800;850;851;5;325;646;1;153;3;6;144;172;7;165
021700025;800;873;875;1;326;644;1;155;2;2;151;171;8;163
021700026;500;549;550;4;204;402;1;97;3;3;91;107;10;97
021700027;200;194;194;4;85;114;1;85;1;4;80;0;0;0
021700028;400;462;462;4;170;309;1;90;0;1;89;80;4;76
021700029;700;724;725;3;270;572;1;127;4;2;121;143;3;140
021700030;400;416;417;5;152;321;1;78;3;4;71;74;3;71
021700031;500;524;523;6;184;394;2;104;1;2;101;80;5;75
021700032;700;777;778;7;282;423;2;275;17;1;257;7;0;7
021700033;400;386;386;7;177;311;1;88;0;6;82;89;2;87
021700034;300;201;201;5;121;178;1;121;3;2;116;0;0;0
021700035;300;267;267;5;75;224;1;75;1;4;70;0;0;0
021700036;400;390;390;5;153;330;1;69;4;3;62;84;1;83
021700037;600;611;613;2;216;500;1;99;0;4;95;117;8;109
021700038;500;574;576;3;185;403;1;96;1;2;93;89;2;87
021700039;500;530;530;6;193;400;2;98;6;2;90;95;6;89
021700040;800;952;956;6;299;533;1;266;22;0;244;33;1;32
021700041;200;104;104;0;36;163;1;36;1;0;35;0;0;0
021700042;100;33;31;6;26;73;1;26;2;0;24;0;0;0
021700043;500;513;513;4;143;377;6;117;6;2;109;26;2;24
021700044;700;725;726;3;275;459;1;240;6;6;228;35;1;34
021700045;500;472;472;6;201;328;2;170;6;2;162;31;0;31
021700046;600;693;693;8;216;433;2;165;5;1;159;51;3;48
021700047;300;206;206;5;100;199;1;100;2;4;94;0;0;0
021700049;300;137;137;52;134;164;2;134;3;4;127;0;0;0
021700050;300;32;32;117;148;151;1;148;1;6;141;0;0;0
021700051;500;529;529;6;179;354;1;145;1;0;144;34;0;34
021700052;100;11;11;5;14;86;0;14;0;0;14;0;0;0
021700053;100;19;19;26;32;65;3;32;4;0;28;0;0;0
021800001;900;932;932;6;327;593;1;306;35;2;269;21;0;21
021800002;600;621;622;6;300;321;1;278;15;11;252;22;0;22
021800003;700;719;719;7;328;410;1;289;9;3;277;39;1;38
021800004;700;686;686;2;260;439;1;260;7;6;247;0;0;0
021800005;300;280;280;5;131;168;1;131;2;1;128;0;0;0
021800006;900;881;884;7;403;496;1;403;10;4;389;0;0;0
021800007;700;711;711;5;436;298;1;401;12;3;386;35;1;34
021800008;600;632;632;8;309;308;1;291;8;3;280;18;0;18
021800009;400;370;370;2;159;256;1;143;0;4;139;16;2;14
021800010;300;334;334;2;138;161;1;138;2;1;135;0;0;0
021800011;700;689;689;4;367;332;1;367;13;4;350;0;0;0
021800012;400;412;412;3;244;157;1;242;2;5;235;2;0;2
021800013;1100;1090;1090;7;699;427;5;668;13;4;651;31;1;30
021800015;200;181;181;3;142;57;1;142;3;4;135;0;0;0
021800016;400;437;437;5;229;173;0;227;11;4;212;2;0;2
021800017;500;468;468;7;220;279;1;220;5;2;213;0;0;0
021800018;800;787;789;9;240;618;1;181;3;2;176;59;4;55
021800019;800;799;798;6;250;609;1;190;5;4;181;60;1;59
021800020;500;498;498;3;107;411;1;88;7;3;78;19;2;17
021800021;500;503;504;5;327;228;1;271;10;4;257;56;1;55
021800022;700;686;687;4;337;366;1;333;17;4;312;4;0;4
021800023;800;797;798;8;383;442;2;356;6;5;345;27;3;24
021800024;400;369;369;5;231;196;1;203;0;3;200;28;1;27
021800025;500;481;481;5;255;337;1;162;4;2;156;93;0;93
021800026;400;395;395;5;239;241;1;158;3;0;155;81;8;73
021800027;500;555;556;2;219;307;1;192;3;1;188;27;3;24
021800028;600;637;637;2;209;442;1;157;10;1;146;52;3;49
021800029;900;974;974;3;457;442;1;457;26;3;428;0;0;0
021800030;700;704;704;8;342;366;1;333;24;4;305;9;0;9
021800031;400;383;383;4;247;191;1;208;4;1;203;39;1;38
021800032;200;222;222;1;155;44;1;155;1;0;154;0;0;0
021800033;600;572;572;7;264;363;1;236;7;1;228;28;0;28
021800034;800;807;807;5;362;445;1;354;35;0;319;8;0;8
021800035;400;459;459;4;230;184;1;215;4;1;210;15;1;14
021800036;400;375;375;4;214;243;1;156;9;0;147;58;1;57
021800037;600;615;614;4;277;394;1;205;4;1;200;72;2;70
021800038;300;340;341;3;222;77;1;222;4;3;215;0;0;0
021800039;1000;986;986;6;602;452;5;543;17;10;516;59;1;58
021800041;500;529;529;3;226;308;5;187;4;1;182;39;0;39
021800042;300;339;340;4;234;75;1;224;4;1;219;10;0;10
021800043;600;623;623;5;289;310;1;289;4;5;280;0;0;0
021800044;400;359;359;6;239;197;1;202;7;4;191;37;1;36
021800045;400;480;481;5;278;158;1;241;4;2;235;37;2;35
021800046;800;837;837;5;392;427;2;371;12;4;355;21;0;21
021800047;700;680;680;10;291;423;1;276;6;5;265;15;1;14
021800048;700;676;678;5;283;419;1;280;7;1;272;3;0;3
021800049;400;363;364;6;134;278;1;121;3;3;115;13;0;13
021800051;1100;1169;1169;5;434;703;1;396;14;3;379;38;2;36
021800052;500;454;454;3;213;320;1;179;6;0;173;34;2;32
021800053;100;31;31;2;33;67;0;33;0;0;33;0;0;0
022100001;400;500;500;6;264;238;2;160;0;6;154;104;8;96
022100002;400;454;454;12;246;263;3;134;1;4;129;112;4;108
022100003;700;810;810;6;396;485;1;214;4;1;209;182;5;177
022100004;500;522;522;2;195;390;1;109;7;1;101;86;1;85
022100005;800;907;908;1;394;575;3;222;6;11;205;172;9;163
022100006;600;678;678;2;315;449;1;150;4;2;144;165;6;159
022100008;250;215;215;5;99;150;1;99;2;2;95;0;0;0
022100009;450;500;500;6;203;352;3;95;0;3;92;108;7;101
022100010;150;84;84;4;72;77;1;72;0;2;70;0;0;0
022100011;250;213;213;4;104;145;1;104;5;2;97;0;0;0
022100012;400;430;430;3;208;206;10;184;9;3;172;24;2;22
022100013;400;427;427;6;144;279;1;120;8;2;110;24;0;24
022100015;200;133;133;6;101;98;1;101;5;2;94;0;0;0
022100016;550;646;646;6;247;394;1;155;7;2;146;92;2;90
022100017;150;79;79;6;43;105;2;43;3;2;38;0;0;0
022100018;500;591;591;5;327;226;2;272;9;0;263;55;1;54
022100019;650;747;747;6;232;459;1;190;10;5;175;42;0;42
022100020;700;785;785;2;357;394;3;303;22;2;279;54;0;54
022100021;300;332;332;2;113;235;1;64;0;3;61;49;2;47
022100022;850;919;919;2;356;646;1;203;6;6;191;153;7;146
022100023;800;872;873;2;348;620;1;179;3;7;169;169;14;155
022300001;600;658;658;7;262;386;1;213;13;4;196;49;0;49
022300002;600;585;585;7;242;433;1;166;6;0;160;76;3;73
022300003;600;617;617;1;218;446;1;153;8;5;140;65;1;64
022300004;600;906;907;2;374;239;1;360;36;2;322;14;0;14
022300005;100;65;65;8;44;55;1;44;1;0;43;0;0;0
022300006;100;56;56;4;32;67;1;32;0;0;32;0;0;0
022300007;100;29;50;1;30;69;1;30;0;0;30;0;0;0
022300008;300;302;302;7;207;92;1;207;5;1;201;0;0;0
022300009;100;93;93;7;67;32;1;67;0;0;67;0;0;0
022300010;100;61;61;7;41;58;1;41;0;0;41;0;0;0
022300011;300;317;317;7;128;171;1;128;3;0;125;0;0;0
022300012;600;642;642;9;297;305;1;294;13;0;281;3;0;3
022300013;100;15;15;7;17;82;1;17;0;0;17;0;0;0
022300014;100;34;34;6;25;74;1;25;1;1;23;0;0;0
022300015;100;41;73;3;41;58;1;41;1;0;40;0;0;0
022300016;200;194;194;5;45;154;1;45;2;0;43;0;0;0
022300017;300;298;298;9;174;137;3;160;8;0;152;14;0;14
022300018;300;305;305;4;152;147;1;152;3;1;148;0;0;0
022300019;600;612;612;6;341;280;1;319;14;5;300;22;0;22
022300020;600;604;604;9;266;340;1;259;7;2;250;7;1;6
022300021;500;505;506;7;244;267;2;231;8;6;217;13;0;13
022300022;300;257;256;4;126;173;1;126;4;5;117;0;0;0
022300023;400;459;459;4;219;198;1;201;3;3;195;18;0;18
022300024;100;139;139;6;74;24;2;74;1;2;71;0;0;0
022300025;600;622;624;3;273;343;1;256;17;0;239;17;0;17
022300026;200;83;157;6;89;110;1;89;1;1;87;0;0;0
022300027;600;843;843;6;350;249;2;349;4;5;340;1;0;1
022300028;100;40;41;8;29;70;1;29;0;0;29;0;0;0
022300029;300;269;270;6;141;158;1;141;4;4;133;0;0;0
022300030;400;492;493;8;284;162;1;237;10;0;227;47;1;46
022300031;100;36;36;0;29;70;1;29;7;0;22;0;0;0
022700001;700;772;773;2;300;550;1;149;3;7;139;151;15;136
022700002;900;986;973;5;367;666;2;232;9;7;216;135;5;130
022700003;900;979;979;6;347;688;1;211;2;4;205;136;8;128
022700004;700;698;699;5;416;358;5;337;21;2;314;79;4;75
022700005;150;122;122;6;67;81;2;67;0;2;65;0;0;0
022700006;400;448;450;4;228;265;2;133;4;3;126;95;1;94
022700007;50;42;39;6;22;27;1;22;7;1;14;0;0;0
022700008;800;804;804;4;392;566;2;232;5;11;216;160;4;156
022700009;400;432;433;7;234;251;1;148;3;4;141;86;2;84
030100001;400;509;509;4;226;242;1;157;3;7;147;69;5;64
030100002;400;504;480;6;270;200;1;199;4;0;195;71;1;70
030100003;600;627;615;7;316;367;10;223;9;8;206;93;2;91
030100004;200;149;133;3;96;103;1;96;1;0;95;0;0;0
030100005;400;356;356;4;203;230;1;169;7;3;159;34;1;33
030100006;600;727;727;1;457;150;1;449;27;0;422;8;0;8
030100007;300;309;302;7;203;96;1;203;11;1;191;0;0;0
030100008;200;205;205;12;59;140;1;59;3;0;56;0;0;0
030100009;200;195;131;4;117;82;1;117;1;3;113;0;0;0
030100010;100;60;58;6;57;42;1;57;0;1;56;0;0;0
030100011;600;829;799;5;377;389;2;209;6;1;202;168;5;163
030100012;150;143;83;2;94;55;1;94;0;1;93;0;0;0
030100013;250;241;189;2;137;112;1;137;3;2;132;0;0;0
030100014;600;874;875;1;348;284;1;315;35;2;278;33;0;33
030100015;500;458;444;5;292;230;2;268;18;4;246;24;1;23
030100016;500;515;469;5;259;278;1;221;18;5;198;38;1;37
030100017;100;77;75;2;31;68;1;31;2;0;29;0;0;0
030200001;600;741;742;9;333;425;1;174;5;8;161;159;9;150
030200002;600;783;784;3;327;449;1;150;4;8;138;177;5;172
030200003;600;754;754;3;302;488;1;111;3;4;104;191;5;186
030200004;600;581;585;2;214;514;1;85;4;1;80;129;4;125
030200005;600;741;741;3;226;467;2;131;5;3;123;95;7;88
030200006;700;799;800;7;328;534;2;164;2;3;159;164;8;156
030200007;600;763;764;4;285;469;1;130;5;1;124;155;12;143
030200008;600;671;675;5;266;477;1;122;3;1;118;144;8;136
030200009;600;733;733;4;299;438;1;161;2;7;152;138;6;132
030200010;600;752;743;5;361;255;1;344;17;1;326;17;0;17
030200011;700;871;687;4;372;338;2;360;24;7;329;12;1;11
030200012;200;196;196;6;121;78;1;121;1;9;111;0;0;0
030200013;200;151;151;5;117;82;1;117;1;1;115;0;0;0
030200014;600;596;596;4;165;468;1;131;5;1;125;34;3;31
030200015;600;664;668;4;265;374;1;225;18;0;207;40;0;40
030200016;600;636;636;9;232;404;1;195;11;1;183;37;1;36
030200017;600;712;712;8;199;428;1;171;6;1;164;28;3;25
030200018;600;694;694;6;194;452;1;147;17;0;130;47;0;47
030200019;600;659;623;7;287;403;1;196;9;4;183;91;4;87
030200020;200;120;120;6;75;124;1;75;2;1;72;0;0;0
030200021;700;818;819;2;352;502;1;197;8;9;180;155;6;149
030200022;300;306;307;3;161;138;1;161;6;5;150;0;0;0
030200023;200;231;231;4;143;56;1;143;3;7;133;0;0;0
030200024;200;248;250;7;134;65;1;134;0;4;130;0;0;0
030200025;100;79;79;2;68;31;1;68;0;0;68;0;0;0
030200026;200;172;173;5;113;84;3;113;1;1;111;0;0;0
030200027;400;311;311;5;163;236;1;163;7;2;154;0;0;0
030200028;400;355;355;2;132;318;1;81;4;0;77;51;4;47
030200029;200;127;127;2;80;119;1;80;0;2;78;0;0;0
030200030;200;109;109;2;59;140;1;59;2;0;57;0;0;0
030200031;200;124;124;5;75;124;1;75;2;2;75;0;0;0
030200032;100;33;33;4;24;75;1;24;1;0;23;0;0;0
030200033;400;299;232;4;115;284;1;115;4;3;108;0;0;0
030200034;500;523;425;4;217;282;1;217;7;4;206;0;0;0
030200035;400;367;301;4;131;268;1;131;5;0;126;0;0;0
030200036;300;297;297;4;204;95;1;204;8;1;195;0;0;0
030200037;100;99;99;7;66;33;1;66;4;3;59;0;0;0
030200038;100;17;17;3;19;80;1;19;0;0;19;0;0;0
030400001;900;880;880;6;242;705;1;194;21;2;171;48;1;47
030400002;800;790;791;3;257;643;1;156;9;1;146;101;8;93
030400003;800;801;802;4;274;657;1;142;6;1;135;132;8;124
030400004;800;752;752;6;230;682;2;116;7;5;104;114;6;108
030400005;600;551;551;4;206;479;1;120;4;1;115;86;5;81
030400006;500;506;506;6;176;402;1;97;2;2;93;79;3;76
030400007;500;526;526;5;178;424;1;75;1;3;71;103;4;99
030400008;500;542;542;5;164;426;1;73;0;3;70;91;4;87
030400009;500;422;423;4;112;444;1;55;1;1;53;57;3;54
030400010;500;473;475;4;128;436;1;63;4;0;59;65;3;62
030400011;400;369;370;4;115;332;1;67;1;1;65;48;4;43
030400012;700;675;658;3;256;557;1;142;3;6;133;114;6;108
030400013;600;566;566;7;205;474;1;125;1;1;123;80;7;73
030400014;1000;940;940;5;334;781;1;218;8;9;201;116;8;108
030500001;500;858;858;1;305;336;1;163;11;6;146;142;4;138
030500002;500;770;770;1;300;316;1;183;10;3;170;117;4;113
030500003;100;78;79;1;39;60;1;39;0;0;39;0;0;0
030500004;200;200;201;2;97;102;1;97;3;0;94;0;0;0
030500005;300;235;235;5;125;174;1;125;10;5;110;0;0;0
030500006;400;417;417;1;95;318;1;81;4;0;77;14;0;14
030600378;500;628;628;2;212;377;1;122;2;2;118;90;5;85
030600379;500;474;474;4;172;408;1;91;0;1;90;81;3;78
030600380;1000;654;654;5;273;857;1;142;4;0;138;131;5;126
030600381;1000;719;719;5;276;841;1;158;2;2;154;118;2;116
030600382;500;318;318;5;173;387;1;112;2;4;106;61;5;56
030600383;500;418;418;6;178;397;1;102;6;3;93;76;4;72
030600384;1000;834;834;8;211;790;2;208;15;1;192;3;0;3
030600385;1000;792;792;8;202;797;1;202;17;2;183;0;0;0
030600386;1000;974;974;4;427;610;1;389;8;28;353;38;1;37
030600387;1000;1120;1120;7;423;739;1;260;8;8;244;163;4;159
030600414;500;32;32;4;34;466;0;34;1;0;33;0;0;0
030600415;100;34;34;6;39;61;0;39;1;0;38;0;0;0
030601001;500;653;654;11;270;396;1;103;0;0;103;167;4;163
030601002;1000;781;781;8;334;855;1;144;5;0;139;190;6;184
030601003;1000;900;901;7;418;828;1;171;1;3;167;247;8;239
030601004;500;771;771;18;328;365;1;134;1;1;132;194;3;191
030601005;500;703;704;10;309;364;5;131;5;4;122;178;10;168
030601006;500;587;587;4;242;388;1;111;4;5;102;131;2;129
030601007;500;684;686;5;287;388;2;110;4;3;103;177;7;170
030601008;500;609;610;11;248;390;2;108;0;3;105;140;3;137
030601009;500;558;558;9;256;399;1;100;2;0;98;156;4;152
030601010;500;594;594;7;284;384;1;115;0;4;111;169;6;163
030601011;500;698;699;7;308;356;1;143;1;3;139;165;4;161
030601012;1000;811;813;7;338;792;1;207;3;9;195;131;3;127
030601013;500;752;753;9;362;151;4;345;2;7;336;17;0;17
030601014;500;679;682;6;289;387;1;112;2;2;108;177;9;168
030601015;500;774;776;12;319;362;1;137;4;4;129;182;8;174
030601016;1000;916;916;7;344;702;2;296;2;8;286;48;1;47
030601017;1000;954;954;10;382;840;1;159;4;3;152;223;8;215
030601018;1000;1061;1062;6;428;839;2;159;2;4;153;269;2;267
030601019;1000;807;810;8;310;777;1;222;4;4;214;88;4;84
030601020;1000;953;953;5;377;742;1;257;7;8;242;120;4;116
030601021;1000;973;977;6;404;827;1;172;3;3;166;232;5;227
030601022;500;749;751;5;326;382;2;116;2;1;113;210;1;209
030601023;1000;952;953;10;391;822;1;177;2;3;172;214;5;209
030601024;1000;923;924;8;378;828;1;171;9;5;157;207;4;203
030601025;500;733;733;14;315;362;2;136;4;5;127;179;7;172
030601026;1000;840;877;5;366;835;1;164;3;1;160;202;7;195
030601027;500;720;721;13;297;366;1;133;1;4;128;164;3;161
030601028;1000;839;840;10;326;849;1;150;6;1;143;176;5;171
030601029;500;714;714;4;297;379;1;120;2;5;113;177;5;172
030601030;1000;835;835;7;372;847;1;152;4;1;147;220;6;214
030601031;500;583;585;5;241;402;1;97;3;4;90;144;3;141
030601032;1000;900;900;5;392;799;1;200;1;3;196;192;7;185
030601033;1000;945;946;6;355;835;1;164;5;0;159;191;8;183
030601034;500;739;739;9;340;384;1;115;1;0;114;225;6;219
030601035;500;704;706;7;308;374;0;126;4;6;116;182;7;175
030601036;500;549;550;10;240;404;2;94;1;1;92;146;6;140
030601037;500;691;691;15;304;372;1;127;6;1;120;177;7;170
030601038;1000;807;808;7;342;862;1;137;4;6;127;205;3;202
030601039;1000;890;890;5;393;848;1;151;2;3;146;242;14;228
030601040;500;537;537;6;239;404;1;95;1;4;90;144;4;140
030601041;500;594;598;6;270;384;4;112;5;3;104;158;4;154
030601042;500;710;710;7;319;394;1;105;2;0;103;214;6;208
030601043;500;776;776;6;336;335;1;164;4;3;157;172;9;163
030601044;500;635;635;8;286;375;1;124;4;1;119;162;9;153
030601045;500;699;703;6;331;383;1;116;5;5;106;215;6;209
030601046;1000;880;880;6;398;749;1;250;5;13;232;148;6;142
030601047;1000;872;872;8;382;811;1;188;4;1;183;194;7;187
030601048;1000;895;895;5;390;766;1;233;3;8;222;157;8;149
030601049;1000;790;790;7;320;845;2;153;3;3;147;167;5;162
030601050;1000;918;922;7;391;807;1;192;1;7;184;199;14;185
030601051;1000;873;875;8;354;841;2;157;5;4;148;197;12;185
030601052;1000;820;821;10;360;639;4;357;3;13;341;3;0;3
030601053;500;761;763;4;330;345;1;154;3;4;147;176;3;173
030601054;1000;880;884;4;334;813;2;185;2;7;176;149;2;147
030601055;1000;872;875;10;376;806;5;189;3;3;183;187;10;177
030601056;1000;1029;1031;4;417;840;1;159;1;4;154;258;5;253
030601057;1000;978;979;7;394;832;1;167;5;4;158;227;12;215
030601058;1000;870;870;7;356;841;1;158;10;5;143;198;5;193
030601059;1000;972;972;10;414;824;1;175;5;3;167;239;4;235
030601060;1000;1012;1012;0;443;779;1;220;3;7;210;223;9;214
030601061;1000;817;817;8;350;865;1;134;0;6;128;216;12;204
030601062;1000;885;885;5;361;837;1;162;1;5;156;199;5;194
030601063;1000;932;932;8;399;820;1;179;7;2;170;220;8;212
030601064;1000;1062;1064;3;401;793;1;206;6;3;197;195;8;187
030601065;1000;1135;1137;9;416;820;1;179;4;4;171;237;10;227
030601066;1000;864;864;9;346;854;3;143;5;17;121;203;10;193
030601067;1000;871;873;9;262;896;1;103;2;1;100;159;6;153
030601068;1000;928;929;8;359;846;1;153;3;4;146;206;4;202
030601069;1000;1014;1016;5;369;822;1;177;11;7;159;192;6;186
030601070;1000;961;963;7;365;828;3;169;4;2;163;196;11;185
030601071;1000;777;778;9;260;863;1;136;8;1;127;124;9;115
030601072;500;717;717;3;234;303;2;195;5;3;187;39;1;38
030601073;500;561;562;6;157;397;1;102;6;1;95;55;1;54
030601074;500;387;388;6;113;428;1;71;4;1;66;42;2;40
030601075;1000;820;821;7;172;869;2;129;14;0;115;43;0;43
030601076;1000;891;891;7;181;843;1;156;14;0;142;25;0;25
030601077;1000;849;855;6;209;886;1;113;5;2;106;96;3;93
030601078;1000;980;983;9;221;840;3;157;3;3;151;64;1;63
030601079;1000;912;914;6;332;807;1;192;2;3;187;140;5;135
030601080;1000;932;935;5;337;674;1;325;6;18;301;12;1;11
030601081;1000;932;932;8;323;845;2;153;7;5;141;170;8;162
030601082;1000;905;907;11;406;765;2;233;4;5;224;173;11;162
030601083;500;688;689;8;287;349;1;150;2;6;142;137;4;133
030601084;1000;908;910;6;413;836;1;163;2;4;157;250;22;228
030601085;1000;871;872;13;355;866;1;133;1;4;128;222;10;212
030601086;500;592;594;8;265;395;1;104;2;1;101;161;6;155
030602087;900;866;866;8;360;769;1;130;3;3;124;230;11;219
030602088;800;770;771;7;305;672;1;127;5;4;118;178;8;170
030602089;800;784;784;10;243;698;2;100;2;5;93;143;6;137
030602090;700;741;741;17;337;596;1;103;6;1;96;234;11;223
030602091;900;950;951;3;400;734;1;165;4;8;153;235;11;224
030602092;1000;1001;1001;21;416;836;3;161;4;2;155;255;14;241
030602093;900;953;953;7;437;733;2;165;5;3;157;272;10;262
030602094;1000;972;976;6;392;833;3;164;6;6;152;228;7;221
030602095;900;878;880;7;384;665;2;233;5;12;216;151;7;144
030602096;1000;1024;1026;9;408;842;2;156;3;4;149;252;7;245
030602097;900;932;933;6;429;700;2;198;6;2;190;231;5;226
030602098;800;836;840;14;360;658;1;141;2;2;137;219;16;203
030602099;700;745;745;20;312;554;1;145;6;2;137;167;4;163
030602100;700;684;684;15;285;506;1;193;0;4;189;92;4;88
030602101;800;804;805;6;333;654;1;145;4;1;140;188;3;185
030602102;600;596;598;15;268;484;2;114;1;0;113;154;5;149
030602103;800;841;841;13;362;626;4;170;4;8;158;192;5;187
030602104;900;881;882;19;391;744;1;155;12;3;140;236;9;227
030602105;700;734;737;21;308;577;1;122;2;3;117;186;7;179
030602106;700;724;725;8;326;570;1;129;2;4;123;197;7;190
030602107;700;734;734;10;278;572;1;127;3;1;123;151;7;144
030602108;900;920;920;0;397;709;1;190;4;9;177;207;8;199
030602109;900;905;908;6;389;729;3;168;4;1;163;221;9;212
030602110;700;748;749;11;285;478;1;221;3;6;212;64;2;62
030602111;800;815;815;15;358;655;1;144;3;0;141;214;10;204
030602112;800;890;892;6;360;679;1;120;4;3;113;240;6;234
030602113;700;684;686;4;277;590;2;108;1;2;105;169;6;163
030602114;600;620;620;9;250;505;1;94;2;1;91;156;10;146
030602115;800;844;846;7;351;653;1;146;2;2;142;205;9;196
030602116;700;729;729;9;309;538;1;161;1;4;156;148;7;141
030602117;800;829;831;3;312;662;2;136;5;2;129;176;10;166
030602118;700;771;771;13;360;358;2;340;4;7;329;20;0;20
030602119;700;766;767;11;338;438;1;261;3;21;237;77;4;73
030602120;1000;998;1001;9;393;837;1;162;4;6;152;231;16;215
030602121;700;745;746;8;319;568;1;131;8;0;123;188;12;176
030602122;800;855;856;10;352;651;1;148;4;5;139;204;9;195
030602123;900;955;955;6;458;729;1;170;2;9;159;288;3;285
030602124;800;827;830;9;372;482;1;317;2;13;302;55;3;52
030602125;800;809;811;5;340;645;1;154;6;5;143;186;8;178
030602126;800;776;777;5;289;655;6;139;5;3;131;150;7;143
030602127;700;717;717;9;262;589;3;108;3;1;104;154;7;147
030602128;700;706;706;11;264;600;1;99;1;0;98;165;9;156
030602129;1000;990;989;8;428;847;1;152;2;3;147;276;5;271
030602130;900;887;889;22;410;686;2;212;3;3;206;198;7;191
030602131;900;907;908;22;429;710;1;189;5;3;181;240;11;229
030602132;1000;987;987;10;453;816;1;183;4;2;177;270;6;264
030602133;700;665;668;24;289;581;1;118;3;0;115;171;9;162
030602134;700;758;758;9;337;551;2;147;2;2;143;190;11;179
030602135;800;792;792;36;402;622;7;171;4;2;165;231;12;219
030602136;700;683;684;27;334;460;1;239;3;11;225;95;3;92
030602137;900;879;879;13;403;749;1;150;5;1;144;253;9;244
030602138;1000;1047;1047;6;466;784;1;215;8;1;206;251;3;248
030602139;800;872;873;6;376;612;1;187;2;3;182;189;6;183
030602140;900;920;922;7;424;700;2;198;5;11;182;226;9;217
030602141;1000;950;950;5;429;833;1;166;1;6;159;263;9;254
030602142;1000;1019;1020;7;435;791;1;208;4;3;201;227;9;218
030602143;700;704;707;8;311;584;1;115;3;1;111;196;3;193
030602144;700;742;742;9;338;576;1;123;4;2;117;215;9;206
030602145;700;684;685;7;275;561;1;138;1;7;130;137;5;132
030602146;700;736;737;6;330;535;1;164;4;3;157;166;8;158
030602147;800;813;816;7;356;655;1;144;0;6;138;212;9;203
030602148;700;673;676;7;289;567;1;132;1;2;129;157;9;148
030602149;600;642;644;14;295;343;2;255;3;6;246;40;2;38
030602150;800;786;786;14;320;666;1;133;2;3;128;187;9;178
030602151;800;829;832;10;376;615;1;184;7;5;172;192;11;181
030602152;900;910;910;9;362;761;2;137;3;5;129;225;3;222
030602153;600;580;580;36;283;497;1;102;0;5;97;181;5;176
030602154;1000;1012;1012;10;410;844;1;155;3;5;147;255;9;246
030602155;600;617;617;9;235;485;2;113;2;3;108;122;3;119
030602156;600;596;597;8;283;471;1;128;1;1;126;155;4;151
030602157;600;639;640;9;247;505;1;94;1;4;89;153;4;149
030602158;600;613;613;8;276;496;1;103;4;2;97;173;3;170
030602159;600;613;615;7;259;494;2;104;5;2;97;155;8;147
030602160;600;638;639;7;261;490;2;108;2;1;105;153;9;144
030602161;600;645;647;9;282;492;1;107;1;1;105;175;9;166
030602162;700;663;664;6;292;569;1;130;1;3;126;162;6;156
030602163;600;633;635;8;259;486;1;113;4;3;106;146;5;141
030602164;600;641;642;9;256;351;1;248;3;12;233;8;1;7
030602165;800;876;879;6;406;649;1;150;3;4;143;256;9;247
030602166;600;600;604;10;295;463;2;135;4;5;126;160;4;156
030602167;600;549;550;8;223;392;2;206;3;5;198;17;0;17
030602168;600;642;643;10;261;508;1;91;4;1;86;170;6;164
030602169;900;917;917;9;395;753;3;144;6;4;134;251;10;241
030602170;700;762;764;7;316;384;1;315;7;10;298;1;0;1
030602171;1000;1020;1023;8;405;863;1;136;4;4;128;269;11;258
030602172;1000;1052;1054;6;383;863;1;136;0;2;134;247;7;240
030602173;800;817;817;3;329;672;1;127;1;4;122;202;5;197
030602174;800;775;776;6;291;673;2;125;2;1;122;166;3;163
030602175;900;846;848;13;312;773;1;126;7;1;118;186;5;181
030602176;1000;968;968;6;407;778;1;221;4;5;212;186;5;181
030602177;1000;982;988;6;334;847;1;152;2;5;145;182;8;174
030602178;1000;1095;1097;6;382;835;5;160;4;4;152;222;10;212
030602179;900;909;911;3;311;757;1;142;0;2;140;169;4;165
030602180;900;892;892;7;363;720;1;179;2;4;173;184;9;175
030602181;900;943;945;7;381;723;1;176;9;0;167;205;4;201
030602182;700;751;753;6;326;464;1;235;3;2;230;91;1;90
030602183;900;903;907;9;342;785;1;114;1;3;110;228;11;217
030602184;1000;1052;1052;8;417;863;1;136;1;4;131;281;8;273
030602185;900;859;877;5;318;790;1;109;3;2;104;209;9;200
030602186;800;784;784;7;359;684;1;115;3;1;111;244;15;229
030602187;700;689;689;8;294;555;1;144;4;3;137;150;2;148
030602188;800;843;844;1;343;671;1;128;2;4;122;215;10;205
030602189;1000;1052;1054;12;439;855;1;144;7;1;136;295;9;286
030602190;1000;1062;1062;3;423;809;1;190;6;2;182;233;4;229
030602191;800;813;813;4;330;675;1;124;4;2;118;206;8;198
030602388;500;560;560;9;244;306;1;193;3;10;180;51;1;50
030602389;700;692;692;9;306;610;1;89;1;4;84;217;11;206
030602390;500;468;470;7;207;411;2;87;3;0;84;120;3;117
030602391;500;463;463;4;200;426;3;71;2;1;68;129;9;120
030602392;900;861;863;4;339;759;1;140;6;3;131;199;8;191
030602394;900;908;908;7;428;500;2;398;11;7;380;30;2;28
030602399;500;467;467;11;161;413;2;85;1;1;83;76;5;71
030602401;300;96;96;12;69;230;1;69;5;1;63;0;0;0
030602402;200;43;43;15;36;163;1;36;2;0;34;0;0;0
030602403;500;44;44;146;170;327;3;170;4;13;153;0;0;0
030602405;500;18;18;89;94;405;1;94;3;5;86;0;0;0
030602407;100;15;15;10;25;74;1;25;1;3;21;0;0;0
030603192;800;765;765;16;278;647;1;152;8;4;140;126;11;115
030603193;800;766;767;8;336;697;1;102;1;7;94;234;11;223
030603194;500;523;523;10;230;428;1;71;3;2;66;159;11;148
030603195;900;873;873;8;349;550;1;349;6;9;334;0;0;0
030603196;800;767;770;8;245;691;1;108;4;2;102;137;3;134
030603197;800;803;804;5;269;683;3;114;3;4;107;155;5;150
030603198;800;961;961;7;353;628;2;170;9;9;152;183;7;176
030603199;800;988;988;9;409;600;1;199;3;8;188;210;12;198
030603200;800;768;768;8;287;659;1;140;0;3;137;147;5;142
030603201;800;789;789;9;329;665;7;128;6;2;120;201;8;193
030603202;800;840;840;7;300;668;1;131;3;0;128;169;3;166
030603203;800;838;840;4;279;673;1;126;1;3;122;153;9;144
030603204;800;816;817;5;334;665;1;134;5;5;124;200;11;189
030603205;900;843;844;7;294;758;1;141;2;6;133;153;5;148
030603206;700;703;703;5;238;593;2;105;8;5;92;133;9;124
030603207;800;763;763;6;250;689;3;108;2;3;103;142;5;137
030603208;800;838;841;6;288;675;2;123;1;3;119;165;4;161
030603209;900;911;912;8;377;765;1;134;3;4;127;243;9;234
030603210;700;751;752;5;274;569;2;129;0;3;126;145;6;139
030603211;700;677;677;4;223;596;1;103;1;3;99;120;9;111
030603212;800;798;798;5;271;675;1;124;2;4;118;147;7;140
030603213;700;677;668;9;263;617;1;82;4;5;73;181;7;174
030603214;500;479;480;17;187;398;1;101;5;1;95;86;4;82
030603215;800;919;919;5;421;601;1;198;6;4;188;223;11;212
030603216;700;732;733;2;306;585;2;113;1;2;110;193;5;188
030603217;500;493;494;8;211;404;1;95;0;6;89;116;4;112
030603218;800;975;976;6;426;511;1;288;12;12;264;138;6;132
030603219;500;473;473;3;180;414;1;85;2;1;82;95;7;88
030603220;600;648;648;6;203;523;1;76;1;3;72;127;5;122
030603221;700;723;723;7;262;586;1;113;1;1;111;149;9;140
030603222;300;355;357;3;161;239;1;60;3;1;56;101;1;100
030603223;400;421;421;5;174;334;2;64;3;5;56;110;4;106
030603224;500;481;481;6;181;438;3;59;5;0;54;122;2;120
030603225;400;381;381;7;135;335;1;64;0;2;62;71;3;68
030603226;800;791;791;9;282;671;1;128;5;3;120;154;9;145
030603227;800;930;932;6;378;669;1;130;7;11;112;248;10;238
030603228;700;642;642;7;221;588;1;111;2;3;106;110;8;102
030603229;400;404;404;6;152;329;1;70;1;2;67;82;4;78
030603230;600;617;617;4;228;492;1;107;1;3;103;121;2;119
030603231;600;634;635;7;258;490;1;109;0;1;108;149;5;144
030603232;600;578;578;4;199;515;1;84;2;1;81;115;5;110
030603233;700;658;658;6;263;568;1;131;1;3;127;132;3;129
030603234;600;625;625;9;202;484;2;114;6;5;103;88;8;80
030603235;600;570;570;5;224;488;2;110;2;4;104;114;1;113
030603236;500;513;514;9;161;427;1;72;2;2;68;89;3;86
030603237;900;933;933;8;343;756;1;143;2;9;132;200;11;189
030603238;700;673;674;8;276;607;1;92;2;4;86;184;8;176
030603239;900;1099;1099;6;457;700;1;199;5;7;187;258;9;249
030603240;700;711;711;10;272;588;1;111;5;1;105;161;14;147
030603241;800;790;792;8;367;639;1;160;6;8;146;207;4;203
030603242;600;636;636;8;279;481;2;117;2;2;113;162;6;156
030603243;800;748;748;7;332;634;2;164;4;0;160;168;6;162
030603244;700;734;734;8;295;556;2;142;5;1;136;153;4;149
030603245;800;777;777;7;272;682;1;117;3;4;110;155;8;147
030603246;500;479;480;8;186;448;1;51;3;4;44;135;8;127
030603247;400;434;437;6;189;323;1;76;2;1;73;113;10;103
030603248;600;595;595;9;259;478;1;121;3;3;115;138;8;130
030603249;400;405;408;10;192;306;1;93;0;0;93;99;4;95
030603250;700;691;691;9;300;580;3;117;2;0;115;183;6;177
030603251;800;778;778;7;313;658;1;141;0;5;136;172;13;159
030603252;500;451;451;5;197;394;1;105;1;0;104;92;2;90
030603253;600;581;581;5;247;487;1;112;5;4;103;135;5;130
030603254;400;424;424;5;185;311;1;88;1;1;86;97;4;93
030603255;500;499;499;5;184;424;1;75;2;3;70;109;4;105
030603256;500;473;477;7;192;403;1;96;2;2;92;96;10;86
030603257;600;575;575;8;232;503;1;96;3;2;91;136;4;132
030603258;800;794;797;6;317;678;1;121;7;2;112;196;8;188
030603259;500;518;518;8;222;405;1;94;2;1;91;128;8;120
030603260;600;636;636;6;272;329;2;269;4;5;260;3;0;3
030603261;800;799;781;7;305;654;2;144;5;3;136;161;12;149
030603262;800;805;805;6;301;646;1;153;3;5;145;148;6;142
030603263;600;645;649;11;234;492;1;107;1;8;98;127;6;121
030603264;700;705;706;8;263;586;1;113;3;0;110;150;3;147
030603265;300;343;343;5;90;252;1;47;0;1;46;43;2;41
030603266;900;1011;1013;7;391;742;2;156;4;6;146;235;15;220
030603267;800;903;905;9;376;645;1;154;3;10;141;222;14;208
030603268;600;642;642;8;236;362;2;236;6;10;220;0;0;0
030603269;700;654;654;6;224;580;1;119;4;0;115;105;4;101
030603270;600;625;627;6;210;450;1;149;6;0;143;61;0;61
030603271;800;766;769;10;301;521;1;278;3;12;263;23;0;23
030603272;600;620;620;10;176;510;1;89;3;5;81;87;2;85
030603273;800;887;890;8;174;652;1;147;12;1;134;27;0;27
030603274;800;800;800;4;263;654;1;145;9;4;132;118;3;115
030603275;800;1008;1009;9;304;514;2;284;17;3;264;20;0;20
030603276;800;799;799;6;196;651;11;138;10;1;127;58;2;56
030603277;700;649;651;6;236;575;1;124;3;2;119;112;4;108
030603278;700;653;657;4;212;513;1;186;6;10;170;26;1;25
030603279;800;819;821;7;253;671;1;128;5;0;123;125;2;123
030603280;800;786;787;6;186;674;2;124;19;1;104;62;0;62
030603281;800;931;931;9;418;624;1;175;2;6;167;243;9;234
030603282;600;601;602;9;260;462;1;137;1;3;133;123;4;119
030603283;500;531;531;9;239;389;1;110;3;1;106;129;4;125
030603284;600;593;595;10;257;467;1;132;3;4;125;125;5;120
030603285;600;609;609;9;253;498;2;100;1;8;91;153;8;145
030603286;900;899;898;8;418;629;1;270;5;17;248;148;5;143
030603287;500;466;466;8;183;365;1;134;5;5;124;49;2;47
030603288;500;535;536;10;213;421;2;77;4;2;71;136;8;128
030603289;400;355;355;6;125;347;1;52;0;0;52;73;2;71
030603290;800;806;809;8;313;702;1;97;5;2;90;216;10;206
030603393;800;812;812;5;294;663;2;135;6;5;124;159;8;151
030603395;600;558;558;7;249;535;1;64;0;3;61;185;12;173
030603396;500;508;509;9;181;415;3;82;3;3;76;99;2;97
030603397;500;517;520;7;178;420;1;79;4;1;74;99;1;98
030603398;600;575;576;7;215;505;2;93;2;4;87;122;8;114
030603411;100;57;57;22;74;25;1;74;5;4;65;0;0;0
030603412;100;52;52;14;62;37;1;62;5;9;48;0;0;0
030604291;500;480;481;9;192;418;1;81;0;2;79;111;8;103
030604292;500;506;506;8;191;391;1;108;3;2;103;83;3;80
030604293;500;475;475;6;179;399;1;100;1;4;95;79;2;77
030604294;600;592;592;8;241;479;2;119;1;2;116;122;5;117
030604295;500;528;528;4;205;403;1;96;1;2;93;109;2;107
030604296;500;552;554;4;204;418;1;81;2;3;76;123;8;115
030604297;700;740;740;5;239;567;1;132;2;3;127;107;7;100
030604298;600;601;602;9;127;493;1;106;7;1;98;21;1;20
030604299;800;768;768;6;208;677;1;122;2;2;118;86;5;81
030604300;900;920;920;11;253;688;1;211;12;0;199;42;1;41
030604301;600;614;614;8;229;488;1;111;2;2;107;118;2;116
030604302;600;574;574;7;196;506;2;92;1;6;85;104;2;102
030604303;400;360;362;5;124;275;1;124;0;2;122;0;0;0
030604304;600;542;542;7;230;467;1;132;6;6;120;98;4;94
030604305;400;384;385;5;130;332;1;67;0;2;65;63;5;58
030604306;400;378;378;5;123;343;1;56;2;1;53;67;2;65
030604307;700;665;665;6;214;612;1;87;1;2;84;127;4;123
030604308;600;611;611;8;130;480;1;119;8;1;110;11;0;11
030604309;700;697;699;6;266;547;2;151;3;3;145;115;4;111
030604310;800;743;743;7;258;666;1;133;5;3;125;125;14;111
030604311;800;802;803;7;306;640;1;159;1;4;154;147;6;141
030604312;900;900;902;5;289;744;4;152;3;3;146;137;6;131
030604313;800;755;756;8;265;666;1;133;3;2;128;132;3;129
030604314;700;718;718;3;271;544;1;155;3;8;144;116;6;110
030604315;800;825;825;7;312;487;1;312;5;9;298;0;0;0
030604316;700;719;720;11;291;570;1;129;2;1;126;162;5;157
030604317;700;745;746;8;286;586;4;110;2;2;106;176;7;169
030604318;700;647;647;6;220;607;1;92;1;3;88;128;7;121
030604319;700;659;659;6;250;585;2;113;3;0;110;137;1;136
030604320;600;652;653;6;250;487;1;112;4;4;104;138;1;137
030604321;700;701;704;3;258;590;1;109;1;5;103;149;14;135
030604322;700;672;673;8;245;577;1;122;3;3;116;123;7;116
030604323;600;622;624;2;217;513;2;85;1;1;83;132;7;125
030604324;800;831;832;4;267;692;1;107;3;5;99;160;8;152
030604325;700;687;688;5;207;619;1;80;3;4;73;127;9;118
030604326;800;802;802;4;335;663;1;136;1;6;129;199;7;192
030604327;600;597;597;6;230;471;1;128;2;4;122;102;4;98
030604328;400;399;400;7;171;315;2;83;2;1;80;88;4;84
030604329;400;402;402;5;180;309;2;89;3;3;83;91;4;87
030604330;500;392;392;3;129;448;1;51;2;1;48;78;0;78
030604331;500;448;448;5;138;432;3;65;2;2;61;73;6;67
030604332;600;554;555;5;210;501;1;98;1;4;93;112;8;104
030604333;700;704;704;7;243;560;1;139;4;6;129;104;2;102
030604334;500;531;532;3;166;423;1;76;1;2;73;90;3;87
030604335;400;449;450;5;163;314;2;84;3;3;78;79;6;73
030604336;600;638;638;4;230;477;4;119;3;3;113;111;3;108
030604337;500;485;485;3;184;410;1;89;3;4;82;95;0;95
030604338;700;701;704;6;219;582;5;113;4;6;103;106;6;100
030604339;400;435;436;14;177;320;1;79;3;1;75;98;8;90
030604340;500;568;568;9;202;383;1;116;1;1;114;86;6;80
030604341;800;821;823;6;300;665;2;133;3;3;127;167;15;152
030604342;500;487;488;6;150;399;1;100;6;2;92;50;2;48
030604343;600;591;591;6;186;489;1;110;3;1;106;76;4;72
030604344;400;424;427;6;125;320;4;76;3;1;72;49;4;45
030604345;700;725;727;6;193;566;1;133;6;4;123;60;1;59
030604346;500;519;520;7;156;400;2;98;2;1;95;58;2;56
030604347;700;736;736;8;226;598;1;101;2;4;95;125;5;120
030604348;400;435;435;4;138;328;1;71;2;0;69;67;3;64
030604349;400;463;468;7;144;336;1;63;3;2;58;81;8;73
030604350;600;649;649;9;204;506;1;93;1;2;90;111;8;103
030604351;500;516;516;5;198;399;1;100;1;3;96;98;5;93
030605352;900;986;987;6;404;719;3;178;2;7;169;226;14;212
030605353;800;817;817;8;278;644;1;155;7;2;146;123;0;123
030605354;900;943;943;9;392;702;1;197;5;6;186;195;15;180
030605355;800;829;832;8;307;635;1;164;5;2;157;143;6;137
030605356;800;851;851;6;325;604;1;195;7;4;184;130;1;129
030605357;800;861;862;7;334;645;1;154;3;6;145;180;5;175
030605358;600;663;666;8;233;370;1;229;2;8;219;4;0;4
030605359;600;629;632;8;179;500;1;99;3;0;96;80;4;76
030605360;700;729;730;7;228;471;1;228;8;4;216;0;0;0
030605361;900;960;960;8;224;694;1;205;14;1;190;19;2;17
030605362;900;946;947;7;259;691;1;208;9;2;197;51;1;50
030605363;800;858;858;6;348;460;1;339;6;10;323;9;1;8
030605364;800;822;823;8;329;649;1;150;3;2;145;179;8;171
030605365;900;910;910;4;310;761;1;138;5;2;131;172;3;169
030605366;800;829;831;6;337;648;1;151;3;2;146;186;7;179
030605367;900;910;909;6;332;709;1;190;6;3;181;142;2;140
030605368;800;808;809;7;298;666;2;132;7;2;123;166;8;158
030605369;700;763;763;11;297;529;1;170;4;7;159;127;4;123
030605370;700;728;730;10;315;538;2;160;4;1;155;155;11;144
030605371;800;771;772;7;232;672;1;127;1;3;123;105;8;97
030605372;800;781;782;11;132;691;1;108;16;0;92;24;0;24
030605373;800;807;807;3;258;625;2;173;16;3;154;85;4;81
030605374;1000;970;972;6;383;840;1;159;6;4;149;224;13;211
030605375;800;794;794;5;283;650;1;149;6;6;137;134;7;127
030605376;1000;974;973;6;395;823;1;176;3;2;171;219;8;211
030605377;1000;1034;1034;5;377;821;2;177;2;5;170;200;5;195
030605400;600;609;610;4;242;496;5;99;2;2;95;143;5;138
030605413;100;17;17;31;41;58;1;41;3;1;37;0;0;0
030800001;600;647;649;7;318;329;1;270;13;7;250;48;4;44
030800002;100;95;95;6;65;34;1;65;0;1;64;0;0;0
030800003;300;240;240;0;124;175;1;124;0;6;118;0;0;0
030800004;300;364;365;4;115;221;1;78;2;1;75;37;0;37
030800005;600;683;684;3;255;382;1;217;3;4;210;38;2;36
030800006;600;650;650;4;213;421;3;176;5;2;169;37;0;37
030800007;200;169;170;3;72;127;1;72;2;2;68;0;0;0
030800008;300;296;296;4;119;179;2;119;3;2;114;0;0;0
030800009;400;104;368;4;108;306;1;93;2;1;90;15;0;15
030800010;200;127;127;2;86;113;1;86;4;5;77;0;0;0
030800011;100;33;33;5;24;75;1;24;0;0;24;0;0;0
030800012;400;384;385;5;158;291;2;107;7;4;96;51;3;48
030800013;400;407;408;5;177;259;1;140;5;6;129;37;4;33
030900001;500;513;519;6;192;383;2;115;5;2;108;77;5;72
030900002;540;576;576;1;192;416;1;123;2;6;115;69;4;65
030900003;550;586;587;2;216;396;1;153;10;4;139;63;1;62
030900004;800;831;835;2;204;647;1;152;11;4;137;52;5;47
030900005;180;185;187;4;84;95;1;84;2;0;82;0;0;0
030900006;120;128;128;4;81;37;2;81;0;2;79;0;0;0
030900007;300;306;306;5;109;190;1;109;1;4;104;0;0;0
030900008;300;328;328;5;103;223;1;76;2;0;74;27;0;27
030900009;80;70;70;5;31;48;1;31;1;0;30;0;0;0
030900010;200;184;184;3;85;114;1;85;5;2;78;0;0;0
030900011;250;259;259;5;124;125;1;124;5;2;117;0;0;0
030900012;550;579;579;7;201;375;2;173;16;3;154;28;2;26
030900013;300;301;302;3;132;167;1;132;13;0;119;0;0;0
030900014;80;73;74;3;54;25;1;54;1;0;53;0;0;0
030900015;200;217;217;4;79;119;2;79;1;0;78;0;0;0
030900016;200;193;193;5;75;124;1;75;0;0;75;0;0;0
030900017;370;385;385;2;168;236;1;133;5;1;127;35;1;34
030900018;90;86;86;5;37;52;1;37;0;0;37;0;0;0
030900019;50;30;31;7;20;29;1;20;0;0;20;0;0;0
030900020;600;612;612;6;202;439;1;160;8;1;151;42;2;40
030900021;180;188;188;8;139;40;1;139;8;1;130;0;0;0
030900022;150;147;147;2;67;82;1;67;2;0;65;0;0;0
030900023;330;345;345;7;126;217;1;112;7;1;104;14;0;14
030900024;300;310;310;2;133;166;1;133;3;2;128;0;0;0
030900025;250;265;265;1;111;138;1;111;9;2;100;0;0;0
030900026;30;13;13;0;13;17;0;13;0;0;13;0;0;0
031300001;600;650;650;3;287;314;1;285;6;7;272;2;0;2
031300002;600;648;650;5;314;402;1;197;3;8;186;117;5;112
031300003;800;835;835;4;341;531;1;268;13;2;253;73;3;70
031300004;900;913;913;0;333;632;1;267;17;5;245;66;2;64
031300005;900;983;983;8;381;526;1;373;34;4;335;8;0;8
031300006;1000;1064;1064;0;413;620;1;379;24;3;352;34;3;31
031300007;800;835;836;2;312;567;1;232;16;5;211;80;4;76
031300008;500;568;568;6;225;298;1;201;8;2;191;24;3;21
031300009;700;714;714;4;314;388;2;310;18;2;290;4;0;4
031300010;600;694;612;5;201;402;2;196;20;0;176;5;0;5
031300011;400;534;534;4;201;216;13;171;12;2;157;30;0;30
031300012;500;569;571;3;221;292;1;207;14;0;193;14;0;14
031300013;600;603;603;1;240;397;2;201;13;4;184;39;1;38
031300014;700;685;686;3;304;439;1;260;13;2;245;44;1;43
031300015;700;731;731;3;350;354;2;344;28;1;315;6;0;6
031300016;200;177;177;4;78;121;1;78;4;1;73;0;0;0
031300017;100;55;55;7;39;60;1;39;1;1;37;0;0;0
031300018;200;188;187;1;87;112;1;87;1;2;84;0;0;0
031300019;100;43;43;4;30;69;1;30;0;0;30;0;0;0
031300020;400;439;440;2;145;287;1;112;2;3;107;33;0;33
031300021;200;145;145;5;65;134;1;65;0;0;65;0;0;0
031300022;500;573;574;5;321;197;1;302;9;0;293;19;0;19
031300023;600;634;634;0;185;446;1;153;7;2;144;32;1;31
031300024;800;828;828;3;220;605;1;194;18;1;175;26;0;26
031300025;700;745;745;2;287;462;2;236;13;3;220;51;1;50
031300026;200;158;158;2;80;119;1;80;2;0;78;0;0;0
031300027;500;589;589;1;236;317;2;181;4;6;171;55;3;52
031300028;300;296;297;3;155;144;1;155;4;2;149;0;0;0
031300029;100;45;45;0;27;72;1;27;1;0;26;0;0;0
031300030;100;20;20;1;21;79;0;21;0;0;21;0;0;0
031300031;100;23;23;0;22;78;0;22;1;0;21;0;0;0
031400001;800;800;800;7;315;505;1;294;30;3;261;21;1;20
031400002;1000;1039;1041;5;218;814;1;185;15;1;169;33;1;32
031400003;900;958;961;4;309;647;1;252;4;3;245;57;4;53
031400004;500;537;537;1;199;364;1;135;5;3;127;64;4;60
031400005;800;810;810;4;270;581;1;218;9;4;205;52;0;52
031400006;700;718;718;2;255;533;2;165;9;5;151;90;7;83
031400007;700;712;712;8;312;495;6;199;5;3;191;113;4;109
031400008;700;763;764;5;356;428;1;271;10;3;258;85;0;85
031400009;600;665;665;10;304;402;1;197;2;2;193;107;3;104
031400010;500;370;370;6;172;345;1;154;10;2;142;18;0;18
031400011;300;237;235;4;204;95;1;204;8;3;193;0;0;0
031600001;400;495;499;8;212;211;1;188;9;0;179;24;1;23
031600002;300;418;418;7;173;148;1;151;1;5;145;22;0;22
031600003;500;596;604;8;260;239;1;260;25;1;234;0;0;0
031600004;800;743;748;5;336;503;1;296;11;1;284;40;1;39
031600005;600;560;565;6;286;372;1;227;4;3;220;59;4;55
031600006;500;543;548;7;282;229;1;270;6;1;263;12;0;12
031600007;500;199;502;4;199;321;1;178;0;1;177;21;0;21
031600008;400;439;441;1;235;181;1;218;7;2;209;17;2;15
031600009;200;175;175;5;81;118;1;81;0;1;80;0;0;0
031600010;200;157;157;3;69;130;1;69;0;1;68;0;0;0
031600011;300;308;309;7;148;150;2;148;1;2;145;0;0;0
031600012;200;177;177;7;102;97;1;102;5;1;96;0;0;0
031600013;100;46;46;7;33;66;1;33;0;0;33;0;0;0
031600014;100;83;84;7;52;47;1;52;0;3;49;0;0;0
031600015;400;454;456;5;204;206;1;193;0;4;189;11;0;11
031600016;600;663;664;6;283;327;1;272;3;4;265;11;1;10
031600017;100;53;53;7;40;59;1;40;3;0;37;0;0;0
031600018;500;470;472;5;162;337;1;162;2;1;159;0;0;0
031600019;500;518;518;4;140;359;1;140;7;1;132;0;0;0
031600020;700;762;766;8;287;433;1;266;8;1;257;21;1;20
031600021;800;826;832;8;293;529;1;270;11;0;259;23;0;23
031600022;700;734;741;7;356;392;1;307;3;3;301;49;1;48
031600023;500;596;590;8;239;269;4;227;12;3;212;12;0;12
031600024;300;307;308;2;130;169;1;130;7;2;121;0;0;0
031600025;600;564;564;7;193;429;1;170;6;2;162;23;1;22
031600026;600;656;658;3;220;405;1;194;6;0;188;26;0;26
031600027;400;423;423;4;143;256;1;143;13;2;128;0;0;0
031600028;100;24;24;0;24;75;1;24;0;0;24;0;0;0
031600029;100;22;22;2;23;76;1;23;0;0;23;0;0;0
032400001;600;647;648;7;196;483;1;116;3;1;112;80;3;77
032400002;500;492;492;4;154;396;1;103;3;3;97;51;2;49
032400003;550;564;565;8;202;431;2;117;2;3;112;85;4;81
032400004;650;655;655;5;218;503;2;145;7;3;135;73;4;69
032400005;500;533;533;7;178;397;2;101;1;2;98;77;0;77
032400006;800;804;804;4;297;612;2;186;4;6;176;111;3;108
032400007;700;701;701;6;267;538;1;161;4;0;157;106;5;101
032400008;500;515;515;4;169;386;1;113;7;2;104;56;5;51
032400009;550;524;526;7;186;438;1;111;2;2;107;75;3;72
032400010;750;736;737;7;264;578;1;171;3;1;167;93;2;91
032400011;700;714;720;8;235;544;2;154;2;2;150;81;3;78
032400012;1000;1029;1030;0;293;739;1;260;38;2;220;33;0;33
032400013;700;691;699;5;228;551;1;148;2;7;139;80;3;77
032400014;700;703;705;4;258;538;2;160;4;1;155;98;0;98
032400015;600;598;601;9;191;466;1;133;5;3;125;58;1;57
032400016;600;601;601;3;218;462;1;137;3;3;131;81;5;76
032400017;900;886;900;6;150;778;1;121;18;0;103;29;2;27
032400018;350;336;341;3;121;248;1;101;5;4;92;20;0;20
032400019;650;689;695;5;232;433;2;215;25;0;190;17;1;16
032400020;130;128;128;11;51;78;1;51;2;1;48;0;0;0
032400021;190;181;181;5;84;105;1;84;6;3;75;0;0;0
032400022;60;50;50;7;37;22;1;37;0;0;37;0;0;0
032400023;130;117;117;6;62;67;1;62;0;3;59;0;0;0
032400024;90;78;78;6;42;47;1;42;0;2;40;0;0;0
032400025;100;93;93;5;54;44;2;54;1;5;48;0;0;0
032400026;240;226;228;7;119;120;1;119;5;1;113;0;0;0
032400027;50;34;35;4;23;26;1;23;0;0;23;0;0;0
032400028;700;723;724;5;287;412;1;287;21;2;264;0;0;0
032400029;400;374;374;4;170;231;1;168;4;0;164;2;0;2
032400030;500;520;520;5;210;291;2;207;7;1;199;3;0;3
032400031;250;200;208;4;91;158;1;91;3;0;88;0;0;0
032400032;650;688;694;5;236;426;2;222;12;0;210;14;1;13
032400033;400;376;379;3;111;306;1;93;5;0;88;18;0;18
032400034;40;21;22;5;19;20;1;19;1;0;18;0;0;0
032400035;350;320;323;3;154;189;7;154;6;0;148;0;0;0
032400036;300;298;298;2;97;202;1;97;3;1;93;0;0;0
032400037;650;660;660;2;226;446;1;203;9;1;193;23;1;22
032400038;400;371;371;7;144;291;1;108;4;4;100;36;1;35
032400039;150;136;136;4;92;57;1;92;2;4;86;0;0;0
032400040;220;223;224;4;91;126;3;91;3;5;83;0;0;0
032400041;230;228;228;3;101;127;2;101;5;2;94;0;0;0
032400042;250;235;236;6;140;109;1;140;7;6;127;0;0;0
032400043;60;33;34;6;24;35;1;24;1;0;23;0;0;0
032400044;50;32;32;0;29;20;1;29;1;0;28;0;0;0
032400045;70;30;30;0;29;40;1;29;0;0;29;0;0;0
032400046;40;12;12;6;10;29;1;10;0;0;10;0;0;0
032600001;700;855;857;3;406;385;1;314;8;6;300;92;7;85
032600002;600;729;730;3;315;360;7;233;6;2;225;82;3;79
032600003;700;890;891;5;345;410;1;289;12;9;268;56;3;53
032600004;700;900;902;3;379;368;1;331;32;7;292;48;0;48
032600005;600;729;731;1;342;317;1;282;7;8;267;60;2;58
032600006;500;612;613;4;199;315;1;184;13;0;171;15;1;14
032600007;500;522;522;2;246;300;1;199;3;1;195;47;1;46
032600008;200;222;225;5;80;119;1;80;0;1;79;0;0;0
032600009;200;146;149;5;113;86;1;113;2;2;109;0;0;0
032600010;200;119;118;7;87;112;1;87;2;0;85;0;0;0
032600011;400;306;307;7;219;180;1;219;0;5;214;0;0;0
032600012;200;176;176;4;124;75;1;124;3;3;118;0;0;0
032600013;400;358;360;2;195;204;1;195;4;6;185;0;0;0
032600014;100;12;12;0;11;88;1;11;0;0;11;0;0;0
040400001;600;600;602;10;227;489;1;110;4;5;101;117;5;112
040400002;900;915;916;12;304;643;1;256;16;3;237;48;0;48
040400003;700;793;793;8;312;420;1;279;21;5;253;33;0;33
040400004;500;536;537;8;236;360;1;139;0;4;135;97;4;93
040400005;100;72;72;28;35;63;2;35;0;7;28;0;0;0
040400006;300;369;370;11;128;242;1;57;1;1;55;71;0;71
040400007;400;471;473;8;162;333;1;66;1;2;63;96;4;92
040400008;500;501;501;22;205;402;1;97;2;5;90;108;5;103
040400009;500;562;558;8;171;431;2;67;0;1;66;104;4;100
040400010;700;740;744;8;231;609;1;90;1;3;86;141;4;134
040400012;700;750;751;10;271;576;1;123;4;3;116;148;10;138
040400013;600;629;629;9;244;493;1;106;0;2;104;138;4;131
040400014;400;466;467;9;212;311;1;88;3;3;82;124;3;121
040400015;400;450;452;20;209;314;1;85;1;5;79;124;9;115
040400016;400;435;439;10;156;334;1;65;3;3;59;91;2;89
040400017;400;390;391;6;159;321;1;78;2;1;75;81;4;77
040400018;400;406;406;4;183;307;1;92;2;2;88;91;5;86
040400019;500;515;515;9;225;419;1;80;1;1;78;145;9;136
040400020;600;640;640;6;311;483;1;116;1;10;105;195;10;185
040400021;600;623;623;8;277;490;2;108;5;5;98;169;8;161
040400022;500;500;504;7;227;416;2;82;0;3;79;145;2;143
040400023;400;407;409;6;163;331;1;68;1;1;66;95;6;89
040400024;600;657;657;11;245;469;1;130;4;3;123;115;5;110
040400025;900;922;922;4;408;763;1;136;1;11;124;272;19;253
040400026;400;402;402;6;153;324;2;74;2;0;72;79;5;74
040400027;400;445;446;9;183;314;1;85;0;1;84;98;3;95
040400028;400;399;400;7;139;349;1;50;0;2;48;89;2;87
040400029;400;425;425;5;165;341;1;58;0;3;55;107;9;98
040400030;600;656;656;10;267;485;1;114;4;2;108;153;6;147
040400031;500;554;554;5;209;385;1;114;1;3;110;95;4;91
040400032;600;691;692;5;256;480;1;119;3;6;110;137;4;133
040400033;600;688;691;9;272;460;1;139;3;4;132;133;4;129
040400034;700;715;716;8;278;568;1;131;1;4;126;147;9;138
040400035;800;842;842;6;354;630;2;168;4;5;159;186;16;170
040400036;600;687;688;5;236;518;1;81;1;4;76;155;11;144
040400037;500;580;581;7;219;414;1;85;2;3;80;134;4;130
040400038;500;591;590;9;203;404;1;95;2;2;91;108;1;107
040400039;600;605;606;8;281;485;1;114;3;6;105;167;5;162
040400040;700;717;717;8;309;524;2;174;2;8;164;135;5;130
040400041;600;655;656;9;263;486;1;113;3;0;110;150;5;145
040400042;700;695;700;7;311;544;3;153;6;3;144;158;3;155
040400043;600;671;672;5;255;482;1;117;2;1;114;138;7;131
040400044;700;770;770;8;332;556;1;143;4;5;134;189;7;182
040400045;400;439;441;6;165;329;2;69;1;2;66;96;7;89
040400046;400;485;487;5;176;315;1;84;1;2;81;92;5;87
040400047;500;575;576;7;204;414;1;85;1;5;79;119;2;116
040400048;600;646;648;12;232;491;1;108;3;2;103;124;2;122
040400049;700;708;715;10;240;591;1;108;0;2;106;132;8;124
040400050;600;620;620;9;280;483;2;115;1;4;110;165;6;159
040400051;700;782;781;7;284;536;1;163;4;0;159;121;6;115
040400052;800;833;833;12;315;614;1;185;4;9;172;130;5;125
040400053;500;574;577;9;243;407;1;92;3;1;88;151;14;137
040400054;700;730;736;9;234;600;1;99;2;2;95;135;9;126
040400055;500;554;555;8;212;408;1;91;1;2;88;121;5;116
040400056;600;607;607;7;221;498;1;101;1;2;98;120;4;116
040400057;500;572;575;15;211;394;2;104;0;4;100;107;9;98
040400058;800;830;831;8;346;653;1;146;2;4;140;200;10;190
040400059;900;945;948;8;350;756;1;143;5;8;130;207;6;201
040400060;700;745;751;10;290;547;2;151;1;7;143;139;5;134
040400061;700;795;798;9;302;578;1;121;3;1;117;181;9;172
040400062;900;983;984;6;348;755;1;144;1;5;138;204;6;198
040400063;800;847;848;9;310;674;1;125;2;1;122;185;21;164
040400064;800;894;896;7;327;623;1;176;0;2;174;151;4;147
040400065;600;628;628;4;200;489;1;110;1;1;108;90;4;86
040400066;500;537;537;6;176;408;1;91;2;0;89;85;2;83
040400067;800;860;863;8;266;546;1;253;5;8;240;13;0;13
040400068;400;458;461;4;136;340;1;59;1;1;57;77;5;72
040400069;400;450;452;4;145;324;1;75;2;3;70;70;5;65
040400070;600;675;679;5;222;491;1;108;2;6;100;114;5;109
040400071;800;848;852;7;310;649;1;150;2;1;147;160;9;151
040400072;600;686;688;6;291;440;1;159;3;3;153;132;2;130
040400073;700;735;741;6;244;606;1;93;2;0;91;151;4;147
040400074;600;683;684;6;216;509;1;90;1;5;84;126;4;122
040400075;400;483;483;4;182;321;1;78;3;1;74;104;5;99
040400076;700;714;714;7;252;586;3;111;1;0;110;141;6;135
040400077;500;576;579;5;236;417;1;82;1;5;76;154;6;148
040400078;600;683;683;8;227;491;1;108;1;3;104;119;6;113
040400079;600;603;603;6;164;514;1;85;0;3;82;79;0;79
040400080;400;395;395;1;95;363;1;36;2;1;33;59;3;56
040400081;700;725;727;6;211;577;1;122;4;4;114;89;8;81
040400082;100;123;123;4;57;41;2;57;8;0;49;0;0;0
040400083;600;615;615;5;219;517;1;82;0;6;76;137;6;131
040400084;800;810;810;8;360;671;1;128;2;4;122;232;11;221
040400085;900;917;915;11;398;784;1;115;2;4;109;283;14;269
040400086;400;385;385;9;157;335;1;64;0;1;63;93;5;88
040400087;300;367;367;7;164;236;2;62;0;2;60;102;5;97
040400088;400;486;488;8;199;214;1;185;0;6;179;14;0;14
040400089;600;637;639;6;264;501;1;98;1;3;94;166;10;156
040400090;500;547;540;7;175;433;1;66;4;2;60;109;5;104
040400091;400;458;456;6;180;303;1;96;1;1;94;84;3;81
040400092;400;492;493;7;133;337;1;62;6;1;55;71;2;69
040400095;600;645;646;9;220;499;1;100;1;4;95;120;12;108
040400096;500;591;591;7;204;295;1;204;5;0;199;0;0;0
040400097;200;137;137;4;98;101;1;98;4;4;90;0;0;0
040400098;200;244;245;4;77;122;1;77;2;3;72;0;0;0
040400099;300;265;265;3;118;181;1;118;4;2;112;0;0;0
040400100;200;234;233;6;115;84;1;115;6;1;108;0;0;0
040400101;300;258;259;2;79;220;1;79;3;0;76;0;0;0
040400102;400;472;472;4;183;271;1;128;2;2;124;55;4;51
040400103;300;302;302;2;96;203;1;96;3;5;88;0;0;0
040400104;400;461;463;3;129;299;1;100;4;1;95;29;2;27
040400105;300;260;262;12;169;130;1;169;5;6;158;0;0;0
040400106;400;448;448;1;133;310;1;89;2;4;83;44;2;41
040400107;400;380;381;3;133;323;1;76;3;4;69;57;6;51
040400108;400;383;385;4;115;326;1;73;0;0;73;42;1;41
040400109;200;229;231;4;116;83;1;116;2;5;109;0;0;0
040400110;200;173;173;3;97;102;1;97;2;0;95;0;0;0
040400111;400;359;359;4;142;336;1;63;0;0;63;79;4;75
040400112;400;408;409;2;173;270;1;129;0;6;123;44;3;41
040400113;100;37;37;7;33;66;1;33;0;1;32;0;0;0
040400114;100;87;87;6;56;43;1;56;1;4;51;0;0;0
040400115;100;64;65;6;55;44;1;55;1;2;52;0;0;0
040400116;400;340;356;3;142;257;1;142;2;4;136;0;0;0
040400117;400;347;348;5;156;275;1;124;0;4;120;32;1;31
040400118;100;73;73;10;54;45;1;54;1;0;53;0;0;0
040400119;100;37;37;8;34;65;1;34;0;1;33;0;0;0
040400120;600;669;671;6;290;437;1;162;7;4;151;128;2;126
040400121;600;603;606;6;201;477;1;122;7;4;111;79;7;72
040400122;600;652;654;3;246;448;1;151;4;5;142;95;4;91
040400123;600;572;573;5;205;497;1;102;2;2;98;103;5;98
040400124;600;588;590;7;220;481;1;118;3;3;112;102;6;96
040400125;300;249;249;5;117;182;1;117;1;4;112;0;0;0
040400126;400;409;409;2;200;277;1;122;9;0;113;78;5;73
040400127;200;153;153;6;73;126;1;73;0;1;72;0;0;0
040400128;600;603;607;6;274;437;1;162;2;9;151;112;10;102
040400129;300;267;267;6;96;203;1;96;2;4;90;0;0;0
040400130;700;704;704;4;252;534;1;165;3;7;155;87;9;78
040400131;600;579;581;3;202;450;1;149;4;3;142;53;3;50
040400132;600;653;654;4;218;405;1;194;10;6;178;24;1;23
040400133;200;117;117;7;96;103;1;96;3;0;93;0;0;0
040400134;200;168;168;3;120;79;1;120;5;2;113;0;0;0
040400135;100;67;67;7;57;39;4;57;0;1;56;0;0;0
040400136;400;349;347;8;99;338;2;60;4;2;54;39;4;35
040400137;100;44;45;7;44;55;1;44;0;2;42;0;0;0
040400138;100;59;59;5;50;49;1;50;2;1;47;0;0;0
040400139;100;56;57;6;49;50;1;49;0;0;49;0;0;0
040400140;100;45;45;3;35;64;1;35;2;0;33;0;0;0
040400141;200;157;157;6;108;91;1;108;1;5;102;0;0;0
040400142;100;30;30;6;26;74;0;26;0;0;26;0;0;0
040400144;200;22;22;50;57;141;2;57;1;0;56;0;0;0
040400149;100;19;19;12;29;70;1;29;5;0;24;0;0;0
040400152;100;12;12;4;16;83;1;16;0;0;16;0;0;0
040400153;100;26;26;6;31;67;2;31;0;0;31;0;0;0
040600002;700;744;745;7;317;553;1;146;0;2;144;171;9;162
040600004;400;464;465;6;163;336;1;63;1;2;60;100;11;89
040600005;500;627;627;9;240;374;1;125;1;7;117;115;6;109
040600006;500;587;587;5;164;413;1;86;1;6;79;78;3;75
040600007;500;521;522;4;225;379;1;120;1;4;115;105;6;99
040600008;500;612;613;7;232;398;1;101;6;4;91;131;2;129
040600009;500;619;621;5;210;410;1;89;0;4;85;121;8;113
040600010;500;660;661;3;249;348;1;151;1;9;141;98;4;94
040600011;500;674;674;8;226;391;1;108;1;5;102;118;8;110
040600012;500;592;593;7;234;402;1;97;0;3;94;137;12;125
040600013;700;726;726;7;269;548;1;151;5;4;142;118;9;109
040600014;500;570;571;4;163;412;1;87;2;3;82;76;4;72
040600015;700;704;715;6;180;588;1;111;7;0;104;69;2;67
040600016;500;644;644;5;190;416;1;83;1;1;81;107;3;104
040600018;500;600;601;5;200;432;1;67;1;1;65;133;2;131
040600019;500;536;538;8;192;384;1;115;4;2;109;77;2;75
040600020;500;554;556;6;199;383;4;113;4;5;104;86;4;82
040600021;500;552;553;9;173;427;1;72;3;2;67;101;2;99
040600022;500;605;606;9;226;387;1;112;0;1;111;114;6;108
040600024;300;343;345;2;116;256;1;43;0;2;41;73;8;65
040600025;500;567;568;6;195;420;1;79;1;2;76;116;8;108
040600026;700;789;793;5;309;561;2;137;0;1;136;172;5;167
040600028;700;754;758;6;237;580;1;119;3;3;113;118;4;114
040600029;500;630;632;7;212;404;2;94;1;3;90;118;5;113
040600030;500;503;505;5;144;424;1;75;1;1;73;69;7;62
040600031;700;759;759;6;266;551;2;147;3;3;141;119;8;111
040600032;700;722;723;4;242;590;1;109;2;0;107;133;8;125
040600033;500;614;614;5;228;376;1;123;3;6;114;105;9;96
040600035;500;568;571;3;175;416;2;82;1;4;77;93;2;91
040600036;500;676;676;5;203;395;1;104;4;1;99;99;6;93
040600037;500;596;597;11;234;372;2;126;0;2;124;108;4;104
040600038;700;224;718;5;229;575;1;124;2;3;119;105;10;95
040600039;500;657;658;3;198;400;1;99;2;3;94;99;1;98
040600041;500;610;610;5;175;398;1;101;6;6;89;74;10;64
040600042;700;770;772;9;235;588;1;111;1;3;107;124;12;112
040600043;500;631;632;3;213;411;1;88;0;10;78;125;1;124
040600045;500;638;639;5;183;419;1;80;2;3;75;103;5;98
040600046;700;719;720;9;222;581;1;118;5;10;103;104;5;99
040600047;100;16;16;31;32;67;1;32;1;2;29;0;0;0
040600050;700;783;783;4;162;618;1;81;1;1;79;81;2;79
040600051;500;697;698;6;220;369;3;128;4;2;122;92;4;88
040600052;500;579;580;6;139;434;1;65;3;0;62;74;3;71
040600053;500;697;697;8;185;361;1;138;9;5;124;47;1;46
040600054;500;659;661;11;180;373;1;126;11;3;112;54;2;51
040600058;400;445;446;2;174;300;1;99;1;3;95;75;4;71
040600059;500;623;626;8;238;357;1;142;4;4;134;96;9;87
040600060;500;633;634;3;216;354;1;145;7;4;134;71;7;64
040600061;800;814;820;5;312;586;1;213;5;6;202;99;7;92
040600063;700;791;792;4;296;468;1;231;6;8;217;65;3;62
040600065;700;761;761;6;293;499;2;199;1;2;196;94;3;91
040600066;500;649;649;5;156;375;1;124;5;0;119;32;0;32
040600067;500;560;561;2;159;400;1;99;3;3;93;60;1;59
040600068;500;504;504;0;148;414;1;85;3;4;78;63;5;58
040600069;500;631;633;1;197;375;2;123;6;2;115;74;4;70
040600070;500;619;620;2;155;402;1;97;1;3;93;58;6;52
040600071;800;845;845;7;119;685;1;114;9;1;104;5;1;4
040600072;200;290;291;4;100;99;1;100;1;0;99;0;0;0
040600073;500;546;548;6;139;360;1;139;6;0;133;0;0;0
040600074;700;727;727;7;105;616;1;83;7;1;75;22;0;22
040600075;500;606;606;6;132;414;1;85;4;3;78;47;3;44
040600076;500;577;579;5;122;412;1;87;1;1;85;35;0;35
040600077;200;217;218;4;92;107;1;92;1;1;90;0;0;0
040600078;100;86;86;4;35;64;1;35;1;0;34;0;0;0
040600079;400;429;429;5;106;314;1;85;0;2;83;21;0;21
040600081;100;56;63;7;28;71;1;28;2;1;25;0;0;0
040600082;300;269;269;5;104;195;1;104;7;0;97;0;0;0
040600083;100;26;26;0;23;76;1;23;0;2;21;0;0;0
041300001;400;775;775;5;269;204;1;195;3;6;186;74;4;70
041300002;400;782;784;4;318;177;1;222;4;9;209;96;3;93
041300003;400;852;853;0;336;173;3;224;4;2;218;112;10;102
041300004;400;699;700;4;285;199;1;200;5;6;189;85;2;83
041300005;400;608;609;0;187;259;1;140;2;5;133;47;8;39
041300006;400;851;853;0;262;210;1;189;4;9;176;73;6;67
041300007;100;37;37;6;28;71;1;28;0;0;28;0;0;0
041300008;100;32;32;7;18;81;1;18;1;0;17;0;0;0
041300009;100;20;20;0;20;79;1;20;1;0;19;0;0;0
041300010;200;251;251;7;144;55;1;144;3;3;138;0;0;0
041300011;100;46;46;7;37;62;1;37;0;1;36;0;0;0
041300012;100;50;50;7;19;80;1;19;0;0;19;0;0;0
041300013;100;86;86;7;69;30;1;69;1;0;68;0;0;0
041300015;100;49;49;8;34;65;1;34;0;0;34;0;0;0
041300016;100;86;86;7;57;41;2;57;14;1;42;0;0;0
041300017;200;167;167;2;73;126;1;73;2;0;71;0;0;0
041300018;400;920;920;4;371;47;1;352;13;5;334;19;0;19
041300019;100;51;51;8;36;63;1;36;0;0;36;0;0;0
041300020;400;984;985;5;205;213;1;186;13;1;172;19;0;19
041300021;100;83;83;5;51;48;1;51;1;1;49;0;0;0
041300022;100;29;30;7;22;77;1;22;2;0;20;0;0;0
041300023;200;116;116;6;62;137;1;62;0;0;62;0;0;0
041300024;100;92;92;7;62;37;1;62;0;1;61;0;0;0
041300025;100;55;55;7;43;56;1;43;0;2;41;0;0;0
041300026;100;49;49;7;38;61;1;38;0;0;38;0;0;0
041300027;100;54;54;7;31;68;1;31;2;0;29;0;0;0
041300028;100;36;36;7;35;64;1;35;1;0;34;0;0;0
041300029;100;51;51;7;34;65;1;34;0;1;33;0;0;0
041400001;400;753;756;1;202;256;1;143;11;5;127;59;3;56
041400002;500;829;830;0;256;280;1;219;18;6;195;37;1;36
041400003;400;577;578;0;181;257;2;141;5;2;134;42;2;40
041400004;300;368;371;3;207;109;1;190;4;1;185;17;0;17
041400005;300;420;419;4;201;138;2;160;7;5;148;41;1;40
041400006;100;68;68;5;53;46;1;53;1;0;52;0;0;0
041400007;100;57;56;7;26;72;2;26;2;0;24;0;0;0
041400008;100;44;44;7;23;76;1;23;0;0;23;0;0;0
041400009;200;112;113;4;57;142;1;57;1;6;50;0;0;0
041400010;100;85;85;6;39;60;1;39;0;8;31;0;0;0
041400011;200;109;109;7;64;135;1;64;1;4;59;0;0;0
041400012;100;36;36;7;16;83;1;16;0;0;16;0;0;0
041400013;100;36;36;7;28;71;1;28;0;0;28;0;0;0
042000001;600;544;546;0;191;483;1;116;3;5;108;75;5;70
042000002;700;700;702;1;206;588;1;111;1;1;109;95;5;90
042000003;600;639;639;3;247;457;1;142;1;6;135;105;5;100
042000005;700;694;694;0;211;585;2;113;7;2;104;98;2;96
042000006;700;709;710;3;246;457;1;242;6;5;231;4;0;4
042000007;900;914;916;4;317;701;1;198;7;8;183;119;7;112
042000009;700;681;681;7;192;594;1;105;1;7;97;87;8;79
042000010;800;786;786;4;255;653;1;146;3;0;143;109;10;99
042000011;600;570;570;3;232;476;1;123;3;2;118;109;11;98
042000012;600;634;634;3;226;474;1;125;4;1;120;101;3;98
042000014;600;554;554;4;218;459;1;140;2;6;132;78;5;73
042000015;400;408;409;4;147;295;1;104;6;3;95;43;0;43
042000016;600;656;656;2;258;419;1;180;7;7;166;78;6;72
042000018;700;848;852;0;216;523;1;176;15;2;159;40;0;40
042000019;700;692;696;5;243;507;2;191;11;6;174;52;3;49
042000020;600;607;608;4;222;433;1;166;0;3;163;56;2;54
042200001;500;555;555;5;178;373;1;126;4;6;116;52;2;50
042200002;500;605;602;3;223;355;1;144;1;5;138;79;4;75
042200003;400;419;423;3;134;330;1;69;2;1;66;65;4;61
042200004;500;539;539;1;203;298;1;201;4;7;190;2;0;2
042200005;400;409;413;7;169;314;1;85;2;4;79;84;2;82
042200006;500;638;641;5;243;255;2;243;2;13;228;0;0;0
042200007;600;743;744;5;227;465;1;134;4;3;127;93;4;89
042200008;400;453;454;6;165;305;1;94;0;0;94;71;5;66
042200009;600;639;643;6;128;530;1;69;2;4;63;59;6;53
042200010;600;625;626;4;89;540;1;59;4;2;53;30;4;26
042200011;700;868;868;7;142;593;1;106;6;1;99;36;1;35
042200012;500;539;539;9;210;295;1;204;6;4;194;6;1;5
042200013;500;537;540;5;192;388;2;110;7;4;99;82;4;78
042200014;500;575;577;7;179;387;1;112;0;2;110;67;0;67
042200015;100;14;14;22;29;70;1;29;2;0;27;0;0;0
042200016;500;578;583;3;216;370;1;129;2;4;123;87;5;82
042200017;500;553;554;6;189;387;1;112;4;4;104;77;3;74
042200021;500;657;658;6;139;379;1;120;2;2;116;19;0;19
042200022;500;595;596;3;172;361;1;138;5;5;128;34;2;32
042200023;600;717;720;0;249;398;1;201;5;6;190;48;2;46
042200024;500;661;662;0;143;388;1;111;6;0;105;32;0;32
042200025;600;808;813;6;152;478;1;121;8;1;112;31;1;30
042200026;200;190;190;5;82;117;1;82;1;3;78;0;0;0
042200027;600;689;693;4;286;313;1;286;4;4;278;0;0;0
042200028;400;422;423;5;151;258;1;141;10;5;126;10;0;10
042200029;300;295;295;3;132;167;1;132;1;3;128;0;0;0
042200030;400;424;426;4;95;319;1;80;4;0;76;15;0;15
042200031;200;249;251;4;88;111;1;88;2;0;86;0;0;0
042200032;200;290;290;5;116;81;3;116;3;2;111;0;0;0
042200033;500;678;686;4;224;342;1;157;4;5;148;67;3;64
042200034;100;31;31;5;12;87;1;12;4;1;7;0;0;0
042200035;300;311;312;6;150;149;1;150;8;6;136;0;0;0
042200036;400;470;472;4;233;216;1;183;9;5;169;50;1;49
042200037;200;112;113;4;66;133;1;66;2;1;63;0;0;0
042200038;300;388;399;1;105;209;1;90;3;4;83;15;0;15
042200039;600;666;669;1;210;400;1;199;6;0;193;11;0;11
042200040;100;94;94;4;76;23;1;76;1;3;72;0;0;0
042200041;300;305;308;4;158;141;1;158;4;1;153;0;0;0
042200042;200;114;114;6;78;121;1;78;1;6;71;0;0;0
042200043;200;215;217;3;78;120;2;78;3;4;71;0;0;0
042200044;500;580;580;8;162;356;1;143;4;2;137;19;0;19
042200045;100;21;21;1;22;78;0;22;0;0;22;0;0;0
042600001;500;823;823;0;207;370;1;129;6;5;118;78;2;76
042600002;500;698;698;1;184;381;1;118;1;4;113;66;4;62
042600003;500;738;738;2;173;386;2;112;3;3;106;61;1;60
042600004;600;881;881;2;192;451;1;148;7;5;136;44;1;43
042600005;500;745;746;4;210;378;1;121;1;4;116;89;4;85
042600006;500;638;638;3;208;312;1;187;5;4;178;21;0;21
042600007;500;697;698;0;291;212;1;287;11;2;274;4;0;4
042600008;300;403;404;6;107;201;4;95;6;3;86;12;0;12
042600009;200;185;191;3;83;114;3;83;0;0;83;0;0;0
042600010;300;358;369;4;157;168;2;130;2;2;126;27;1;26
042600011;100;93;93;7;39;60;1;39;1;0;38;0;0;0
042600012;300;447;449;2;102;205;1;94;5;3;86;8;1;7
042600013;300;289;292;4;124;175;1;124;2;5;117;0;0;0
042600014;300;364;365;4;168;160;1;139;3;1;135;29;0;29
042600015;200;134;135;6;99;100;1;99;0;0;99;0;0;0
042600016;300;473;474;4;94;228;1;71;3;0;68;23;1;22
042600017;400;605;607;8;124;290;1;109;2;3;104;15;0;15
042600018;500;604;606;5;193;317;1;182;2;0;180;11;0;11
042600019;600;709;709;0;297;305;1;294;10;1;283;3;0;3
042600020;300;443;443;7;169;157;1;142;7;3;132;27;1;26
042600021;400;567;568;2;160;287;1;112;2;2;108;48;1;47
042600022;100;14;14;0;14;85;1;14;1;0;13;0;0;0
042600023;200;85;85;16;80;119;1;80;1;0;79;0;0;0
042800001;500;654;654;4;187;343;1;156;4;5;147;31;2;29
042800002;300;429;429;5;170;205;1;94;1;4;89;76;7;69
042800003;300;453;454;4;120;219;1;80;4;0;76;40;2;38
042800005;500;614;616;4;221;369;1;130;3;4;123;91;5;86
042800006;300;424;425;5;178;208;1;91;4;1;86;87;3;84
042800007;500;662;663;4;256;367;1;132;3;2;127;124;4;120
042800009;500;673;675;8;188;321;1;178;6;3;169;10;0;10
042800010;400;541;541;5;165;298;1;101;1;2;98;64;0;64
042800011;400;521;524;9;190;306;2;92;3;3;86;98;4;94
042800012;400;507;508;6;239;290;1;109;1;3;105;130;8;122
042800013;300;463;463;3;181;203;1;96;1;6;89;85;0;85
042800014;300;379;381;7;127;236;1;63;4;1;58;64;4;60
042800016;400;518;522;7;182;314;1;85;3;3;79;97;5;92
042800017;600;752;754;3;296;311;2;287;8;14;265;9;0;9
042800018;500;612;615;5;201;379;1;120;4;6;110;81;6;75
042800019;400;480;481;9;175;303;1;96;5;4;87;79;2;77
042800020;500;657;659;8;204;396;1;103;1;4;98;101;3;98
042800021;600;734;736;4;294;465;1;134;5;5;124;160;12;148
042800022;400;581;584;3;220;280;2;118;4;4;110;102;5;97
042800023;400;590;591;8;184;290;2;108;1;6;101;76;5;71
042800024;500;630;632;5;231;366;1;133;1;6;126;98;7;91
042800025;300;479;481;8;156;212;1;87;0;3;84;69;1;68
042800026;400;561;561;5;187;300;2;98;1;7;90;89;3;86
042800029;100;14;14;12;21;78;1;21;0;1;20;0;0;0
042800030;200;88;63;25;86;113;1;86;22;1;63;0;0;0
042800031;600;721;722;7;246;453;1;146;6;8;132;100;5;95
042800032;500;598;601;6;208;359;1;140;7;4;129;68;1;67
042800033;400;499;499;6;186;300;1;99;2;3;94;87;3;84
042800034;700;1054;1056;8;327;486;2;212;10;4;198;115;3;112
042800035;600;698;700;9;200;483;1;116;1;6;109;84;7;77
042800041;300;408;409;1;134;183;1;116;2;1;113;18;0;18
042800044;200;131;131;3;84;114;2;84;7;1;76;0;0;0
042800047;700;872;873;3;270;510;1;189;9;8;172;81;3;78
042800050;600;741;743;4;234;437;2;161;5;5;151;73;2;71
042800053;200;275;275;1;93;106;1;93;2;3;88;0;0;0
042800056;200;87;87;6;62;137;1;62;0;5;57;0;0;0
042800058;300;433;434;3;229;120;2;178;8;1;169;51;2;49
042800062;700;944;945;3;255;494;3;203;11;8;184;52;1;51
042800065;600;758;758;3;264;383;1;216;10;3;203;48;1;47
042800069;400;495;495;2;148;290;1;109;4;4;101;39;1;38
042800070;400;565;565;4;147;273;1;126;8;4;114;21;1;20
042800071;200;17;17;34;49;150;1;49;0;2;47;0;0;0
042800073;500;623;624;3;229;326;1;173;1;1;171;56;1;55
042800074;400;527;531;4;180;273;1;126;1;6;119;54;2;52
042800078;200;201;201;5;45;154;1;45;2;1;42;0;0;0
042800080;400;474;478;5;162;259;1;140;3;7;130;22;0;22
042800083;700;876;876;3;400;418;1;281;3;6;272;119;2;117
042800086;200;211;211;5;82;117;1;82;3;2;77;0;0;0
042800087;500;715;715;4;242;342;1;157;7;5;145;85;4;81
042800088;400;535;537;4;194;287;1;112;3;7;102;82;3;79
042800089;400;519;520;9;173;316;2;82;3;1;78;91;7;84
042800090;500;740;740;9;220;371;1;128;2;3;123;92;7;85
043100001;600;735;736;2;254;458;1;141;3;7;131;113;9;104
043100002;600;740;741;2;251;448;1;151;2;4;145;100;5;95
043100003;600;860;861;4;232;438;1;161;13;8;140;71;3;68
043100004;600;1017;1017;1;194;466;1;133;8;0;125;61;1;60
043100005;600;878;878;0;194;507;1;92;2;5;85;102;10;92
043100006;500;610;610;6;216;283;1;216;10;0;206;0;0;0
043100007;300;356;358;2;115;208;1;91;6;0;85;24;1;23
043100008;100;82;82;4;52;47;1;52;0;0;52;0;0;0
043100009;300;334;334;1;103;208;1;91;3;9;79;12;3;9
043100010;400;553;554;3;63;347;1;52;5;2;45;11;0;11
043100011;200;216;216;5;96;103;1;96;6;2;88;0;0;0
043100012;200;192;193;6;98;101;1;98;3;7;88;0;0;0
043100013;500;592;593;4;208;320;1;179;5;3;171;29;0;29
043100014;500;656;656;3;280;249;3;248;19;4;225;32;0;32
043100015;500;602;602;7;225;273;2;225;10;5;210;0;0;0
043100016;500;604;604;5;191;336;2;162;17;4;141;29;4;25
043100018;100;25;25;4;17;82;1;17;1;1;15;0;0;0
043100019;200;233;233;2;99;100;1;99;1;2;96;0;0;0
043100020;200;124;124;6;62;137;1;62;2;1;59;0;0;0
043100021;100;42;42;8;21;78;1;21;0;1;20;0;0;0
043100022;200;139;139;5;48;151;1;48;1;2;45;0;0;0
043100023;100;62;62;7;33;66;1;33;0;1;32;0;0;0
043100026;400;521;522;2;126;296;1;103;3;3;97;23;0;23
043100030;500;578;579;4;179;363;1;136;12;3;121;43;0;43
043200001;200;466;471;0;135;87;1;112;2;1;109;23;1;22
043200002;200;555;566;4;217;12;1;187;8;9;170;30;2;28
043200003;200;486;495;0;186;57;1;142;2;3;137;44;2;42
043200004;100;55;55;8;28;71;1;28;0;0;28;0;0;0
043200005;100;45;45;8;32;67;1;32;0;0;32;0;0;0
043200006;100;143;144;7;68;30;2;68;2;1;65;0;0;0
043200007;100;75;79;6;55;44;1;55;1;1;53;0;0;0
043200008;100;72;72;5;39;60;1;39;0;0;39;0;0;0
043200009;100;21;21;0;21;78;1;21;1;1;19;0;0;0
043200010;100;12;12;13;19;80;1;19;2;1;16;0;0;0
050100001;400;497;497;2;177;279;3;118;2;3;113;59;2;57
050100002;200;388;389;3;165;87;1;112;0;5;107;53;1;52
050100003;300;415;417;1;162;180;1;119;3;2;114;43;0;43
050100004;300;325;327;0;123;231;1;68;2;5;61;55;3;52
050100005;400;481;483;1;177;299;1;100;0;3;97;77;4;73
050100006;500;645;647;0;233;334;1;165;3;11;151;68;7;61
050100007;500;666;666;0;205;346;1;153;6;6;141;52;3;49
050100008;800;936;938;3;477;323;3;474;34;5;435;3;0;3
050100009;100;65;66;8;25;74;1;25;1;0;24;0;0;0
050100010;100;82;82;7;57;42;1;57;0;0;57;0;0;0
050100011;200;172;172;6;77;122;1;77;3;0;74;0;0;0
050100012;100;50;50;8;28;71;1;28;0;1;27;0;0;0
050100013;100;54;54;7;18;81;1;18;0;0;18;0;0;0
050100014;100;92;92;5;59;40;1;59;1;6;52;0;0;0
050100015;100;29;29;8;19;80;1;19;2;0;17;0;0;0
050100016;100;36;36;6;21;78;1;21;1;0;20;0;0;0
050100017;100;91;91;5;48;50;2;48;0;1;47;0;0;0
050100018;100;32;32;8;24;75;1;24;0;0;24;0;0;0
050300001;300;315;315;2;180;119;1;180;5;6;169;0;0;0
050300002;100;80;80;7;54;45;1;54;3;0;51;0;0;0
050300003;100;56;56;4;29;70;1;29;0;0;29;0;0;0
050300004;100;15;15;7;15;84;1;15;0;0;15;0;0;0
050300005;200;233;233;3;118;81;1;118;6;2;110;0;0;0
050600001;500;508;515;1;262;271;1;228;6;15;207;34;0;34
050600002;500;445;445;4;220;338;1;161;6;9;146;59;6;53
050600003;500;441;450;0;230;326;1;173;3;9;161;57;4;53
050600004;500;435;441;3;216;319;2;179;7;10;162;37;2;35
050600005;300;278;283;2;154;145;1;154;1;3;150;0;0;0
050600006;100;86;86;6;66;33;1;66;2;2;62;0;0;0
050600007;500;441;470;2;203;345;1;154;7;5;142;49;3;46
050600008;200;222;223;1;138;61;1;138;4;2;132;0;0;0
050600009;300;279;279;4;134;164;2;134;2;8;124;0;0;0
050600010;200;170;171;4;104;96;0;104;3;5;96;0;0;0
050600011;300;284;284;6;155;143;2;155;1;7;147;0;0;0
050600012;200;137;160;3;79;120;1;79;3;2;74;0;0;0
050600013;100;42;42;0;42;57;1;42;1;0;41;0;0;0
050600014;100;31;31;2;33;65;2;33;2;1;30;0;0;0
050600015;100;28;28;0;28;71;1;28;0;0;28;0;0;0
050900001;400;330;330;6;100;300;1;99;6;0;93;1;0;1
050900002;500;531;531;8;162;388;1;111;3;6;102;51;0;51
050900003;500;461;462;6;153;415;1;84;1;3;80;69;5;64
050900004;500;473;474;5;126;439;1;60;1;3;56;66;4;62
050900005;500;506;506;9;159;421;5;74;2;2;70;85;7;78
050900006;500;588;590;6;180;401;2;97;1;5;91;83;4;79
050900007;500;578;579;8;177;409;1;90;2;2;86;87;5;82
050900008;500;560;560;4;179;390;1;109;1;1;107;70;3;67
050900009;500;468;468;7;159;401;2;97;0;2;95;62;1;61
050900010;500;658;658;6;221;382;1;117;5;3;109;104;5;99
050900011;400;369;369;7;124;346;1;53;0;1;52;71;5;66
050900012;500;595;595;6;226;379;1;120;3;4;113;106;9;97
050900013;500;606;608;7;186;393;1;106;4;4;98;80;5;75
050900014;500;587;587;8;163;414;1;85;2;1;82;78;3;75
050900015;500;497;497;6;135;422;1;77;2;1;74;58;5;53
050900016;500;539;539;6;130;427;1;72;1;3;68;58;6;52
050900017;500;540;540;8;159;340;1;159;3;4;152;0;0;0
050900018;400;436;437;12;133;339;1;60;1;1;58;73;4;69
050900019;400;434;434;7;127;351;1;48;1;4;43;79;2;77
050900020;500;510;511;7;130;439;1;60;1;0;59;70;7;63
050900021;500;474;476;4;132;429;1;70;1;6;63;62;3;59
050900022;500;576;576;9;175;419;1;80;3;5;72;95;4;91
050900023;500;637;638;3;157;409;1;90;6;4;80;67;5;62
050900024;500;524;525;8;155;427;1;72;4;2;66;83;10;73
050900025;500;534;536;9;181;398;1;101;3;6;92;80;4;76
050900026;500;524;524;7;175;423;1;76;1;1;74;99;7;92
050900027;500;656;656;9;237;373;1;126;1;3;122;111;4;107
050900028;500;611;612;7;194;406;1;93;4;1;88;101;3;98
050900029;500;607;607;6;176;398;1;101;5;2;94;75;2;73
050900030;500;488;488;9;135;420;2;78;1;2;75;57;3;54
050900031;500;571;573;6;171;409;1;90;1;1;88;81;4;77
050900032;500;555;556;8;161;399;1;100;5;5;90;61;3;58
050900033;500;542;542;7;154;433;1;66;2;1;63;88;4;84
050900034;500;467;469;10;149;420;1;79;3;2;74;70;7;63
050900035;500;480;480;7;135;411;1;88;3;1;84;47;1;46
050900036;500;569;569;6;182;388;1;111;2;9;100;71;8;63
050900037;500;486;488;6;136;416;1;83;0;2;81;53;1;52
050900038;500;638;640;9;172;405;1;94;1;4;89;78;7;71
050900039;500;586;586;5;162;348;1;151;0;6;145;11;2;9
050900040;500;669;672;10;174;400;1;99;1;4;94;75;4;71
050900041;500;693;694;8;255;352;2;146;6;7;133;109;6;103
050900042;500;530;530;7;146;429;1;70;2;4;64;76;2;74
050900043;500;614;617;9;191;403;2;95;1;1;93;96;1;95
050900044;400;392;393;6;136;335;1;64;3;2;59;72;8;64
050900045;300;241;241;6;85;214;1;85;0;7;78;0;0;0
050900046;500;488;489;5;187;413;1;86;1;1;84;101;9;92
050900047;500;583;584;6;192;398;2;100;2;2;96;92;5;87
050900048;400;426;428;7;184;324;1;75;0;0;75;109;5;104
050900049;400;512;512;7;200;294;1;105;3;2;100;95;3;92
050900050;500;635;635;7;147;427;3;70;2;2;66;77;3;74
050900051;500;586;587;6;144;419;1;80;2;4;74;64;6;58
050900052;500;678;679;7;171;407;1;92;2;0;90;79;3;76
050900053;500;610;611;8;182;397;1;102;3;4;95;80;6;74
050900054;500;559;561;5;125;418;1;81;3;2;76;44;1;43
050900055;500;485;487;9;120;440;2;58;0;2;56;62;3;59
050900056;500;564;565;9;135;425;1;74;4;5;65;61;2;59
050900057;500;619;620;6;177;404;1;95;2;7;86;82;6;76
050900058;500;575;577;7;178;407;1;92;2;1;89;86;6;80
050900059;500;558;559;6;162;403;1;96;3;2;91;66;1;65
050900060;500;486;486;9;152;411;1;88;0;2;86;64;2;62
050900061;500;623;623;7;158;429;1;70;2;1;67;88;2;86
050900062;500;598;601;8;175;415;1;84;6;2;76;91;5;86
050900063;500;578;580;8;169;418;1;81;0;0;81;88;4;84
050900064;500;588;589;8;155;414;2;84;6;3;75;71;4;66
050900065;500;828;828;5;250;360;2;138;2;6;130;112;9;103
050900066;500;597;599;9;184;408;2;90;2;6;82;94;12;82
050900067;500;648;650;10;226;388;1;111;3;2;106;115;7;108
050900068;500;584;584;9;209;403;1;96;3;2;91;113;3;110
050900069;500;705;705;7;152;354;3;143;9;1;133;9;0;9
050900070;500;745;746;9;162;349;1;150;15;1;134;12;0;12
050900071;500;878;879;9;190;325;1;174;29;3;142;16;0;16
050900072;500;507;507;7;110;409;1;90;11;0;79;20;0;20
050900073;500;597;598;8;125;384;1;115;14;3;98;10;1;9
050900074;500;585;585;9;130;376;2;122;19;6;97;8;0;8
050900075;500;745;746;9;149;406;1;93;4;0;89;56;4;52
050900076;500;660;677;5;197;326;2;172;13;3;156;25;2;23
050900077;300;289;289;4;86;212;2;86;1;3;82;0;0;0
050900078;400;388;388;4;116;339;1;60;1;0;59;56;5;51
050900079;500;770;770;4;204;380;1;119;2;3;114;85;6;79
050900080;400;409;409;7;98;309;1;90;8;0;82;8;0;8
050900081;100;108;110;5;68;31;1;68;0;3;65;0;0;0
050900082;100;62;62;6;43;56;1;43;0;1;42;0;0;0
050900083;200;144;144;5;76;122;2;76;1;2;73;0;0;0
050900084;100;38;38;3;33;66;1;33;1;0;32;0;0;0
050900085;100;58;58;8;53;46;1;53;1;0;52;0;0;0
050900086;100;83;83;6;62;37;1;62;1;0;61;0;0;0
050900087;400;454;485;4;153;284;1;115;1;3;111;38;2;36
050900088;500;554;596;5;223;314;3;183;5;8;170;40;1;39
050900089;100;39;39;8;29;70;1;29;0;1;28;0;0;0
050900090;100;96;96;7;63;36;1;63;2;0;61;0;0;0
050900091;200;198;198;3;77;122;1;77;0;0;77;0;0;0
050900092;500;563;565;2;224;329;1;170;2;4;164;54;2;52
050900093;400;391;391;1;149;285;1;114;4;3;107;35;3;32
050900094;400;389;390;2;155;289;1;110;1;3;106;45;4;41
050900095;500;512;515;6;169;376;1;123;5;5;113;46;3;43
050900096;400;447;449;2;146;292;1;107;2;2;103;39;2;37
050900097;300;229;231;5;93;206;1;93;0;3;90;0;0;0
050900098;300;256;258;3;99;200;1;99;1;1;97;0;0;0
050900099;400;421;440;1;185;264;1;135;3;4;128;50;2;48
050900100;300;357;357;3;192;118;1;181;5;5;171;11;0;11
050900101;300;297;298;5;144;155;1;144;1;4;139;0;0;0
050900102;300;296;297;2;157;141;2;157;6;1;150;0;0;0
050900103;400;367;367;13;186;238;1;161;1;3;157;25;0;25
050900104;100;65;66;6;48;51;1;48;1;1;46;0;0;0
050900105;300;267;267;5;151;148;1;151;0;3;148;0;0;0
050900106;500;560;570;2;207;344;1;155;7;7;141;52;0;52
050900107;300;268;278;5;118;181;1;118;6;2;110;0;0;0
050900108;500;602;611;6;175;354;1;145;10;1;134;30;1;29
050900109;500;565;581;7;176;356;2;142;12;4;126;34;5;29
050900110;300;258;258;1;149;149;2;149;2;4;143;0;0;0
050900111;100;59;59;2;46;52;2;46;0;1;45;0;0;0
050900112;200;121;121;3;63;136;1;63;3;5;55;0;0;0
050900113;100;34;34;6;29;70;1;29;0;0;29;0;0;0
050900114;100;36;36;7;30;69;1;30;0;0;30;0;0;0
050900115;100;61;61;4;38;61;1;38;0;1;37;0;0;0
050900116;100;44;44;4;40;59;1;40;0;1;39;0;0;0
050900117;200;110;110;4;56;143;1;56;0;1;55;0;0;0
050900118;500;539;539;3;165;360;1;139;5;6;128;26;2;24
050900119;200;178;179;3;79;120;1;79;2;3;74;0;0;0
050900120;300;275;280;5;127;171;2;127;0;1;126;0;0;0
050900121;100;32;32;20;34;64;2;34;1;1;32;0;0;0
050900122;100;24;24;3;27;72;1;27;0;0;27;0;0;0
050900123;100;20;20;5;25;74;1;25;1;1;23;0;0;0
050900124;100;36;36;4;38;61;1;38;0;0;38;0;0;0
050900125;100;34;34;4;37;62;1;37;2;0;35;0;0;0
050900126;100;31;31;7;38;61;1;38;0;0;38;0;0;0
050900127;100;19;19;9;28;70;2;28;3;0;25;0;0;0
050900128;100;15;15;7;17;82;1;17;1;0;16;0;0;0
050900129;100;11;11;1;9;90;1;9;2;0;7;0;0;0
051500001;200;127;127;3;73;126;1;73;1;1;71;0;0;0
051500002;500;489;489;0;230;310;1;189;6;4;179;41;0;41
051500003;400;405;407;3;183;252;1;147;3;1;143;36;1;35
051500004;100;107;107;3;67;32;1;67;2;3;62;0;0;0
051500005;100;48;48;6;33;66;1;33;1;0;32;0;0;0
051500006;100;31;31;7;21;78;1;21;0;0;21;0;0;0
051500007;100;35;35;6;32;67;1;32;0;1;31;0;0;0
051500008;100;32;32;3;20;79;1;20;0;0;20;0;0;0
051500009;100;29;29;5;29;70;1;29;0;0;29;0;0;0
051600001;400;394;400;5;178;264;1;135;4;6;125;43;0;43
051600002;500;525;531;7;242;308;2;190;10;9;171;52;2;50
051600003;100;32;32;6;28;71;1;28;0;0;28;0;0;0
051600004;200;156;156;5;75;124;1;75;0;0;75;0;0;0
051600005;100;27;28;8;27;72;1;27;0;0;27;0;0;0
051600006;100;40;41;4;32;67;1;32;0;2;30;0;0;0
051600007;100;20;22;3;16;83;1;16;0;0;16;0;0;0
051600008;100;47;50;7;28;71;1;28;0;1;27;0;0;0
051600009;100;46;47;5;40;59;1;40;0;0;40;0;0;0
051600010;100;25;25;6;26;73;1;26;0;0;26;0;0;0
051600011;100;18;18;3;19;80;1;19;0;0;19;0;0;0
051600012;200;124;125;3;79;119;2;79;2;0;77;0;0;0
051600013;100;120;120;0;71;28;1;71;2;1;68;0;0;0
051600014;200;154;154;2;92;107;1;92;18;0;74;0;0;0
051600015;300;297;304;4;148;151;1;148;3;6;139;0;0;0
051600016;300;213;216;0;111;188;1;111;5;2;104;0;0;0
051600017;100;36;36;6;31;68;1;31;0;0;31;0;0;0
051600018;100;41;42;6;33;66;1;33;1;0;32;0;0;0
051600019;100;39;41;6;30;69;1;30;0;0;30;0;0;0
051600020;200;119;120;5;72;126;2;72;1;2;69;0;0;0
051600021;600;772;772;3;367;286;1;313;21;9;283;54;1;53
051600022;600;651;652;2;314;296;1;303;16;1;286;11;1;10
051600023;600;702;707;2;260;376;1;223;21;4;198;37;1;36
051600024;100;69;71;7;59;40;1;59;0;1;58;0;0;0
051600025;100;16;16;8;22;76;2;22;0;1;21;0;0;0
051600026;100;13;13;7;19;79;2;19;0;0;19;0;0;0
051600027;100;44;44;1;44;56;0;44;0;0;44;0;0;0
052200001;500;635;635;1;248;320;1;179;9;5;165;69;9;59
052200002;500;548;549;1;223;311;1;188;8;9;171;35;3;32
052200003;500;619;622;0;227;309;2;189;8;4;177;38;1;37
052200004;500;600;602;2;274;274;1;225;7;9;209;49;5;44
052200005;100;56;57;8;40;59;1;40;2;0;38;0;0;0
052200006;100;35;35;7;32;67;1;32;3;0;29;0;0;0
052200007;100;45;45;5;29;70;1;29;1;0;28;0;0;0
052200008;100;25;27;5;14;85;1;14;0;0;14;0;0;0
052200009;200;205;208;4;96;103;1;96;4;2;90;0;0;0
052200010;300;249;249;5;99;200;1;99;3;1;95;0;0;0
052200011;200;160;160;2;77;122;1;77;1;1;75;0;0;0
052200012;100;36;35;6;37;62;1;37;2;1;34;0;0;0
052200013;100;14;14;1;14;86;0;14;0;0;14;0;0;0
052500001;300;294;301;6;164;135;1;164;5;4;155;0;0;0
052500002;100;34;34;7;25;74;1;25;0;0;25;0;0;0
052500003;100;33;33;6;22;77;1;22;0;0;22;0;0;0
052500004;100;71;71;6;46;53;1;46;0;1;45;0;0;0
052500005;200;146;156;3;82;117;1;82;2;2;78;0;0;0
052500006;300;317;324;2;159;140;1;159;2;4;153;0;0;0
052500007;100;92;93;3;66;33;1;66;3;1;62;0;0;0
052500008;100;27;27;2;24;76;0;24;2;0;22;0;0;0
053000001;300;302;302;2;150;149;1;150;4;2;144;0;0;0
053000002;400;411;412;2;208;274;1;125;3;1;121;83;0;83
053000003;300;291;297;5;177;122;1;177;5;6;166;0;0;0
053000004;200;209;214;3;121;78;1;121;5;1;115;0;0;0
053000005;400;432;436;4;226;209;1;190;4;5;181;36;2;34
053000006;300;228;228;4;128;171;1;128;3;5;120;0;0;0
053000007;200;166;167;4;110;89;1;110;1;2;107;0;0;0
053000008;100;36;36;3;38;61;1;38;0;0;38;0;0;0
053300001;500;586;612;4;350;231;1;268;11;3;254;82;5;77
053300002;200;126;125;1;107;93;0;107;4;1;102;0;0;0
053300003;200;120;121;6;83;116;1;83;1;2;80;0;0;0
053300004;200;148;150;1;64;131;5;64;3;0;61;0;0;0
053300005;100;110;110;4;71;28;1;71;2;2;67;0;0;0
053300006;400;522;522;0;228;191;1;208;9;6;193;20;1;19
053300007;400;520;543;3;248;187;1;212;19;2;191;36;1;35
053300008;200;116;119;2;73;126;1;73;5;1;67;0;0;0
053300009;500;575;581;4;264;271;17;212;16;1;195;52;1;51
053300010;100;76;76;2;44;55;1;44;2;0;42;0;0;0
053300011;100;11;11;2;9;90;1;9;0;0;9;0;0;0
053300012;100;27;27;3;29;70;1;29;0;0;29;0;0;0
053300013;100;33;33;3;35;64;1;35;1;0;34;0;0;0
053700001;200;196;196;1;125;74;1;125;6;3;116;0;0;0
053700002;200;148;149;1;90;109;1;90;2;4;84;0;0;0
053700003;100;68;76;3;57;42;1;57;1;1;55;0;0;0
053700004;200;114;116;2;66;133;1;66;1;1;64;0;0;0
053700005;100;39;39;4;38;61;1;38;1;1;36;0;0;0
053700006;100;104;112;3;68;31;1;68;4;2;62;0;0;0
053700007;200;196;200;0;109;90;1;109;5;3;101;0;0;0
053700008;300;274;274;2;148;151;1;148;9;5;134;0;0;0
053700009;200;123;131;3;60;135;5;60;1;0;59;0;0;0
053700010;100;96;96;2;64;35;1;64;1;1;62;0;0;0
053700011;100;34;34;0;32;68;0;32;5;0;27;0;0;0
060500001;400;461;472;1;218;216;1;183;5;4;174;35;2;33
060500002;400;524;524;2;243;179;1;220;12;8;200;23;2;21
060500003;600;681;694;1;314;317;2;281;12;14;255;33;1;32
060500004;300;299;299;3;164;135;1;164;11;8;145;0;0;0
060500005;400;387;393;6;204;195;10;195;9;2;184;9;1;8
060500006;600;680;698;4;366;239;1;360;4;1;355;6;0;6
060500007;300;391;391;4;224;75;1;224;9;5;210;0;0;0
060500008;300;268;268;4;156;142;2;156;1;2;153;0;0;0
060500009;300;319;326;4;209;90;1;209;6;2;201;0;0;0
060500010;200;179;181;6;121;77;2;121;3;2;116;0;0;0
060500011;100;35;35;2;37;63;0;37;1;0;36;0;0;0
060500012;100;53;53;6;57;43;0;57;1;0;56;0;0;0
060800001;500;538;545;4;268;341;1;158;2;8;148;110;6;104
060800002;500;562;567;6;283;264;1;235;3;10;222;48;1;47
060800003;400;485;487;2;181;272;3;125;2;2;121;56;2;54
060800004;500;516;521;0;218;378;1;121;3;4;114;97;1;96
060800005;400;488;496;1;190;286;1;113;4;4;105;77;3;74
060800006;400;467;479;0;235;265;1;134;0;7;127;101;3;98
060800007;500;549;549;1;222;352;1;147;3;4;140;75;6;69
060800008;600;670;681;5;264;376;1;223;7;2;214;41;5;36
060800009;400;488;492;2;226;244;1;155;2;3;150;71;2;69
060800010;400;471;471;0;227;263;1;136;0;5;131;91;4;87
060800011;400;485;489;2;214;256;1;143;3;8;132;71;4;67
060800012;400;489;493;1;234;165;1;234;4;10;220;0;0;0
060800013;500;586;598;0;227;343;2;155;1;6;148;72;5;67
060800014;600;696;705;3;337;303;1;296;13;1;282;41;0;41
060800015;900;962;962;2;543;365;1;534;11;1;522;9;0;9
060800016;700;747;747;5;339;383;2;315;14;0;301;24;2;22
060800017;500;591;595;1;267;356;1;143;0;7;136;124;5;119
060800018;300;336;339;1;145;199;1;100;1;4;95;45;1;44
060800019;400;501;505;2;247;330;1;69;3;3;63;178;0;178
060800020;200;142;142;3;97;102;1;97;0;2;95;0;0;0
060800021;500;536;557;3;277;236;1;263;8;15;240;14;0;14
060800022;600;584;597;1;330;289;1;310;16;0;294;20;0;20
060800023;300;318;318;5;246;52;2;246;4;1;241;0;0;0
060800024;400;367;368;2;179;235;1;164;4;2;158;15;0;15
060800025;300;254;264;1;190;109;1;190;0;6;184;0;0;0
060800026;600;556;586;1;378;265;1;334;1;11;322;44;1;43
060800027;400;431;469;3;331;71;1;328;0;2;326;3;0;3
060800028;200;124;124;4;79;120;1;79;1;2;76;0;0;0
060800029;220;199;202;5;199;19;2;199;0;0;199;0;0;0
060800030;700;771;797;4;435;300;1;399;15;3;381;36;3;33
060800031;600;625;633;4;342;272;1;327;8;4;315;15;1;14
060800032;400;401;408;2;231;193;5;202;2;5;195;29;0;29
060800033;300;278;278;1;272;27;1;272;0;0;272;0;0;0
060800034;600;586;586;2;348;302;1;297;7;7;283;51;2;49
060800035;600;594;613;3;333;327;1;272;6;13;253;61;1;60
060800036;600;613;633;4;318;325;1;274;13;6;255;44;1;43
060800037;500;482;496;2;277;241;2;257;24;7;226;20;0;20
060800038;600;609;608;1;318;303;2;295;12;7;276;23;1;22
060800039;400;407;408;2;226;201;1;198;7;5;186;28;0;28
060800040;120;94;94;0;94;25;1;94;3;2;89;0;0;0
060800041;100;77;77;0;76;23;1;76;0;2;74;0;0;0
060800042;80;40;40;0;40;39;1;40;2;0;38;0;0;0
060800043;100;55;55;0;55;44;1;55;0;0;55;0;0;0
060800044;80;42;42;1;43;37;0;43;0;1;42;0;0;0
060800045;100;45;45;3;48;51;1;48;0;0;48;0;0;0
060800046;100;11;11;46;52;47;1;52;3;0;49;0;0;0
061000001;300;805;805;6;209;201;1;98;5;0;93;111;5;106
061000002;400;935;935;7;289;288;1;111;2;2;107;178;10;168
061000003;200;538;538;5;154;123;1;76;3;3;70;78;4;74
061000004;200;572;575;0;151;119;1;80;1;2;77;71;3;68
061000005;200;555;556;3;175;114;1;85;4;2;79;90;2;88
061000006;200;652;654;5;182;111;1;88;3;4;81;94;4;90
061000007;200;538;542;7;200;90;1;109;4;0;105;91;1;90
061000008;200;500;503;8;201;93;1;106;2;3;101;95;6;89
061000009;300;781;781;5;252;186;1;113;1;2;110;139;7;132
061000010;200;434;435;7;125;135;1;64;1;6;57;61;6;55
061000011;200;440;440;8;163;138;1;61;0;3;58;102;3;99
061000012;200;554;556;9;197;121;1;78;0;1;77;119;7;112
061000013;300;795;797;8;348;140;3;157;4;8;145;192;9;183
061000014;200;636;637;6;254;66;1;133;3;9;121;121;6;115
061000015;200;523;523;7;168;104;1;95;3;2;90;73;7;66
061000016;300;541;541;8;202;203;1;96;0;4;92;106;13;93
061000017;400;903;903;7;363;194;3;203;5;3;195;160;9;151
061000018;200;581;585;5;216;85;1;114;2;5;107;102;7;95
061000019;200;607;608;8;235;80;1;119;0;5;114;116;2;114
061000020;200;617;617;4;230;80;1;119;4;3;112;111;3;108
061000021;400;1014;1014;9;402;168;2;230;2;7;221;172;7;165
061000022;300;922;923;5;347;127;1;172;1;7;164;175;6;169
061000023;300;789;789;8;307;136;1;163;3;6;154;144;8;136
061000024;400;1063;1063;8;413;181;1;218;3;5;210;195;10;185
061000025;200;571;571;7;208;104;1;95;1;4;90;113;2;111
061000026;300;811;814;9;296;164;1;135;3;7;125;161;5;156
061000027;200;674;674;6;293;54;1;145;1;3;141;148;4;144
061000028;300;715;716;5;273;154;2;144;0;2;142;129;6;123
061000029;200;586;586;7;266;82;1;117;0;3;114;149;8;141
061000030;200;673;674;3;238;75;1;124;1;5;118;114;8;106
061000031;200;582;582;8;221;93;2;105;0;3;102;116;9;107
061000032;300;981;985;9;372;150;1;149;1;3;145;223;10;213
061000033;200;576;578;6;222;85;1;114;2;1;111;108;4;104
061000034;300;823;826;5;334;165;1;134;4;3;127;200;5;195
061000035;200;608;610;23;227;86;1;113;2;5;106;114;6;108
061000036;300;771;771;5;299;160;1;139;2;4;133;160;9;151
061000037;200;438;441;4;188;126;1;73;1;6;66;115;6;109
061000038;200;522;525;8;180;120;1;79;3;1;75;101;2;99
061000039;300;902;903;7;336;137;1;162;2;2;158;174;10;164
061000040;400;572;573;9;236;163;1;236;3;10;223;0;0;0
061000041;200;607;608;6;220;105;2;93;1;4;88;127;7;120
061000042;300;809;810;6;303;150;1;149;1;2;146;154;7;147
061000043;200;477;478;5;160;128;1;71;2;0;69;89;3;86
061000044;300;746;748;7;249;147;1;152;11;1;140;97;7;90
061000045;200;460;460;4;146;122;1;77;3;4;70;69;6;63
061000046;300;743;743;8;232;179;1;120;1;4;115;112;7;105
061000047;200;469;469;6;185;93;1;106;1;2;103;79;5;74
061000048;200;403;403;11;130;131;2;67;1;1;65;63;2;61
061000049;300;711;711;4;208;94;2;204;4;6;194;4;0;4
061000050;200;478;478;8;115;135;1;64;3;0;61;51;3;48
061000051;200;533;538;4;170;121;1;78;0;3;75;92;1;91
061000052;200;509;513;8;145;123;1;76;0;2;74;69;1;68
061000053;200;402;402;8;107;134;1;65;1;1;63;42;3;39
061000054;300;754;754;7;214;197;1;102;1;3;98;112;6;106
061000055;200;661;662;3;193;106;1;93;0;4;89;100;6;94
061000056;200;617;618;4;183;108;1;91;2;1;88;92;7;85
061000057;200;632;633;5;220;95;3;102;4;3;95;118;5;113
061000058;200;633;636;0;170;113;1;86;2;3;81;84;4;80
061000059;200;630;632;4;217;109;1;90;4;6;80;127;7;120
061000060;200;697;697;3;183;106;1;93;8;6;79;90;2;88
061000061;200;598;601;3;210;77;1;122;4;3;115;88;5;83
061000062;200;603;607;4;139;130;1;69;8;1;60;70;5;65
061000063;200;570;571;5;149;117;1;82;0;2;80;67;6;61
061000064;300;736;739;2;202;191;1;108;0;4;104;94;10;84
061000065;300;873;874;3;260;162;2;136;5;3;128;124;2;122
061000066;200;693;694;7;228;96;1;103;1;3;99;125;2;123
061000067;200;554;555;3;158;124;1;75;1;5;69;83;5;78
061000068;200;691;691;9;231;76;1;123;3;5;115;108;6;102
061000069;300;960;960;1;268;190;1;109;2;2;105;159;9;150
061000070;300;754;754;5;243;152;1;147;2;6;139;96;7;89
061000071;200;536;538;4;128;126;1;73;2;0;71;55;0;55
061000072;200;566;570;7;129;105;1;94;2;2;90;35;2;26
061000073;200;566;569;6;141;123;1;76;2;1;73;65;6;59
061000074;300;895;895;4;224;178;7;120;6;3;111;104;0;104
061000075;200;606;608;5;155;118;1;81;1;3;77;74;0;74
061000076;300;954;958;0;231;191;2;107;2;6;99;124;6;118
061000077;200;567;570;4;153;130;1;69;5;2;62;84;3;81
061000078;400;881;882;5;354;178;2;220;3;4;213;134;4;130
061000079;400;816;822;5;302;97;1;302;7;5;290;0;0;0
061000080;200;526;526;22;179;127;1;72;2;2;68;107;8;99
061000081;300;383;402;4;209;132;2;166;4;4;158;43;4;39
061000082;400;524;528;3;197;243;3;154;2;5;147;43;1;42
061000083;500;606;622;4;240;327;1;172;1;9;162;68;2;66
061000084;200;150;151;2;93;106;1;93;3;1;89;0;0;0
061000085;300;328;328;4;186;113;1;186;4;2;180;0;0;0
061000086;300;376;377;3;161;163;1;136;3;0;133;25;0;25
061000087;200;187;187;4;116;83;1;116;2;0;114;0;0;0
061000088;600;837;839;3;283;325;1;274;23;3;248;9;0;9
061000089;300;366;370;6;203;100;1;199;12;1;186;4;0;4
061000090;400;535;535;4;159;249;1;150;4;2;144;9;1;8
061000091;300;391;391;1;161;158;1;141;6;4;131;20;1;19
061000092;100;35;35;4;32;67;1;32;1;2;29;0;0;0
061000093;200;188;188;4;104;95;1;104;3;1;100;0;0;0
061000094;500;629;631;7;225;352;1;147;2;9;136;78;6;72
061000095;500;755;756;5;243;281;1;218;4;9;205;25;2;23
061000096;400;534;534;4;227;231;2;167;7;1;159;60;5;55
061000097;400;539;540;6;165;289;1;110;1;0;109;55;4;51
061000098;200;269;270;3;150;49;1;150;3;3;144;0;0;0
061000099;500;609;621;4;153;381;4;115;3;0;112;38;0;38
061000100;500;582;596;5;114;407;1;92;8;0;84;22;1;21
061000101;400;535;550;4;222;196;1;203;4;2;197;19;0;19
061000102;600;721;739;6;222;411;2;187;6;2;179;35;3;32
061000103;500;580;580;2;184;343;1;156;17;2;137;28;0;28
061000104;100;101;101;4;79;20;1;79;3;2;74;0;0;0
061000105;300;311;312;7;128;185;1;114;2;1;111;14;0;14
061000106;100;10;10;5;15;82;3;15;0;0;15;0;0;0
061000107;100;15;15;0;15;85;0;15;0;0;15;0;0;0
061000108;100;14;14;1;15;84;1;15;2;0;13;0;0;0
061000109;100;18;18;3;21;78;1;21;0;0;21;0;0;0
061000110;100;18;18;5;23;76;1;23;0;1;22;0;0;0
061000111;100;18;18;0;18;82;0;18;0;1;17;0;0;0
061000112;100;39;39;5;44;55;1;44;0;1;43;0;0;0
061000113;100;41;41;0;27;72;1;27;1;2;24;0;0;0
061000114;100;41;41;20;52;47;1;52;5;3;44;0;0;0
061000115;100;28;28;33;52;47;1;52;2;5;45;0;0;0
061000116;100;30;30;8;17;82;1;17;1;0;16;0;0;0
062000001;600;615;617;1;268;471;1;128;3;6;119;140;10;130
062000002;700;786;788;4;287;548;1;151;4;2;145;136;6;130
062000003;500;539;540;4;220;356;1;143;4;8;131;77;4;73
062000004;700;708;710;6;329;548;1;151;2;2;147;178;13;165
062000005;500;555;555;9;227;426;1;73;0;3;70;154;11;143
062000006;700;783;783;4;351;551;2;147;5;4;138;204;13;191
062000007;600;637;637;7;261;484;1;115;2;2;111;146;5;141
062000008;700;717;717;4;293;573;3;124;2;7;115;169;14;155
062000009;700;792;792;1;330;543;1;156;3;8;145;174;12;162
062000010;700;738;738;9;362;559;1;140;1;2;137;222;15;207
062000011;800;880;880;10;406;647;1;152;2;7;143;254;24;230
062000012;700;701;703;9;308;565;1;134;7;3;124;174;11;163
062000013;600;660;663;5;270;389;1;210;11;2;197;60;4;56
062000014;500;585;586;6;226;355;1;144;3;1;140;82;3;79
062000016;600;643;643;5;188;431;1;168;9;0;159;20;3;17
062000017;500;506;529;3;188;381;1;118;0;3;115;70;2;68
062000018;400;474;478;3;183;287;1;112;3;2;107;71;2;69
062000019;400;461;460;0;219;253;1;146;7;1;138;73;6;67
062000020;500;480;480;0;185;363;1;136;8;2;126;49;0;49
062000021;400;464;464;3;205;275;1;124;6;4;114;81;1;80
062000022;700;700;705;1;375;349;1;350;23;2;325;25;0;25
062000023;600;600;599;1;283;325;1;274;15;2;257;9;0;9
062000024;800;801;803;0;323;544;3;253;22;4;227;70;1;69
062000025;700;782;782;2;264;535;1;164;6;7;151;100;3;97
062000026;300;286;286;1;193;106;1;193;6;0;187;0;0;0
062000027;100;43;43;2;44;55;1;44;0;0;44;0;0;0
062100001;400;574;575;4;186;238;1;161;8;2;151;25;0;25
062100002;400;607;609;4;227;209;1;190;7;7;176;37;3;34
062100003;400;663;667;3;246;236;1;163;4;4;155;83;4;79
062100004;500;739;743;3;341;198;1;301;24;3;274;40;3;37
062100005;300;246;251;3;107;191;2;107;6;3;98;0;0;0
062100006;200;149;152;5;87;112;1;87;1;5;81;0;0;0
062100007;400;434;458;3;177;247;1;152;5;4;143;25;0;25
062100008;200;169;169;5;76;122;2;76;0;6;70;0;0;0
062100009;200;213;214;3;152;47;1;152;0;0;152;0;0;0
062100010;300;289;297;2;149;150;1;149;2;1;146;0;0;0
062100011;100;99;99;6;54;45;1;54;2;2;50;0;0;0
062100012;400;567;575;7;189;241;1;158;13;1;144;31;2;29
062100013;400;559;578;4;154;255;1;144;7;1;136;10;0;10
062100014;200;185;186;3;133;66;1;133;1;0;132;0;0;0
062100015;400;470;472;4;270;161;3;236;21;2;213;34;0;34
062100016;600;603;603;4;310;330;3;267;10;3;254;46;3;43
062100017;200;118;123;5;78;121;1;78;1;3;74;0;0;0
062100018;200;138;151;3;95;104;1;95;2;4;89;0;0;0
062100019;80;47;47;0;47;33;0;47;0;0;47;0;0;0
062100020;50;29;29;6;34;16;0;34;1;0;33;0;0;0
062100021;40;17;17;6;23;17;0;23;3;0;20;0;0;0
062100022;30;12;12;5;17;13;0;17;0;0;17;0;0;0
062700001;550;590;592;5;206;458;1;91;0;5;86;115;7;108
062700002;600;639;642;5;206;481;1;118;1;6;111;88;9;79
062700003;600;632;633;2;250;447;1;152;0;7;145;98;4;94
062700004;650;692;694;5;235;526;1;123;4;4;115;112;7;105
062700005;550;617;618;4;233;426;1;123;3;2;118;110;4;106
062700006;550;589;591;7;221;436;1;113;0;4;109;108;3;105
062700007;450;491;491;15;210;314;1;135;4;3;128;75;3;72
062700008;600;674;675;7;263;448;1;151;5;4;142;112;3;109
062700009;500;569;573;1;195;389;1;110;0;6;104;85;10;75
062700010;550;596;599;4;193;461;1;88;4;1;83;105;6;99
062700011;700;762;762;7;241;562;1;137;2;3;132;104;7;97
062700012;750;801;801;7;276;577;1;172;3;6;163;104;11;93
062700013;450;472;474;5;146;357;1;92;4;1;87;54;1;53
062700014;600;667;667;2;228;454;2;144;10;9;125;84;4;80
062700015;400;453;453;1;177;278;1;121;9;2;110;56;2;54
062700016;300;340;340;3;125;174;1;125;4;5;116;0;0;0
062700017;250;225;225;5;74;175;1;74;3;2;69;0;0;0
062700018;150;109;109;4;79;70;1;79;1;1;77;0;0;0
062700019;350;327;327;4;145;229;1;120;0;2;118;25;1;24
062700020;350;405;407;3;148;244;1;105;4;2;99;43;4;39
062700021;350;307;307;2;157;192;1;157;4;12;141;0;0;0
062700022;300;266;266;0;63;236;1;63;0;1;62;0;0;0
062700023;550;573;575;5;169;429;1;120;0;0;120;49;1;48
062700024;650;697;700;6;219;497;2;151;1;8;142;68;3;65
062700025;100;74;74;1;52;47;1;52;1;0;51;0;0;0
062700026;400;418;418;5;131;300;1;99;5;1;93;32;0;32
062700027;300;275;275;5;115;182;3;115;3;6;106;0;0;0
062700028;100;59;58;7;36;63;1;36;2;0;34;0;0;0
062700029;200;191;191;3;81;118;1;81;0;2;79;0;0;0
062700030;250;220;220;6;122;127;1;122;0;4;118;0;0;0
062700031;200;168;168;1;117;82;1;117;4;1;112;0;0;0
062700032;250;221;221;2;120;128;2;120;4;3;113;0;0;0
062700033;550;553;556;1;245;373;2;175;6;5;164;70;1;69
062700034;300;329;330;6;139;174;1;125;3;1;121;14;0;14
062700035;150;105;105;3;61;88;1;61;2;1;58;0;0;0
062700036;100;86;86;7;54;45;1;54;1;1;52;0;0;0
062700037;300;290;290;1;146;153;1;146;5;3;138;0;0;0
062700038;300;251;251;4;125;174;1;125;1;2;122;0;0;0
062700039;100;77;77;5;54;45;1;54;1;7;46;0;0;0
062700040;300;250;252;3;119;180;1;119;2;7;110;0;0;0
062700041;50;32;31;6;24;25;1;24;0;2;22;0;0;0
062700042;250;221;221;7;78;171;1;78;1;2;75;0;0;0
062700043;50;24;24;0;24;25;1;24;0;0;24;0;0;0
062800001;600;671;673;4;244;404;1;195;7;2;186;49;4;45
062800002;500;589;592;3;245;344;1;155;6;3;146;90;3;87
062800003;500;631;638;1;240;328;1;171;4;6;161;69;2;67
062800004;500;560;563;2;200;356;1;143;1;7;135;57;4;53
062800005;100;12;12;4;9;90;1;9;0;1;8;0;0;0
062800006;200;173;174;2;91;107;2;91;6;3;82;0;0;0
062800007;600;660;660;8;274;374;1;225;12;4;209;49;2;47
062800008;400;504;523;5;264;170;2;228;5;4;219;36;1;35
062800009;400;499;505;2;195;229;1;170;7;2;161;25;1;24
062800010;400;531;545;1;244;155;1;244;4;10;230;0;0;0
062800011;400;480;499;4;218;204;1;195;7;1;187;23;0;23
062800012;100;12;12;2;14;86;0;14;0;0;14;0;0;0
062800013;100;32;32;0;32;67;1;32;0;2;30;0;0;0
062800014;100;16;16;2;18;82;0;18;0;2;16;0;0;0
062800015;100;27;27;2;28;71;1;28;4;3;21;0;0;0
063100001;900;1002;1004;0;417;556;1;343;7;4;332;74;7;67
063100002;800;924;925;0;337;543;1;256;4;6;246;81;1;80
063100003;600;730;731;2;235;462;1;137;2;7;128;98;1;97
063100004;500;533;535;5;173;361;1;138;5;1;132;35;1;34
063100005;800;917;918;1;347;491;2;307;6;3;298;40;1;39
063100006;500;514;520;7;163;382;1;117;10;4;103;45;1;44
063100007;500;548;557;7;157;373;1;126;12;1;113;31;0;31
063100008;400;471;483;2;186;239;1;160;4;5;151;26;0;26
063100009;500;551;570;2;205;359;1;140;9;7;124;65;3;62
063100010;500;583;583;6;236;349;1;150;2;4;144;86;5;81
063100011;500;111;513;2;113;383;6;111;5;3;103;2;0;2
063100012;400;451;451;3;140;273;1;126;0;4;122;14;1;13
063100013;200;184;184;1;86;112;2;86;2;1;83;0;0;0
063100014;100;103;104;2;49;50;1;49;1;0;48;0;0;0
063100015;400;429;429;2;155;271;2;127;0;3;124;28;3;25
063100016;200;175;179;6;58;141;1;58;6;1;51;0;0;0
063100017;100;51;51;2;50;50;0;50;0;0;50;0;0;0
063100018;100;33;33;0;32;68;0;32;2;0;30;0;0;0
063200001;300;541;549;1;163;191;1;108;2;3;103;55;5;50
063200002;500;734;741;1;304;271;1;228;6;11;211;76;3;73
063200003;300;454;457;0;128;196;1;103;0;1;102;25;0;25
063200004;300;533;537;2;204;143;1;156;0;6;150;48;1;47
063200005;200;204;205;4;146;53;1;146;2;0;144;0;0;0
063200006;400;457;459;6;209;206;1;193;7;2;184;16;2;14
063200007;300;349;354;1;170;151;1;148;3;3;142;22;0;22
063200008;200;109;120;4;82;117;1;82;0;3;79;0;0;0
063200009;200;260;260;5;150;49;1;150;5;1;144;0;0;0
063200010;300;296;296;2;161;137;2;161;1;3;157;0;0;0
063200011;100;42;42;7;38;61;1;38;1;0;37;0;0;0
063200012;100;87;87;3;59;40;1;59;1;5;53;0;0;0
063200013;200;187;189;4;123;76;1;123;1;4;118;0;0;0
063200014;100;35;36;5;31;68;1;31;0;1;30;0;0;0
063200015;200;209;210;2;137;62;1;137;9;5;123;0;0;0
063200016;100;22;22;0;20;80;0;20;0;0;20;0;0;0
063200017;100;15;15;0;13;87;0;13;0;0;13;0;0;0
063200018;100;34;34;14;43;56;1;43;6;3;34;0;0;0
063500001;400;535;541;1;203;254;1;145;1;8;136;58;3;55
063500002;400;480;492;3;223;244;1;155;5;5;145;68;1;67
063500003;100;48;40;5;40;59;1;40;2;0;38;0;0;0
063500004;300;345;346;1;200;116;2;182;4;2;176;18;0;18
063500005;300;343;344;1;165;134;1;165;1;1;163;0;0;0
063500006;300;440;445;4;175;138;1;161;1;3;157;14;0;14
063500007;300;340;344;0;177;201;1;98;0;4;94;79;0;79
063500008;150;158;159;4;87;62;1;87;1;1;85;0;0;0
063500009;300;297;298;0;115;184;1;115;4;1;110;0;0;0
063500010;300;365;372;1;184;131;1;168;9;5;154;16;0;16
063500011;100;58;58;1;38;61;1;38;0;0;38;0;0;0
063500012;50;23;23;0;22;27;1;22;1;1;20;0;0;0
070500001;800;959;963;3;295;689;1;110;2;1;107;185;6;179
070500002;800;879;880;4;278;671;3;126;2;4;120;152;3;149
070500003;700;697;698;5;197;611;1;88;1;3;84;109;1;108
070500004;400;403;403;7;128;350;2;48;1;1;46;80;2;78
070500005;600;584;584;6;201;501;1;98;2;4;92;103;5;98
070500006;700;693;693;7;220;600;1;99;1;1;97;121;3;118
070500007;600;618;620;9;197;510;1;89;3;1;85;108;4;104
070500008;600;602;602;7;171;523;1;76;1;1;74;95;5;90
070500009;600;637;638;8;172;525;1;74;6;0;68;98;4;94
070500010;700;701;703;7;198;600;1;99;2;2;95;99;4;95
070500011;500;448;450;7;152;428;1;71;0;1;70;81;4;77
070500012;800;827;828;10;202;705;2;93;6;2;85;109;7;102
070500013;600;643;643;6;205;513;1;86;5;1;80;119;4;115
070500014;700;755;755;5;237;612;1;87;2;1;84;150;3;147
070500015;500;547;548;8;169;439;1;60;3;5;52;109;7;102
070500016;600;599;601;8;186;492;1;107;2;2;103;79;5;74
070500017;500;528;528;7;164;431;1;68;4;0;64;96;7;89
070500018;500;550;551;9;171;412;1;87;3;1;83;84;1;83
070500019;800;801;800;10;282;653;1;146;2;5;139;136;10;126
070500020;600;613;614;5;233;490;2;108;2;5;101;125;3;122
070500021;500;523;522;11;185;425;1;74;2;3;69;111;3;108
070500022;500;537;538;8;182;420;1;79;3;5;71;103;1;102
070500023;500;553;554;8;189;407;1;92;0;4;88;97;2;95
070500024;800;912;914;5;279;692;1;107;5;0;102;172;9;163
070500025;700;705;705;8;229;594;3;103;4;1;98;126;8;118
070500026;500;518;519;10;200;391;1;108;1;5;102;92;2;90
070500027;200;154;154;7;53;146;1;53;2;2;49;0;0;0
070500028;500;486;486;9;191;429;1;70;2;2;66;121;5;116
070500029;500;552;553;7;225;401;1;98;1;4;93;127;7;120
070500030;400;454;456;6;171;331;1;68;5;0;63;103;3;100
070500031;400;397;398;6;143;330;1;69;1;1;67;74;4;70
070500032;600;644;648;8;214;504;1;95;2;4;89;119;4;115
070500033;700;720;723;8;253;579;1;120;2;2;116;133;5;128
070500034;600;664;665;9;260;477;1;122;3;3;116;138;7;131
070500035;700;736;735;8;239;572;1;127;2;7;118;112;5;107
070500036;500;544;543;10;189;426;1;73;0;2;71;116;6;110
070500037;600;666;668;8;221;479;2;119;10;5;104;102;5;97
070500038;500;568;573;5;186;426;1;73;4;3;66;113;0;113
070500039;500;587;588;9;167;427;1;72;4;1;67;95;3;92
070500040;500;514;512;7;167;404;1;95;3;2;90;72;2;70
070500041;700;838;838;6;297;566;1;133;0;4;129;164;5;159
070500042;600;675;673;8;152;516;1;83;3;0;80;69;1;68
070500043;600;646;646;10;230;489;1;110;1;2;107;120;5;115
070500044;700;717;717;5;267;588;2;110;1;7;102;157;7;150
070500045;700;769;771;8;280;587;1;112;3;2;107;168;5;163
070500046;700;676;680;8;190;628;1;71;2;2;67;119;6;113
070500047;500;560;562;12;206;406;1;93;2;1;90;113;9;104
070500048;400;473;474;4;191;318;1;81;4;2;75;110;4;106
070500049;600;637;641;8;245;403;1;196;4;7;185;49;4;45
070500050;500;486;488;6;168;416;1;83;4;2;77;85;3;82
070500051;700;752;752;4;204;594;1;105;6;1;98;99;1;98
070500052;600;580;581;11;192;514;2;84;2;1;81;108;2;106
070500053;500;571;571;5;198;412;2;86;5;0;81;112;3;109
070500054;500;581;582;4;179;397;1;102;4;4;94;77;5;72
070500055;400;115;335;7;122;337;1;62;0;2;60;60;6;54
070500056;600;656;658;8;196;496;1;103;2;3;98;93;8;85
070500057;600;653;654;10;198;513;1;86;3;4;79;112;8;104
070500058;500;555;557;6;165;412;1;87;5;0;82;78;4;74
070500059;500;526;527;9;194;428;1;71;3;3;65;123;9;114
070500060;600;569;571;5;200;487;1;112;4;5;103;88;6;82
070500061;600;614;615;8;232;488;1;111;4;2;105;121;4;117
070500062;500;539;542;8;190;397;1;102;2;4;96;88;1;87
070500063;400;448;448;8;210;280;1;119;5;2;112;91;3;88
070500064;500;558;559;5;225;397;1;102;1;4;97;123;5;118
070500065;500;550;550;8;217;377;1;122;0;6;116;95;4;91
070500066;600;602;601;9;235;509;1;90;3;2;85;145;3;142
070500067;400;348;349;7;121;342;1;57;2;0;55;64;0;64
070500068;500;549;551;7;184;425;1;74;1;1;72;110;6;104
070500069;400;453;454;6;119;335;2;63;1;2;60;56;4;52
070500070;600;625;630;8;210;531;1;68;1;0;67;142;4;138
070500071;600;654;654;8;216;502;2;96;2;1;93;120;5;115
070500072;700;771;770;9;248;590;1;109;2;4;103;139;5;134
070500073;700;761;764;6;233;472;1;227;7;14;206;6;0;6
070500074;700;731;734;5;267;631;1;68;1;1;66;199;9;190
070500075;400;379;380;3;105;346;1;53;2;1;50;52;1;51
070500076;500;555;555;7;144;450;1;49;0;0;49;95;5;90
070500077;700;775;774;8;279;540;1;159;3;3;153;120;1;119
070500078;600;605;601;7;163;521;2;77;2;5;70;86;4;82
070500079;300;324;325;8;106;258;1;41;1;0;40;65;3;62
070500080;600;648;649;10;163;508;1;91;0;0;91;72;0;72
070500081;500;518;518;8;169;422;1;77;3;3;71;92;6;86
070500082;200;141;141;6;58;141;1;58;1;0;57;0;0;0
070500083;200;134;134;7;65;134;1;65;3;2;60;0;0;0
070500084;100;53;53;6;49;50;1;49;2;0;47;0;0;0
070500085;100;48;49;7;28;71;1;28;1;1;26;0;0;0
070500086;100;92;92;7;69;30;1;69;1;0;68;0;0;0
070500087;100;79;79;8;65;34;1;65;0;0;65;0;0;0
070500088;300;229;231;7;83;216;1;83;0;3;80;0;0;0
070500089;200;139;139;7;63;136;1;63;2;3;58;0;0;0
070500090;200;114;114;5;64;135;1;64;2;4;58;0;0;0
070500091;200;136;138;7;84;114;2;84;2;3;79;0;0;0
070500092;200;143;143;5;60;139;1;60;0;1;59;0;0;0
070500093;200;179;180;8;84;115;1;84;1;5;78;0;0;0
070500094;100;89;90;8;63;36;1;63;3;3;57;0;0;0
070500095;100;67;67;7;46;53;1;46;1;0;45;0;0;0
070500096;100;56;56;7;42;57;1;42;0;3;39;0;0;0
070500097;400;407;408;6;189;283;1;116;2;2;112;73;2;71
070500098;200;106;107;5;63;136;1;63;3;1;59;0;0;0
070500099;200;108;113;7;59;140;1;59;0;2;57;0;0;0
070500100;300;252;252;4;124;175;1;124;2;7;115;0;0;0
070500101;100;75;76;6;52;47;1;52;0;1;51;0;0;0
070500102;200;104;105;5;64;135;1;64;3;1;60;0;0;0
070500103;100;102;102;7;89;10;1;89;6;3;80;0;0;0
070500104;300;263;264;7;107;192;1;107;2;8;97;0;0;0
070500105;200;115;115;7;82;117;1;82;6;4;72;0;0;0
070500106;600;572;573;7;144;496;1;103;11;4;88;41;1;40
070500107;200;188;189;6;83;116;1;83;0;1;82;0;0;0
070500108;200;113;113;7;68;131;1;68;2;3;63;0;0;0
070500109;100;92;92;7;62;37;1;62;1;1;60;0;0;0
070500110;50;15;15;11;23;26;1;23;5;0;18;0;0;0
070500111;100;24;24;6;21;78;1;21;1;3;17;0;0;0
070500112;200;139;139;6;79;120;1;79;0;5;74;0;0;0
070500113;200;211;212;6;71;128;1;71;1;3;67;0;0;0
070500114;100;93;93;5;44;55;1;44;2;2;40;0;0;0
070500115;100;26;26;6;25;74;1;25;0;1;24;0;0;0
070500116;100;50;50;6;26;72;2;26;1;1;24;0;0;0
070500117;100;105;105;6;62;38;0;62;1;0;61;0;0;0
070500118;200;26;26;71;82;117;1;82;5;2;75;0;0;0
070500119;100;21;21;12;28;71;1;28;1;1;26;0;0;0
070500120;100;18;18;13;24;75;1;24;0;0;24;0;0;0
070500121;50;19;19;8;27;22;1;27;0;0;27;0;0;0
071200001;300;384;387;5;103;235;2;63;5;1;57;40;1;38
071200002;500;515;519;2;181;400;1;99;3;2;94;82;6;76
071200003;400;456;458;10;175;294;1;105;2;2;101;70;5;65
071200004;500;525;532;2;174;404;1;95;1;3;91;79;5;74
071200005;400;421;424;5;155;322;1;77;1;4;72;78;0;78
071200006;350;373;374;2;134;287;1;62;2;1;59;72;2;70
071200007;300;310;312;6;109;239;1;60;1;5;54;49;2;47
071200008;560;698;699;5;106;460;2;98;9;3;86;8;0;8
071200009;400;488;490;7;167;290;1;109;2;1;106;58;3;55
071200010;500;525;526;4;172;387;2;111;3;0;108;61;2;59
071200011;550;609;613;5;152;472;1;77;2;3;72;75;4;71
071200012;350;390;392;4;147;272;1;77;2;0;75;70;5;65
071200013;500;507;508;5;143;405;1;94;3;4;87;49;1;48
071200014;370;450;451;5;167;267;1;102;3;4;95;65;4;61
071200015;50;27;27;5;25;24;1;25;1;0;24;0;0;0
071200016;130;113;113;7;71;58;1;71;2;1;68;0;0;0
071200017;200;183;184;4;87;112;1;87;4;1;82;0;0;0
071200018;60;38;33;5;18;39;3;18;1;0;17;0;0;0
071200019;100;86;86;7;58;41;1;58;2;2;54;0;0;0
071200020;200;186;186;4;99;100;1;99;2;5;92;0;0;0
071200021;110;94;95;6;55;54;1;55;1;0;54;0;0;0
071200022;70;47;47;10;38;31;1;38;5;0;33;0;0;0
071200023;50;41;41;7;10;39;1;10;1;0;9;0;0;0
071200024;50;25;25;5;29;20;1;29;1;0;28;0;0;0
072900001;700;844;844;6;183;561;1;138;11;7;120;45;3;42
072900002;500;486;486;7;158;429;1;70;2;2;66;88;6;82
072900003;500;459;460;6;165;412;1;87;1;3;83;78;8;70
072900004;500;500;501;9;189;404;1;95;6;2;87;94;5;89
072900005;600;672;673;6;170;491;1;108;5;1;102;62;0;62
072900006;600;672;672;11;184;504;3;93;6;0;87;91;4;87
072900007;500;509;509;8;132;368;1;131;10;2;119;1;0;1
072900008;800;952;954;8;245;564;1;235;28;3;204;10;0;10
072900009;600;575;577;5;192;435;1;164;3;8;153;28;5;23
072900010;600;719;719;9;235;494;1;105;3;1;101;130;10;120
072900011;700;858;859;8;264;548;1;151;8;3;140;113;3;110
072900012;600;612;613;9;195;481;1;118;4;0;114;77;7;70
072900013;500;495;495;6;185;422;1;77;2;1;74;108;8;100
072900014;600;611;611;8;231;494;2;104;8;3;93;127;10;117
072900015;500;543;543;5;187;425;1;74;1;3;70;113;4;109
072900016;500;469;470;7;162;423;1;76;1;3;72;86;2;84
072900017;600;666;666;6;237;491;1;108;3;3;102;129;7;122
072900018;600;700;702;8;244;477;1;122;4;2;116;122;7;115
072900019;500;552;556;9;141;431;1;68;1;0;67;73;5;68
072900020;700;745;746;1;235;579;2;119;4;4;111;116;5;111
072900021;600;582;582;6;216;498;1;101;1;2;98;115;3;112
072900022;600;731;733;6;223;480;1;119;1;7;111;104;6;98
072900023;800;848;848;8;302;630;1;169;3;5;161;133;7;124
072900024;600;613;616;5;178;518;1;81;2;2;77;97;4;93
072900025;500;538;538;5;174;412;1;87;1;5;81;87;3;84
072900026;600;641;641;3;220;498;1;101;1;3;97;119;4;115
072900027;600;682;683;2;227;474;1;125;2;6;117;102;13;89
072900028;800;889;890;10;282;663;2;135;3;2;130;147;7;140
072900029;800;843;845;6;244;670;1;129;2;6;121;115;8;107
072900030;700;722;722;5;223;603;1;96;2;0;94;127;3;124
072900031;200;236;236;3;71;128;1;71;4;1;66;0;0;0
072900032;600;707;708;6;160;479;2;119;13;3;103;41;1;40
072900033;200;205;205;7;100;98;2;100;4;2;94;0;0;0
072900034;300;256;256;3;120;178;2;120;2;1;117;0;0;0
072900035;100;126;126;4;58;41;1;58;0;0;58;0;0;0
072900036;100;76;76;7;44;54;2;44;1;0;43;0;0;0
072900037;400;471;472;4;165;281;2;117;4;2;111;48;1;47
072900038;400;406;410;7;184;252;1;147;2;1;144;37;1;36
072900039;500;505;508;8;201;338;1;161;3;2;156;40;1;39
072900040;300;294;296;5;110;189;1;110;5;3;102;0;0;0
072900041;400;423;423;6;157;263;1;136;12;0;124;21;0;21
072900042;600;582;584;8;141;490;1;109;12;4;93;32;1;31
072900043;600;605;605;6;138;464;1;135;14;3;118;3;0;3
072900044;100;84;84;6;24;75;1;24;2;4;18;0;0;0
072900045;500;494;496;5;199;368;1;131;4;2;125;68;2;66
072900046;300;303;303;3;103;196;1;103;4;4;95;0;0;0
072900047;300;381;383;4;179;151;1;148;1;3;144;31;1;30
072900048;200;163;163;7;63;136;1;63;0;2;61;0;0;0
072900049;100;160;160;3;86;13;1;86;3;2;81;0;0;0
072900050;100;103;103;8;64;35;1;64;0;4;60;0;0;0
072900051;100;68;68;5;36;63;1;36;1;0;35;0;0;0
072900052;100;111;111;7;51;48;1;51;1;2;48;0;0;0
072900053;300;329;329;3;135;186;1;113;4;1;108;22;2;20
072900054;500;531;538;6;252;270;1;229;5;0;224;23;0;23
072900055;600;601;602;5;224;405;1;194;3;2;189;30;2;28
072900056;500;560;562;5;170;363;1;136;13;0;123;34;0;34
072900057;100;61;61;7;33;66;1;33;0;1;32;0;0;0
072900058;200;159;166;6;80;119;1;80;5;1;74;0;0;0
072900059;200;182;182;5;84;114;2;84;0;0;84;0;0;0
072900060;500;510;510;2;207;347;1;152;6;3;143;55;2;53
072900061;50;60;60;3;32;17;1;32;1;4;27;0;0;0
072900062;50;38;38;6;29;20;1;29;0;1;28;0;0;0
072900063;100;48;49;8;24;75;1;24;3;0;21;0;0;0
072900064;50;33;33;7;24;25;1;24;0;0;24;0;0;0
072900065;100;105;105;8;61;37;2;61;1;0;60;0;0;0
072900066;700;778;781;6;168;569;2;129;11;1;117;39;1;38
072900067;50;10;10;23;27;22;1;27;3;2;22;0;0;0
072900068;100;47;47;12;40;59;1;40;8;0;32;0;0;0
072900069;50;25;25;7;28;22;0;28;1;1;26;0;0;0
072900070;50;23;23;4;26;24;0;26;1;0;25;0;0;0
073500001;500;550;552;4;175;427;1;72;0;1;71;103;3;100
073500002;700;789;793;7;267;566;1;133;1;4;128;134;5;129
073500003;600;693;697;5;233;488;1;111;4;2;105;122;5;117
073500004;700;731;735;8;256;609;1;90;4;4;82;166;7;159
073500005;500;552;555;8;193;400;1;99;0;5;94;94;6;88
073500006;600;614;615;8;174;500;1;99;2;1;96;75;5;70
073500007;500;577;580;8;174;405;1;94;6;3;85;80;4;76
073500008;600;608;609;8;146;520;1;79;9;1;69;67;1;66
073500009;600;681;682;7;217;493;2;105;4;4;97;112;3;109
073500010;600;606;608;7;190;487;1;112;3;2;107;78;4;74
073500011;400;351;352;7;93;350;2;48;2;0;46;45;5;40
073500012;400;492;493;4;138;295;2;103;1;3;99;35;1;34
073500013;500;535;537;6;146;396;1;103;1;1;101;43;1;42
073500014;100;34;34;8;22;77;1;22;0;0;22;0;0;0
073500015;100;27;27;8;20;79;1;20;0;0;20;0;0;0
073500016;100;46;46;8;36;62;2;36;0;1;35;0;0;0
073500017;100;83;83;7;28;70;2;28;0;0;28;0;0;0
073500018;600;678;679;5;207;469;1;130;3;4;123;77;5;72
073500019;700;763;765;9;211;488;1;211;0;9;202;0;0;0
073500020;100;31;31;7;27;72;1;27;2;0;25;0;0;0
080300001;1000;1100;1100;14;390;802;3;195;6;4;185;195;5;190
080300002;600;637;638;6;162;516;2;82;0;3;79;80;2;78
080300003;1000;1125;1125;6;145;882;1;117;11;0;106;28;0;28
080300004;600;653;655;5;169;513;1;86;4;1;81;83;2;81
080300005;500;560;560;0;118;434;1;65;3;0;62;53;5;48
080300006;700;782;784;6;263;594;1;105;3;4;98;158;5;153
080300007;1000;1112;1114;6;204;866;1;133;4;4;125;71;3;68
080300008;500;593;593;5;182;430;1;69;0;2;67;113;11;102
080300009;600;621;622;4;144;529;1;70;0;1;69;74;1;73
080300010;500;600;600;6;176;411;1;88;5;3;80;88;1;87
080300011;600;609;609;6;233;484;1;115;3;2;110;118;5;113
080300012;800;800;803;5;214;693;1;106;1;3;102;108;8;100
080300013;800;914;917;8;266;644;1;155;1;5;149;111;6;105
080300014;500;519;520;2;189;420;1;79;1;2;76;110;6;104
080300015;100;18;18;14;26;73;1;26;1;0;25;0;0;0
080300016;300;265;267;5;130;169;1;130;11;5;114;0;0;0
080300017;200;117;117;5;44;155;1;44;0;0;44;0;0;0
080300018;400;428;428;3;161;261;2;137;3;1;133;24;0;24
080300019;300;219;219;4;83;216;1;83;1;1;81;0;0;0
080300020;200;113;113;7;48;151;1;48;0;0;48;0;0;0
080300021;200;150;150;6;62;137;1;62;1;2;59;0;0;0
080300022;600;642;643;7;321;385;2;213;4;3;206;108;4;104
080300023;200;105;105;7;63;136;1;63;3;0;60;0;0;0
080300024;400;385;385;7;136;263;1;136;3;1;132;0;0;0
080300025;200;105;105;4;57;142;1;57;0;4;53;0;0;0
080300026;600;767;767;7;251;431;1;168;2;2;164;83;2;81
080300027;800;1056;1056;4;349;479;1;320;18;3;299;29;3;26
080300028;300;157;157;5;89;210;1;89;2;2;85;0;0;0
080300029;200;170;170;5;55;144;1;55;4;1;50;0;0;0
080300030;500;492;492;7;153;346;1;153;4;4;145;0;0;0
080300031;100;33;33;14;30;69;1;30;2;5;23;0;0;0
080300032;600;795;798;5;314;340;1;259;5;3;251;55;1;54
080300033;400;354;354;5;154;245;1;154;5;1;148;0;0;0
080300034;100;62;62;6;42;57;1;42;3;0;39;0;0;0
080300035;100;35;35;6;19;80;1;19;3;0;16;0;0;0
080300036;300;240;240;4;134;165;1;134;4;3;127;0;0;0
080300037;100;18;18;27;40;59;1;40;3;2;35;0;0;0
080300038;100;14;14;21;33;66;1;33;1;1;31;0;0;0
081200001;500;594;594;7;200;376;1;123;1;2;120;77;5;72
081200002;500;597;597;5;184;398;1;101;3;6;92;83;0;83
081200003;500;680;681;7;232;345;1;154;2;8;144;78;1;77
081200004;500;712;714;8;239;366;2;132;2;3;127;107;7;100
081200005;500;649;649;4;217;375;1;124;2;2;120;93;3;90
081200006;600;710;711;6;208;479;1;120;1;3;116;88;5;83
081200007;600;757;761;6;123;503;1;96;6;1;89;27;1;26
081200008;500;637;639;5;199;387;1;112;3;4;105;87;5;82
081200009;300;284;285;7;111;188;1;111;2;2;107;0;0;0
081200010;100;25;43;4;29;70;1;29;0;1;28;0;0;0
081200011;100;35;35;5;19;80;1;19;2;0;17;0;0;0
081200012;300;303;298;5;126;170;4;126;5;1;120;0;0;0
081200013;100;28;28;7;15;84;1;15;0;0;15;0;0;0
081200014;100;62;62;7;20;79;1;20;0;0;20;0;0;0
081200015;100;24;24;5;18;81;1;18;1;0;17;0;0;0
081200016;100;75;75;6;46;53;1;46;1;0;45;0;0;0
081200017;200;108;108;6;62;137;1;62;5;1;56;0;0;0
081200018;100;57;57;5;29;70;1;29;0;1;28;0;0;0
081200019;200;155;155;5;59;140;1;59;3;1;55;0;0;0
081200020;300;663;663;9;94;205;1;94;2;0;92;0;0;0
081200021;100;35;35;8;23;76;1;23;0;1;22;0;0;0
081200022;400;384;384;4;110;311;2;87;0;1;86;23;0;23
081200023;400;363;363;6;106;313;1;86;4;5;77;20;0;20
081200024;200;159;159;5;59;139;2;59;2;2;55;0;0;0
081200025;300;302;302;6;44;268;1;31;0;2;29;13;0;13
081200026;500;510;512;5;97;417;2;81;1;2;78;16;0;16
081200027;200;155;155;5;75;124;1;75;6;2;67;0;0;0
081200028;200;159;159;4;56;143;1;56;2;1;53;0;0;0
081200029;100;72;72;6;26;73;1;26;0;1;25;0;0;0
081200030;100;40;40;6;23;76;1;23;0;0;23;0;0;0
081200031;200;180;180;3;46;153;1;46;3;0;43;0;0;0
081200032;300;363;363;5;101;198;1;101;9;0;92;0;0;0
081200033;400;418;418;4;126;295;1;104;8;3;93;22;0;22
081200034;200;225;225;6;62;137;1;62;4;0;58;0;0;0
081200035;100;129;129;7;39;60;1;39;2;0;37;0;0;0
081200036;100;47;47;6;26;73;1;26;1;0;25;0;0;0
081200037;400;327;327;6;68;352;1;47;2;0;45;21;0;21
081200038;100;35;35;6;11;88;1;11;0;0;11;0;0;0
081200039;100;66;66;8;29;70;1;29;1;0;28;0;0;0
081200040;200;225;226;6;54;145;1;54;2;0;52;0;0;0
081200041;400;399;402;6;98;312;1;87;6;2;79;11;1;10
081200042;400;342;342;8;93;321;1;78;5;0;73;15;0;15
081200043;100;48;48;8;20;79;1;20;1;0;19;0;0;0
081200044;100;32;32;7;21;78;1;21;0;1;20;0;0;0
081200045;200;147;147;5;53;146;1;53;0;0;53;0;0;0
081500001;150;108;109;6;61;88;1;61;1;2;58;0;0;0
081500002;300;299;299;4;68;231;1;68;5;1;62;0;0;0
081500003;400;586;586;5;202;239;1;160;8;0;152;42;0;42
081500004;50;44;44;7;33;16;1;33;0;1;32;0;0;0
081500005;600;852;852;12;190;439;1;160;5;3;152;30;1;29
081500006;700;904;904;14;239;460;1;239;1;1;237;0;0;0
081500007;200;154;154;6;81;118;1;81;0;2;79;0;0;0
081500008;800;1070;1070;6;267;557;2;241;8;2;231;26;2;24
081500009;400;380;380;3;116;327;1;72;1;2;69;44;2;42
081500010;500;539;538;6;174;340;1;159;3;4;152;15;1;14
081500011;200;154;154;5;64;135;1;64;2;0;62;0;0;0
081500012;300;373;373;4;126;173;1;126;12;5;109;0;0;0
081500013;50;29;29;7;21;28;1;21;0;0;21;0;0;0
081500014;50;28;46;5;33;15;2;33;1;0;32;0;0;0
081500015;100;76;76;3;46;53;1;46;0;0;46;0;0;0
081500016;100;70;71;5;51;48;1;51;2;0;49;0;0;0
081500017;700;829;829;6;327;458;1;241;27;4;210;86;1;85
081500018;200;164;164;6;68;131;1;68;1;2;65;0;0;0
081500019;50;40;40;7;32;17;1;32;0;0;32;0;0;0
081500020;200;184;184;4;83;116;1;83;4;1;78;0;0;0
081500021;700;750;750;7;286;484;10;206;9;6;191;80;3;77
081500022;150;127;128;6;53;95;2;53;4;3;46;0;0;0
081500023;400;432;432;7;75;324;1;75;5;0;70;0;0;0
081500024;400;364;365;3;97;312;2;86;5;1;80;11;0;11
081500025;100;92;92;7;61;38;1;61;2;0;59;0;0;0
081500026;200;167;167;7;58;141;1;58;1;0;57;0;0;0
081500027;900;925;925;4;292;620;1;279;15;3;261;13;1;12
081500028;300;345;345;3;126;190;1;109;1;2;106;17;1;16
081500029;200;214;214;3;100;98;2;100;3;4;93;0;0;0
081500030;50;22;27;8;30;19;1;30;0;0;30;0;0;0
081500031;550;689;690;7;179;384;1;165;13;7;145;14;1;13
081500032;300;307;307;5;135;164;1;135;7;1;127;0;0;0
081500033;300;271;271;4;141;158;1;141;4;0;137;0;0;0
081500034;100;89;89;6;49;50;1;49;2;2;45;0;0;0
081500035;50;19;23;7;19;30;1;19;0;0;19;0;0;0
081500036;200;163;163;5;72;127;1;72;1;0;71;0;0;0
081500037;100;88;88;8;67;32;1;67;2;2;63;0;0;0
081500038;400;453;454;0;165;259;1;140;7;5;128;25;5;20
081500039;200;174;179;2;98;101;1;98;1;4;93;0;0;0
081500040;500;501;501;6;116;402;1;97;6;7;84;19;0;19
081500041;200;103;103;8;43;156;1;43;0;3;40;0;0;0
081500042;100;63;63;6;45;54;1;45;0;0;45;0;0;0
081500043;500;573;573;5;185;385;1;114;2;0;112;71;2;69
081500044;500;488;488;3;191;391;1;108;5;2;101;83;3;80
081500045;400;493;493;6;151;263;1;136;2;3;131;15;1;14
081500046;150;113;113;7;65;84;1;65;1;4;60;0;0;0
081500047;100;60;60;6;40;59;1;40;3;0;37;0;0;0
081500048;100;60;60;5;40;59;1;40;1;2;37;0;0;0
081500049;100;76;76;5;49;50;1;49;1;1;47;0;0;0
081500050;200;181;181;5;93;106;1;93;2;1;90;0;0;0
081500051;50;33;33;7;24;25;1;24;2;0;22;0;0;0
081500052;200;260;261;5;93;106;1;93;5;5;83;0;0;0
081500053;150;132;132;5;70;79;1;70;2;1;67;0;0;0
081500054;150;125;126;5;70;78;2;70;1;1;68;0;0;0
081500055;200;203;203;5;69;130;1;69;0;1;68;0;0;0
081500056;300;303;305;4;96;203;1;96;0;2;94;0;0;0
081500057;100;51;51;5;24;75;1;24;1;0;23;0;0;0
081500058;700;834;842;5;229;531;2;167;7;4;156;62;0;62
081500059;300;315;315;4;159;140;1;159;5;2;152;0;0;0
081500060;700;723;723;10;264;449;1;250;19;1;230;14;0;14
081500061;500;527;526;8;153;362;3;135;2;0;133;18;0;18
081500062;50;20;20;8;15;34;1;15;1;1;13;0;0;0
081500063;100;118;118;2;48;51;1;48;1;0;47;0;0;0
081500064;850;960;960;9;258;591;1;258;17;0;241;0;0;0
081500065;200;183;183;6;44;155;1;44;0;0;44;0;0;0
081500066;300;378;386;5;153;146;6;148;4;0;144;5;0;5
081500067;600;619;619;5;160;449;1;150;6;0;144;10;0;10
081500068;50;34;34;5;37;11;2;37;2;2;33;0;0;0
081700001;600;576;577;10;238;487;1;112;1;2;109;126;5;121
081700002;700;733;735;10;293;517;1;182;3;8;171;111;4;107
081700003;900;946;946;9;206;721;1;178;13;2;163;28;1;27
081700004;900;957;957;9;169;731;3;166;18;0;148;3;0;3
081700005;900;896;896;9;333;704;2;194;8;7;179;139;3;136
081700006;900;916;918;7;314;720;1;179;2;5;172;135;3;132
081700007;600;636;636;1;246;464;1;135;1;5;129;111;4;107
081700008;500;465;466;7;174;421;1;78;4;1;73;96;5;91
081700009;700;735;736;6;269;546;1;153;2;5;146;116;3;113
081700010;600;607;607;8;232;477;1;122;1;8;113;110;8;102
081700011;800;831;831;8;187;626;2;172;15;0;157;15;2;13
081700012;800;789;791;11;261;671;1;128;4;6;118;133;5;128
081700013;500;568;569;7;193;396;2;102;2;1;99;91;1;90
081700014;300;268;269;7;110;189;1;110;7;0;103;0;0;0
081700015;100;75;75;8;40;59;1;40;1;1;38;0;0;0
081700016;400;491;491;4;150;301;1;98;3;3;92;52;3;49
081700017;400;463;468;4;206;262;1;137;3;3;131;69;3;66
081700018;100;66;66;8;21;78;1;21;0;1;20;0;0;0
081700019;200;203;203;7;85;113;2;85;2;0;83;0;0;0
081700020;50;49;49;8;35;14;1;35;0;2;33;0;0;0
081700021;100;56;56;8;29;70;1;29;0;1;28;0;0;0
081700022;50;34;34;8;18;31;1;18;1;0;17;0;0;0
081700023;40;19;20;8;16;23;1;16;0;0;16;0;0;0
081700024;150;160;160;7;32;117;1;32;1;1;30;0;0;0
081700025;80;84;84;7;27;52;1;27;0;0;27;0;0;0
081700026;70;68;68;6;34;35;1;34;1;0;33;0;0;0
081700027;300;356;357;5;100;201;1;98;4;1;93;2;0;2
081700028;150;149;149;5;57;92;1;57;2;0;55;0;0;0
081700029;60;51;52;7;23;36;1;23;3;0;20;0;0;0
081700030;50;43;43;8;27;22;1;27;0;0;27;0;0;0
082000001;600;631;631;4;256;411;1;188;13;2;173;68;11;57
082000002;400;370;370;6;173;242;2;156;18;0;138;17;2;15
082000003;300;312;312;11;65;234;1;65;0;1;64;0;0;0
082000004;300;271;271;10;89;210;1;89;6;3;80;0;0;0
082000005;100;109;109;7;75;23;2;75;0;1;74;0;0;0
082000006;650;650;651;10;210;466;1;183;14;1;168;27;0;27
082000007;300;312;313;3;131;178;1;121;3;3;115;10;0;10
082000008;50;49;50;7;23;26;1;23;2;0;21;0;0;0
082000009;700;728;728;9;218;481;1;218;7;2;209;0;0;0
082000010;150;133;133;10;52;97;1;52;1;0;51;0;0;0
082000011;500;525;524;14;156;343;1;156;0;3;153;0;0;0
082000012;300;314;314;7;121;182;1;117;3;1;113;4;0;4
082000013;200;186;186;8;79;120;1;79;3;0;76;0;0;0
082000014;50;43;43;7;29;20;1;29;1;0;28;0;0;0
082000015;200;183;183;8;69;130;1;69;1;0;68;0;0;0
082000016;150;123;123;5;55;94;1;55;0;0;55;0;0;0
082000017;50;17;17;7;22;27;1;22;5;0;17;0;0;0
082700001;800;789;789;4;234;653;1;146;1;6;139;88;6;82
082700002;800;741;741;7;206;676;1;123;0;4;119;83;3;80
082700003;600;597;598;7;183;455;1;144;3;5;136;39;1;38
082700004;1400;1391;1392;7;346;1053;1;346;29;3;314;0;0;0
082700005;900;938;938;9;212;737;1;162;4;3;155;50;3;47
082700006;600;614;616;7;215;455;1;144;5;3;136;71;3;68
082700007;800;770;772;6;254;644;1;155;2;2;151;99;3;96
082700008;300;238;238;6;73;226;1;73;2;0;71;0;0;0
082700009;400;394;394;7;108;304;1;95;4;1;90;13;0;13
082700010;1000;983;984;5;298;736;1;263;6;2;255;35;0;35
082700011;800;744;745;6;176;631;1;168;4;0;164;8;0;8
082700012;900;945;946;7;212;690;1;209;7;2;200;3;0;3
082700013;400;374;374;9;47;352;1;47;1;0;46;0;0;0
082700014;300;274;274;6;49;249;2;49;0;0;49;0;0;0
082700015;500;523;523;7;132;367;1;132;6;1;125;0;0;0
082700016;200;135;135;8;15;184;1;15;0;0;15;0;0;0
082700017;1300;1299;1299;8;281;1050;1;249;11;1;237;32;0;32
082700018;1300;1224;1224;14;358;942;3;355;19;3;333;3;0;3
082700019;1300;1217;1217;14;390;917;2;381;9;5;367;9;0;9
082700020;600;572;573;8;168;449;1;150;6;1;143;18;1;17
082700021;100;69;69;6;39;60;1;39;1;0;38;0;0;0
082700022;700;658;658;8;157;548;1;151;5;0;146;6;0;6
082700023;200;166;166;5;67;132;1;67;0;1;66;0;0;0
082700024;300;264;264;6;102;197;1;102;3;3;96;0;0;0
082700025;100;36;36;8;21;77;2;21;1;1;19;0;0;0
082700026;1300;1282;1284;5;305;995;2;303;17;1;285;2;0;2
082700027;1100;1077;1077;6;313;786;1;313;18;5;290;0;0;0
082700028;400;381;381;8;87;312;1;87;1;0;86;0;0;0
082700029;800;815;815;8;194;605;1;194;7;1;186;0;0;0
082700030;300;222;222;7;66;232;2;66;3;2;61;0;0;0
082700031;400;415;416;6;111;288;1;111;4;3;104;0;0;0
082700032;100;23;23;7;23;76;1;23;1;1;21;0;0;0
082800001;500;545;545;6;194;381;1;118;7;5;106;76;3;73
082800002;500;619;619;3;187;393;1;106;5;1;100;81;4;77
082800003;500;513;515;6;163;421;1;78;1;3;74;85;5;80
082800004;500;537;540;9;220;401;1;98;3;2;93;122;5;117
082800005;500;625;626;8;229;397;1;102;3;2;97;127;6;121
082800006;500;970;1015;9;351;346;4;150;5;4;141;201;10;191
082800007;500;772;775;9;353;340;1;159;1;2;156;194;8;186
082800008;500;607;609;7;262;401;1;98;2;2;94;164;8;156
082800009;500;567;571;8;255;372;2;126;5;7;114;129;7;122
082800010;500;607;607;9;263;368;0;132;1;4;127;131;8;123
082800011;500;598;600;8;249;370;1;129;0;3;126;120;9;111
082800012;500;537;539;8;187;418;2;80;3;2;75;107;3;104
082800013;500;523;524;7;224;375;1;124;1;5;118;100;4;96
082800014;500;848;848;8;360;350;1;149;5;4;140;211;6;205
082800015;500;692;693;6;289;384;1;115;6;1;108;174;5;169
082800016;500;749;750;8;353;152;1;347;6;10;331;6;2;4
082800017;500;597;599;10;263;386;1;113;1;1;111;150;5;145
082800018;500;801;805;9;336;341;1;158;6;2;150;178;2;176
082800019;500;601;603;10;275;383;3;114;2;2;110;161;5;156
082800020;500;534;534;6;228;383;2;115;1;2;112;113;4;109
082800021;500;513;513;5;207;391;2;107;1;0;106;100;2;98
082800022;500;802;802;9;350;326;2;172;9;4;159;178;9;169
082800023;500;563;567;9;243;381;1;118;3;1;114;125;4;121
082800024;500;515;516;7;225;400;1;99;1;3;95;126;6;120
082800025;500;675;675;5;289;378;2;120;3;3;114;169;11;158
082800026;500;682;682;7;260;424;1;75;0;4;71;185;12;173
082800027;500;560;562;10;225;399;1;100;1;1;98;125;4;121
082800028;500;663;665;2;263;409;1;90;0;1;89;173;5;168
082800029;500;658;658;7;232;385;1;114;3;1;110;118;1;117
082800030;500;800;801;9;289;336;1;163;8;3;152;126;4;122
082800031;500;833;837;10;240;378;1;121;4;1;116;119;7;112
082800032;500;722;724;6;257;374;1;125;4;3;118;132;6;126
082800033;500;594;596;8;239;376;1;123;2;2;119;116;2;114
082800034;500;564;565;4;196;382;1;117;2;2;113;79;4;75
082800035;500;516;517;6;188;413;1;86;5;2;79;102;2;100
082800036;500;627;627;5;202;391;1;108;3;5;100;95;2;93
082800037;500;643;646;7;250;356;1;143;2;2;139;107;3;104
082800038;500;658;660;6;115;432;1;67;5;3;59;48;2;46
082800039;500;559;559;7;135;412;1;87;3;2;82;48;0;48
082800040;500;593;596;6;225;381;1;118;1;0;117;107;2;105
082800041;500;602;602;4;215;391;2;107;1;1;105;108;6;102
082800042;500;771;771;8;257;354;2;144;7;2;135;113;4;109
082800043;500;605;608;8;231;385;1;114;3;4;107;117;2;115
082800044;500;721;721;8;246;380;1;119;3;2;114;127;8;119
082800045;500;808;808;11;283;348;1;151;1;1;149;132;6;126
082800046;500;666;667;6;248;388;1;111;2;2;107;137;1;136
082800047;500;813;814;10;310;343;1;156;2;4;150;154;8;146
082800048;500;725;726;6;169;384;1;115;4;1;110;54;4;50
082800049;500;633;635;8;130;415;1;84;8;1;75;46;3;43
082800050;500;830;834;5;316;339;2;159;2;4;153;157;7;150
082800051;500;615;616;8;223;364;1;135;2;4;129;88;6;82
082800052;500;596;596;8;218;387;1;112;3;0;109;106;2;104
082800053;500;511;511;8;134;429;4;67;1;1;65;67;1;66
082800054;500;365;366;10;124;436;1;63;0;1;62;61;2;59
082800055;500;633;635;3;206;380;1;119;4;3;112;87;5;82
082800056;500;811;815;4;273;375;1;124;3;1;120;149;7;142
082800057;500;665;668;6;218;388;1;111;3;1;107;107;8;99
082800058;500;649;654;4;193;394;2;104;0;3;101;89;4;85
082800059;500;719;722;7;327;351;1;148;2;2;144;179;4;175
082800060;500;703;703;6;290;328;2;170;3;6;161;120;2;118
082800061;500;683;684;5;312;348;1;151;0;5;146;161;6;155
082800062;500;729;731;4;313;334;1;165;2;3;160;148;5;143
082800063;500;601;601;4;284;347;1;152;3;2;147;132;4;128
082800064;500;695;698;7;304;339;1;160;0;1;159;144;3;141
082800065;500;578;583;7;202;398;1;101;3;2;96;101;4;97
082800066;500;645;646;7;221;396;1;103;3;3;97;118;5;113
082800067;500;649;649;7;237;370;1;129;1;2;126;108;10;98
082800068;500;605;605;5;222;343;1;156;1;1;154;66;5;61
082800069;500;637;638;4;220;385;1;114;1;0;113;106;4;102
082800070;500;643;647;5;222;380;2;118;1;0;117;104;4;100
082800071;500;661;661;6;218;388;1;111;6;3;102;107;3;104
082800072;500;707;712;7;230;395;1;104;2;6;96;126;8;118
082800073;500;525;527;8;151;419;1;80;3;1;76;71;4;67
082800074;500;546;546;3;168;405;1;94;8;3;83;74;4;70
082800075;500;478;481;8;137;435;1;64;1;1;62;73;4;69
082800076;500;707;707;8;263;374;1;125;1;2;122;138;6;132
082800077;500;628;632;8;77;437;2;61;6;1;54;16;0;16
082800078;500;729;729;8;110;429;1;70;2;1;67;40;1;39
082800079;500;732;733;8;171;355;1;144;5;3;136;27;1;26
082800080;500;660;665;8;118;427;1;72;5;1;66;46;4;42
082800081;500;677;677;9;146;391;2;107;7;0;100;39;2;37
082800082;500;671;673;4;143;404;1;95;13;4;78;48;0;48
082800083;500;736;736;9;156;346;1;153;18;0;135;3;0;3
082800084;500;686;686;9;183;327;1;172;32;4;136;11;0;11
082800085;500;550;551;9;117;431;1;68;4;0;64;49;3;46
082800086;500;524;524;9;125;432;1;67;2;2;63;58;2;56
082800087;500;578;580;8;160;427;1;72;2;4;66;88;3;85
082800088;500;554;555;7;136;414;1;85;1;3;81;51;2;49
082800089;500;458;459;7;121;431;1;68;2;0;66;53;0;53
082800090;500;527;527;7;163;420;1;79;0;0;79;84;3;81
082800091;500;776;780;9;276;339;1;160;6;4;150;116;4;112
082800092;500;574;575;4;170;411;1;88;3;5;80;82;1;81
082800093;500;624;624;5;224;366;2;132;6;4;122;92;2;90
082800094;500;647;651;7;194;398;1;101;2;1;98;93;6;87
082800095;500;586;586;5;164;401;1;98;2;2;94;66;3;63
082800096;500;637;638;5;185;395;1;104;2;1;101;81;3;78
082800097;500;672;674;8;199;381;3;116;4;1;111;83;5;78
082800098;500;637;637;8;185;383;1;116;2;1;113;69;6;63
082800099;500;666;666;4;197;381;2;117;2;3;112;80;6;74
082800100;500;677;678;5;187;376;1;123;6;2;115;64;7;57
082800101;500;398;403;7;78;463;1;36;0;0;36;42;1;41
082800102;500;646;651;4;251;348;1;151;5;3;143;100;3;97
082800103;500;634;636;8;276;316;1;183;3;5;175;93;3;90
082800104;200;115;116;8;47;151;2;47;1;3;43;0;0;0
082800105;500;632;634;6;222;391;1;108;2;1;105;114;6;108
082800106;500;681;682;7;229;367;1;132;2;2;128;97;2;95
082800107;500;478;478;7;117;429;3;68;2;3;63;49;6;43
082800108;500;420;421;6;122;430;2;68;1;2;65;54;1;53
082800109;500;592;596;6;133;427;2;71;4;0;67;62;5;57
082800110;500;820;824;6;206;366;2;132;1;3;128;74;1;73
082800111;500;694;694;5;196;387;1;112;0;2;110;84;1;83
082800112;500;487;490;6;136;423;1;76;4;1;71;60;0;60
082800113;500;604;605;8;121;425;1;74;1;2;71;47;1;46
082800114;500;604;605;8;155;405;1;94;1;4;89;61;3;58
082800115;500;638;638;4;203;392;1;107;5;0;102;96;3;93
082800116;500;507;508;9;144;418;1;81;2;0;79;63;3;60
082800117;500;566;568;8;173;401;1;98;2;7;89;75;4;71
082800118;500;570;573;8;188;400;1;99;3;0;96;89;2;87
082800119;500;629;631;3;121;416;1;83;2;1;80;38;0;38
082800120;500;567;569;7;97;439;1;60;0;2;58;37;3;34
082800121;500;596;597;6;65;451;1;48;1;0;47;17;1;16
082800122;500;647;647;8;65;451;1;48;5;1;42;17;0;17
082800123;500;718;720;5;65;450;1;49;5;2;42;16;0;16
082800124;500;603;603;6;67;432;1;67;6;1;60;0;0;0
082800125;500;627;628;7;22;477;1;22;1;0;21;0;0;0
082800126;500;686;688;4;48;451;1;48;11;0;37;0;0;0
082800127;300;76;76;61;84;215;1;84;2;4;78;0;0;0
082800128;300;109;109;17;90;209;1;90;9;4;77;0;0;0
082800129;100;18;18;12;29;70;1;29;4;1;24;0;0;0
082800130;100;25;25;0;25;74;1;25;0;0;25;0;0;0
082900001;500;642;644;3;245;359;1;140;1;4;135;105;4;101
082900002;400;558;559;3;178;309;1;90;5;3;82;88;5;83
082900003;300;482;483;5;152;212;1;87;1;0;86;65;0;65
082900004;600;920;921;5;239;404;1;195;4;7;184;44;1;43
082900005;100;108;108;5;32;67;1;32;1;1;30;0;0;0
082900006;100;41;41;7;24;75;1;24;0;0;24;0;0;0
082900007;100;56;56;6;32;66;2;32;1;0;31;0;0;0
082900008;200;117;117;6;41;158;1;41;1;1;39;0;0;0
082900009;300;278;278;1;110;189;1;110;3;3;104;0;0;0
082900010;100;86;86;6;44;55;1;44;0;0;44;0;0;0
082900011;100;60;60;8;30;69;1;30;0;1;29;0;0;0
082900012;300;208;208;3;85;214;1;85;1;6;78;0;0;0
082900013;100;17;17;8;19;80;1;19;0;0;19;0;0;0
082900014;100;39;39;7;14;85;1;14;0;1;13;0;0;0
082900015;100;45;45;6;28;71;1;28;1;0;27;0;0;0
082900016;100;29;30;7;14;85;1;14;0;0;14;0;0;0
090200001;1500;1688;1710;8;404;1145;1;354;9;4;341;50;2;48
090200002;1500;1885;1915;8;453;1123;2;375;9;6;360;78;6;72
090200003;1500;2184;2207;1;509;1088;1;411;8;10;393;98;4;94
090200004;1500;1959;1959;4;377;1163;1;336;4;4;328;41;0;41
090200005;200;236;236;7;70;128;2;70;1;1;68;0;0;0
090200006;500;585;585;5;184;315;1;184;1;1;182;0;0;0
090200007;500;544;538;6;102;397;1;102;6;1;95;0;0;0
090200008;700;731;741;10;202;496;2;202;7;0;195;0;0;0
090200009;600;642;655;8;156;443;1;156;4;1;151;0;0;0
090200010;1100;1234;1234;5;301;808;1;291;4;10;277;10;0;10
090200011;300;298;305;10;101;198;1;101;1;0;100;0;0;0
090200012;1000;1005;1010;9;220;777;3;220;4;2;214;0;0;0
090200013;500;551;554;8;107;392;1;107;3;0;104;0;0;0
090200014;800;808;808;8;124;675;1;124;5;0;119;0;0;0
090200015;500;587;587;7;227;285;2;213;4;3;206;14;0;14
090200016;400;374;380;7;97;301;2;97;1;0;96;0;0;0
090200017;300;363;367;7;82;217;1;82;4;0;78;0;0;0
090200018;100;112;112;7;46;53;1;46;1;0;45;0;0;0
090200019;200;172;172;5;76;124;0;76;0;0;76;0;0;0
090200020;800;737;777;7;237;578;1;221;2;6;213;16;0;16
090200021;200;199;200;6;70;130;0;70;1;0;69;0;0;0
090200022;300;296;307;7;77;222;1;77;1;2;74;0;0;0
090200023;200;206;206;6;54;145;1;54;1;0;53;0;0;0
090200024;600;557;561;8;92;507;1;92;5;0;87;0;0;0
090200025;200;192;192;5;43;157;0;43;0;0;43;0;0;0
090200026;200;162;162;7;44;155;1;44;2;0;42;0;0;0
090200027;1000;1011;1024;10;216;783;2;215;5;1;209;1;0;1
090200028;700;710;710;8;280;423;1;276;5;14;257;4;1;3
090200029;400;393;393;5;120;279;1;120;1;0;119;0;0;0
090200030;200;153;158;6;56;143;1;56;0;0;56;0;0;0
090200031;700;703;706;8;146;553;1;146;0;0;146;0;0;0
090200032;100;104;104;7;64;34;2;64;0;1;63;0;0;0
090200033;400;411;411;8;68;331;1;68;3;0;65;0;0;0
090200034;200;159;162;5;51;148;1;51;7;0;44;0;0;0
090200035;100;44;44;7;37;62;1;37;0;0;37;0;0;0
090200036;200;193;197;6;60;138;2;60;2;0;58;0;0;0
090200037;100;70;70;4;58;41;1;58;2;0;56;0;0;0
090200038;300;297;297;7;92;207;1;92;1;1;90;0;0;0
090200039;500;499;506;8;122;377;1;122;3;1;118;0;0;0
090200040;900;811;829;7;132;767;1;132;2;0;130;0;0;0
090200041;200;216;216;9;54;146;0;54;0;0;54;0;0;0
090200042;400;337;345;10;62;339;2;59;0;2;57;3;0;3
090200043;200;238;241;7;51;148;1;51;1;1;49;0;0;0
090200044;300;260;260;12;69;230;1;69;0;1;68;0;0;0
090200045;200;178;178;6;41;158;1;41;1;0;40;0;0;0
090200046;200;210;210;5;49;150;1;49;0;0;49;0;0;0
090200047;200;197;200;7;43;156;1;43;1;0;42;0;0;0
090200048;300;263;266;6;69;230;1;69;2;1;66;0;0;0
090200049;100;105;105;6;27;72;1;27;0;0;27;0;0;0
090200050;100;95;95;1;95;5;0;95;0;0;95;0;0;0
090200051;100;65;65;0;64;35;1;64;0;0;64;0;0;0
090200052;100;36;36;0;36;64;0;36;0;0;36;0;0;0
090200053;100;26;26;0;26;73;1;26;0;0;26;0;0;0
090200054;100;46;46;0;46;54;0;46;0;0;46;0;0;0
090200055;100;36;36;1;32;68;0;32;1;0;31;0;0;0
090200056;100;69;69;1;69;31;0;69;0;1;68;0;0;0
090200057;100;30;30;0;30;70;0;30;0;0;30;0;0;0
090200058;100;40;40;1;41;59;0;41;0;0;41;0;0;0
090800001;2400;2470;2474;12;639;1853;1;546;29;1;516;93;2;91
090800002;1300;1300;1303;13;367;1298;1;1;0;0;1;366;0;366
090800003;640;643;643;7;228;496;1;143;0;1;142;85;0;85
090800004;1650;1649;1651;6;512;1306;1;343;4;7;332;162;0;162
090800005;450;461;462;9;148;339;4;107;3;0;104;41;0;41
090800006;550;551;552;7;110;549;1;0;0;0;0;110;0;110
090800007;550;557;557;7;126;547;1;2;0;0;2;124;0;124
090800008;200;199;199;10;67;132;1;67;1;2;64;0;0;0
090800009;450;487;488;7;163;319;1;130;3;3;124;33;4;29
090800010;400;421;421;5;129;370;1;29;1;0;28;100;3;97
090800011;250;287;287;4;86;163;1;86;0;1;85;0;0;0
090800012;200;216;217;10;49;150;1;49;4;0;45;0;0;0
090800013;550;553;553;8;134;415;1;134;0;0;134;0;0;0
090800014;440;448;448;6;134;305;1;134;0;0;134;0;0;0
090800015;350;373;373;4;111;332;0;18;0;0;18;93;0;93
090800016;450;459;459;3;94;449;1;0;0;0;0;94;1;93
090800017;600;621;621;9;126;473;1;126;1;1;124;0;0;0
090800018;600;648;648;12;125;474;1;125;3;0;122;0;0;0
090800019;800;828;835;7;277;522;1;277;0;0;277;0;0;0
090800020;650;672;674;8;194;455;1;194;13;0;181;0;0;0
090800021;1000;1032;1042;6;241;758;1;241;0;1;240;0;0;0
090800022;550;561;561;7;157;392;1;157;0;0;157;0;0;0
090800023;850;872;872;6;243;606;1;243;0;2;241;0;0;0
090800024;200;244;244;7;52;147;1;52;4;0;48;0;0;0
090800025;300;303;303;9;95;204;1;95;1;1;93;0;0;0
090800026;400;422;422;7;87;312;1;87;5;1;81;0;0;0
090800027;250;272;272;5;74;175;1;74;0;0;74;0;0;0
090800028;100;84;84;3;42;57;1;42;0;0;42;0;0;0
090800029;200;221;221;5;46;154;0;46;0;0;46;0;0;0
090800030;650;680;681;3;329;500;2;148;8;0;140;181;4;177
090800031;450;478;478;7;78;449;1;0;0;0;0;78;0;78
090800032;800;173;823;6;179;665;0;135;0;0;135;44;0;44
090800033;700;713;713;7;162;700;0;0;0;0;0;162;0;162
090800034;350;384;384;9;116;348;1;1;0;0;1;115;1;114
090800035;400;406;406;7;124;275;1;124;2;0;122;0;0;0
090800036;150;152;152;7;32;117;1;32;1;0;31;0;0;0
090800037;1200;1212;1212;13;172;1027;1;172;2;0;170;0;0;0
090800038;400;422;423;5;142;399;1;0;0;0;0;142;0;142
090800039;250;289;290;8;111;138;1;111;2;1;108;0;0;0
090800040;260;273;273;6;80;177;3;80;1;0;79;0;0;0
090800041;200;204;204;7;70;129;1;70;3;0;67;0;0;0
090800042;200;206;206;5;68;131;1;68;1;0;67;0;0;0
090800043;250;258;259;11;93;156;1;93;0;0;93;0;0;0
090800044;360;377;379;8;108;251;1;108;3;0;105;0;0;0
090800045;50;37;37;0;36;13;1;36;0;0;36;0;0;0
091400001;400;641;642;5;290;206;1;193;1;5;187;97;10;87
091400002;300;416;416;0;196;156;1;143;6;1;136;53;4;49
091400003;200;347;348;2;111;102;0;98;2;4;92;13;1;12
091400004;100;93;93;7;75;24;1;75;1;1;73;0;0;0
091400005;200;138;144;2;108;91;1;108;0;1;107;0;0;0
091400006;200;281;281;3;149;50;1;149;3;8;138;0;0;0
091400007;300;263;263;3;136;162;2;136;2;1;133;0;0;0
091400008;200;115;115;2;71;128;1;71;0;0;71;0;0;0
091400009;200;297;315;7;77;123;0;77;2;1;74;0;0;0
091400010;300;303;303;11;172;127;1;172;3;4;165;0;0;0
091400011;300;440;445;4;197;128;1;171;5;2;164;26;1;25
091400012;400;651;651;8;319;106;1;293;10;10;273;26;2;24
091400013;100;72;72;1;49;50;1;49;4;0;45;0;0;0
091400014;200;252;252;3;116;83;1;116;2;0;114;0;0;0
091400015;100;49;50;0;16;83;1;16;0;1;15;0;0;0
091400016;200;240;240;0;110;89;1;110;2;3;105;0;0;0
091400017;200;225;225;2;87;112;1;87;1;1;85;0;0;0
091400018;400;1064;1064;1;287;181;2;217;14;1;202;70;2;68
091400019;400;887;889;1;273;146;1;253;20;2;231;20;0;20
091400020;400;982;982;2;198;205;0;195;15;4;176;3;0;3
091400021;300;1080;1081;6;169;130;1;169;4;1;164;0;0;0
091400022;400;1418;1418;2;264;135;1;264;12;0;252;0;0;0
091400023;300;600;600;2;113;235;1;64;7;0;57;49;0;49
091400024;200;300;300;8;60;139;1;60;1;0;59;0;0;0
091400025;200;266;266;6;65;129;6;65;2;1;62;0;0;0
091400026;300;656;658;0;96;203;1;96;12;0;84;0;0;0
091400027;200;268;269;4;59;140;1;59;3;0;56;0;0;0
091400028;400;1251;1251;6;221;178;1;221;17;1;203;0;0;0
091400029;400;1053;1056;7;239;236;1;163;3;0;160;76;3;73
091400030;300;391;391;6;110;201;1;98;1;1;96;12;1;11
091400031;300;807;807;9;173;126;1;173;23;0;150;0;0;0
091400032;300;662;662;11;133;219;1;80;4;0;76;53;0;53
091400033;400;690;690;6;239;160;3;237;5;0;232;2;0;2
091400034;300;496;498;0;172;168;1;131;4;2;125;41;0;41
091400035;300;327;333;0;84;227;1;72;0;1;71;12;0;12
091400036;300;502;502;3;135;164;1;135;9;0;126;0;0;0
091400037;300;957;964;4;170;249;1;50;3;0;47;120;0;120
091400038;300;756;765;8;145;153;2;145;5;0;140;0;0;0
091400039;200;453;455;6;116;94;1;105;2;1;102;11;0;11
091400040;300;697;699;8;189;109;2;189;8;0;181;0;0;0
091400041;200;395;395;3;96;135;1;64;3;0;61;32;0;32
091400042;500;1398;1408;9;312;212;1;287;13;4;270;25;3;22
091400043;400;992;1001;9;272;127;1;272;14;1;257;0;0;0
091400044;300;495;495;6;131;168;1;131;7;0;124;0;0;0
091400045;400;684;686;8;211;201;1;198;2;0;196;13;0;13
091400046;400;753;757;8;209;185;6;209;5;3;201;0;0;0
091400047;400;804;807;7;196;353;1;46;0;1;45;150;0;150
091400048;400;679;683;1;197;202;1;197;8;2;187;0;0;0
091400049;200;186;186;3;64;135;1;64;0;0;64;0;0;0
091400050;100;106;106;6;46;53;1;46;0;0;46;0;0;0
091400051;300;279;279;7;137;162;1;137;3;1;133;0;0;0
091400052;200;288;286;4;71;129;0;71;4;0;67;0;0;0
091400053;100;205;205;4;46;51;3;46;2;0;44;0;0;0
091400054;200;226;226;4;71;128;1;71;3;0;68;0;0;0
091400055;200;375;375;5;65;134;1;65;0;1;64;0;0;0
091400056;400;525;532;7;143;256;1;143;4;0;139;0;0;0
091400057;400;943;943;1;302;98;0;302;10;4;288;0;0;0
091400058;400;608;616;7;183;216;1;183;2;0;181;0;0;0
091400059;200;136;136;4;64;135;1;64;0;0;64;0;0;0
091400060;400;774;774;3;220;179;1;220;10;3;207;0;0;0
091400061;200;139;139;2;70;129;1;70;1;0;69;0;0;0
091400062;100;100;100;4;58;41;1;58;0;0;58;0;0;0
091400063;200;191;191;7;82;117;1;82;0;3;79;0;0;0
091400064;200;251;251;4;111;88;1;111;3;0;108;0;0;0
091400065;300;477;477;0;152;169;0;131;2;5;124;21;1;20
091400066;300;487;487;0;177;149;1;150;6;4;140;27;2;25
091400067;300;432;432;6;124;175;1;124;11;0;113;0;0;0
091400068;200;363;363;4;84;115;1;84;5;0;79;0;0;0
091400069;200;383;378;5;63;136;1;63;8;1;54;0;0;0
091400070;200;325;325;8;70;129;1;70;3;0;67;0;0;0
091400071;200;257;257;0;65;134;1;65;0;0;65;0;0;0
091400072;500;329;328;1;68;431;1;68;5;0;63;0;0;0
091400073;100;197;197;0;38;61;1;38;0;0;38;0;0;0
091400074;200;330;330;6;75;124;1;75;5;0;70;0;0;0
091400075;200;263;263;3;73;126;1;73;2;0;71;0;0;0
091400076;200;252;254;6;81;117;2;81;3;0;78;0;0;0
091400077;100;38;38;0;36;64;0;36;0;0;36;0;0;0
091400078;100;67;67;2;68;32;0;68;2;0;66;0;0;0
091400079;100;30;30;0;28;72;0;28;0;0;28;0;0;0
091400080;100;48;48;0;47;53;0;47;0;0;47;0;0;0
091500001;1000;1135;1139;2;382;705;1;294;7;6;281;88;10;78
091500002;1000;1279;1286;2;364;745;1;254;2;7;245;110;8;102
091500003;700;785;793;4;253;534;1;165;3;2;160;88;5;83
091500004;1000;996;1003;5;257;823;4;173;3;1;169;84;8;76
091500005;1000;1292;1297;10;283;783;1;216;6;8;202;67;2;65
091500006;1000;1163;1172;9;298;766;1;233;3;1;229;65;1;64
091500007;400;469;469;10;115;284;1;115;2;1;112;0;0;0
091500008;400;453;453;7;103;296;1;103;2;1;100;0;0;0
091500009;1000;1104;1110;11;236;763;1;236;9;4;223;0;0;0
091500010;300;333;334;10;73;226;1;73;0;0;73;0;0;0
091500011;1000;1214;1227;8;338;662;1;337;11;8;318;1;0;1
091500012;400;442;444;9;121;278;1;121;2;0;119;0;0;0
091500013;500;622;631;7;207;292;1;207;0;5;202;0;0;0
091500014;1000;1398;1424;19;432;566;2;432;12;11;409;0;0;0
091500015;200;197;197;4;46;153;1;46;0;0;46;0;0;0
091500016;300;254;256;7;107;192;1;107;0;0;107;0;0;0
091500017;500;492;494;9;89;410;1;89;1;1;87;0;0;0
091500018;300;234;236;7;50;249;1;50;2;1;47;0;0;0
091500019;300;263;263;9;67;232;1;67;1;0;66;0;0;0
091500020;500;758;758;10;143;356;1;143;7;2;134;0;0;0
091500021;500;514;528;8;159;340;1;159;2;2;155;0;0;0
091500022;500;473;481;6;216;283;1;216;2;1;213;0;0;0
091500023;500;532;533;10;124;374;2;124;1;5;118;0;0;0
091500024;200;153;153;11;37;162;1;37;3;1;33;0;0;0
091500025;200;177;179;8;64;135;1;64;2;0;62;0;0;0
091500026;500;575;568;9;142;357;1;142;2;1;139;0;0;0
091500027;700;795;811;11;148;551;1;148;1;0;147;0;0;0
091500028;300;232;234;5;54;245;1;54;0;0;54;0;0;0
091500029;300;74;294;7;74;225;1;74;0;0;74;0;0;0
091500030;700;762;769;15;177;522;1;177;8;0;169;0;0;0
091500031;200;185;185;6;46;153;1;46;1;0;45;0;0;0
091500032;200;144;144;5;40;159;1;40;5;0;35;0;0;0
091500033;500;501;502;7;98;401;1;98;0;4;94;0;0;0
091500034;600;600;619;12;224;375;1;224;9;1;214;0;0;0
091500035;700;681;681;8;201;699;1;0;0;0;0;201;0;201
091500036;1000;1100;1100;10;237;762;1;237;3;1;233;0;0;0
091500037;200;153;153;6;53;146;1;53;0;0;53;0;0;0
091500038;400;337;337;12;64;335;1;64;0;0;64;0;0;0
091500039;400;352;352;7;46;352;2;46;0;0;46;0;0;0
091500040;300;221;221;7;51;248;1;51;0;0;51;0;0;0
091500041;300;205;205;11;46;253;1;46;0;1;45;0;0;0
091500042;600;585;585;14;293;306;1;293;0;0;293;0;0;0
091500043;600;611;627;9;271;330;1;269;3;2;264;2;0;2
091500044;200;154;154;7;71;128;1;71;1;0;70;0;0;0
091500045;200;185;185;7;69;130;1;69;1;1;67;0;0;0
091500046;200;119;119;7;22;177;1;22;0;0;22;0;0;0
091500047;1000;1040;1064;13;241;752;7;241;10;2;229;0;0;0
091500048;500;449;453;13;126;373;1;126;2;0;124;0;0;0
091500049;500;633;636;9;104;394;2;104;3;1;100;0;0;0
091500050;300;275;275;5;54;245;1;54;0;1;53;0;0;0
091500051;200;187;187;10;50;149;1;50;0;1;49;0;0;0
091500052;500;690;698;16;160;338;2;160;2;0;158;0;0;0
091500053;300;266;268;8;55;244;1;55;0;0;55;0;0;0
091500054;300;405;405;10;72;299;1;0;0;0;0;72;0;72
091500055;300;367;367;12;74;225;1;74;1;0;73;0;0;0
091500056;200;130;130;8;47;152;1;47;0;0;47;0;0;0
091500057;300;114;293;4;114;184;2;114;1;7;106;0;0;0
091500058;200;190;190;3;128;71;1;128;2;1;125;0;0;0
091500059;300;230;231;2;101;198;1;101;0;0;101;0;0;0
091500060;100;78;78;6;54;45;1;54;0;0;54;0;0;0
091500061;100;39;39;9;34;64;2;34;1;0;33;0;0;0
091500062;100;39;40;7;46;53;1;46;0;0;46;0;0;0
091500063;400;396;396;3;217;193;1;206;6;5;195;11;0;11
091500064;300;222;222;3;109;188;3;109;1;5;103;0;0;0
091500065;300;261;261;9;48;250;2;48;1;0;47;0;0;0
091500066;200;134;134;3;30;168;2;30;0;0;30;0;0;0
091500067;300;21;342;9;30;270;0;30;2;1;27;0;0;0
091500068;100;72;72;6;52;47;1;52;0;1;51;0;0;0
091500069;500;484;485;7;209;290;1;209;6;4;199;0;0;0
091500070;500;447;447;8;178;321;1;178;2;0;176;0;0;0
091500071;300;345;345;9;78;221;1;78;1;0;77;0;0;0
091500072;200;119;123;7;40;159;1;40;1;1;38;0;0;0
091500073;200;141;141;6;26;173;1;26;0;0;26;0;0;0
091500074;100;103;79;5;11;88;1;11;0;0;11;0;0;0
091500075;200;138;151;5;54;145;1;54;1;0;53;0;0;0
091500076;400;430;434;6;94;305;1;94;3;0;91;0;0;0
091500077;300;221;221;9;35;264;1;35;2;0;33;0;0;0
091500078;100;85;85;7;15;84;1;15;0;0;15;0;0;0
091500079;50;32;32;8;29;20;1;29;2;1;26;0;0;0
091500080;100;53;53;0;49;51;0;49;0;0;49;0;0;0
091500081;50;29;29;0;28;22;0;28;0;0;28;0;0;0
091500082;100;40;40;0;40;60;0;40;0;0;40;0;0;0
091500083;50;36;36;0;35;14;1;35;0;0;35;0;0;0
091500084;50;28;28;0;27;23;0;27;1;0;26;0;0;0
091500085;100;49;49;0;45;55;0;45;0;0;45;0;0;0
091500086;100;38;38;2;40;60;0;40;1;0;39;0;0;0
091600001;800;837;841;8;187;674;3;123;5;3;115;64;4;60
091600002;1000;1158;1160;7;148;877;1;122;6;0;116;26;0;26
091600003;800;807;807;7;150;692;1;107;4;2;101;43;0;43
091600004;800;816;816;4;158;697;1;102;3;1;98;56;2;54
091600005;500;474;474;7;148;413;1;86;1;2;83;62;1;61
091600006;900;887;887;6;140;762;1;137;15;2;120;3;0;3
091600007;700;726;727;7;132;567;1;132;12;0;120;0;0;0
091600008;800;817;817;10;162;637;1;162;26;1;135;0;0;0
091600009;600;644;644;10;92;507;1;92;11;0;81;0;0;0
091600010;300;375;375;4;97;246;1;53;1;2;50;44;3;41
091600011;1000;1071;1071;6;359;807;2;191;2;4;185;168;3;165
091600012;800;763;764;9;302;642;1;157;2;5;150;145;7;138
091600013;700;789;793;9;292;540;1;159;2;3;154;133;7;126
091600014;600;571;571;8;207;504;1;95;1;1;93;112;1;111
091600015;600;561;565;10;238;471;1;128;1;4;123;110;6;104
091600016;600;570;571;9;160;496;1;103;1;3;99;57;3;54
091600017;500;461;463;7;177;388;1;111;1;8;102;66;3;63
091600018;700;722;725;6;264;543;1;156;1;3;152;108;8;100
091600019;500;543;545;9;230;375;1;124;2;1;121;106;4;102
091600020;900;945;946;8;374;643;1;256;1;7;248;118;6;112
091600021;700;674;674;7;232;579;1;120;1;4;115;112;3;109
091600022;600;612;613;8;218;479;1;120;3;2;115;98;5;93
091600023;600;615;615;7;208;502;2;96;4;2;90;112;11;101
091600024;700;663;663;10;231;579;1;120;5;4;111;111;4;107
091600025;600;635;635;5;191;521;1;78;3;6;69;113;7;106
091600026;600;636;641;7;212;475;1;124;3;8;113;88;4;84
091600027;500;521;522;6;194;407;2;91;1;3;87;103;11;92
091600028;700;651;653;4;216;569;1;130;2;5;123;86;3;83
091600029;500;481;481;3;156;408;1;91;1;2;88;65;6;59
091600030;600;640;640;13;166;493;1;106;2;3;101;60;2;58
091600031;700;707;712;6;184;595;1;104;2;0;102;80;1;79
091600032;500;555;557;10;157;413;0;87;2;2;83;70;7;63
091600033;600;594;597;9;199;474;1;125;3;3;119;74;4;70
091600034;600;596;599;10;169;508;3;89;0;2;87;80;8;72
091600035;600;639;640;4;159;475;1;124;2;2;120;35;2;33
091600036;400;398;398;7;150;295;1;104;2;3;99;46;3;43
091600037;400;440;440;4;164;313;1;86;3;2;81;78;8;70
091600038;500;584;584;2;209;379;2;119;4;5;110;90;4;86
091600039;600;586;587;6;172;505;1;94;3;3;88;78;3;75
091600040;700;700;703;8;169;599;1;100;3;1;96;69;5;64
091600041;500;546;547;4;161;405;3;92;1;4;87;69;1;68
091600042;800;868;869;10;224;624;2;174;3;5;166;50;4;46
091600043;1000;1056;1056;10;276;800;1;199;10;6;183;77;7;70
091600044;900;900;901;9;300;703;1;196;6;5;185;104;6;98
091600045;1000;997;1000;6;285;802;3;195;12;3;180;90;10;80
091600046;1000;979;979;6;286;800;1;199;3;3;193;87;4;83
091600047;900;920;923;8;285;728;1;171;8;6;157;114;7;107
091600048;700;742;743;5;210;537;2;161;6;3;152;49;1;48
091600049;1000;1030;1033;7;259;826;1;173;5;3;165;86;7;79
091600050;900;833;833;3;245;754;1;145;3;3;139;100;7;93
091600051;1000;1216;1217;6;358;776;1;223;4;4;215;135;4;131
091600052;1000;961;962;6;311;766;2;232;14;6;212;79;5;74
091600053;1000;960;964;5;284;794;1;205;10;6;189;79;3;76
091600054;1000;1002;1002;8;302;780;1;219;4;3;212;83;2;81
091600055;1200;1650;1650;5;400;906;1;293;15;3;275;107;7;100
091600056;1000;1017;1019;7;220;829;2;169;8;2;159;51;4;47
091600057;1000;1042;1042;11;287;829;1;170;8;5;157;117;5;112
091600058;1000;1051;1052;9;307;780;3;217;4;1;212;90;5;85
091600059;1000;1006;1010;9;230;836;1;163;6;0;157;67;4;63
091600060;500;484;485;5;123;446;1;53;3;0;50;70;0;70
091600061;1000;907;908;8;187;835;1;164;16;3;145;23;3;20
091600062;1000;982;982;11;262;788;1;211;6;1;204;51;4;47
091600063;800;849;849;11;185;631;1;168;12;2;154;17;0;17
091600064;1000;985;992;3;354;779;1;220;5;2;213;134;2;132
091600065;900;912;912;10;231;687;1;212;9;1;202;19;1;18
091600066;700;651;665;9;195;529;3;168;10;0;158;27;2;25
091600067;700;697;704;6;148;553;1;146;4;1;141;2;0;2
091600068;500;544;545;10;146;352;2;146;4;0;142;0;0;0
091600069;800;812;816;9;182;625;3;172;24;3;145;10;0;10
091600070;200;268;268;6;83;116;1;83;5;1;77;0;0;0
091600071;400;339;343;7;72;327;1;72;5;0;67;0;0;0
091600072;600;616;618;9;152;447;1;152;1;1;150;0;0;0
091600073;900;890;894;13;258;671;0;229;8;3;218;29;0;29
091600074;300;285;288;9;82;217;1;82;0;0;82;0;0;0
091600075;600;663;664;10;191;408;1;191;5;1;185;0;0;0
091600076;500;503;508;9;192;306;2;192;2;0;190;0;0;0
091600077;900;889;904;18;187;713;1;186;5;2;179;1;0;1
091600078;300;317;317;8;99;200;1;99;0;1;98;0;0;0
091600079;400;492;490;8;154;243;3;154;3;2;149;0;0;0
091600080;700;740;743;9;221;483;1;216;12;3;201;5;0;5
091600081;500;555;557;9;170;329;1;170;3;0;167;0;0;0
091600082;400;445;449;10;135;265;0;135;5;2;128;0;0;0
091600083;500;518;524;10;168;331;1;168;1;2;165;0;0;0
091600084;400;424;441;11;177;222;1;177;7;2;168;0;0;0
091600085;200;260;261;9;117;82;1;117;1;1;115;0;0;0
091600086;200;279;279;6;88;111;1;88;8;1;79;0;0;0
091600087;100;114;114;8;58;41;1;58;1;0;57;0;0;0
091600088;200;294;294;7;107;92;1;107;1;1;105;0;0;0
091600089;400;394;395;7;111;287;2;111;1;0;110;0;0;0
091600090;600;669;669;9;222;383;1;216;4;3;209;6;1;5
091600091;400;457;465;8;166;233;1;166;6;5;155;0;0;0
091600092;400;436;439;9;175;356;1;43;1;0;42;132;0;132
091600093;700;180;703;16;196;510;4;186;9;2;175;10;0;10
091600094;700;729;732;14;177;522;1;177;10;1;166;0;0;0
091600095;500;520;520;9;163;336;1;163;5;2;156;0;0;0
091600096;700;755;758;42;285;414;1;285;11;0;274;0;0;0
091600097;500;563;573;14;182;317;1;182;3;1;178;0;0;0
091600098;500;516;523;12;187;312;1;187;3;7;177;0;0;0
091600099;700;714;723;8;283;418;2;280;15;2;263;3;0;3
091600100;200;285;285;7;109;90;1;109;3;0;106;0;0;0
091600101;400;447;429;9;111;288;1;111;2;0;109;0;0;0
091600102;1000;902;1006;12;265;734;1;265;16;2;247;0;0;0
091600103;100;184;184;6;71;28;1;71;2;1;68;0;0;0
091600104;800;824;824;11;238;561;1;238;17;1;220;0;0;0
091600105;800;869;869;11;196;603;1;196;0;2;194;0;0;0
091600106;900;937;948;19;262;663;1;236;6;4;226;26;0;26
091600107;700;761;761;12;246;454;1;245;4;0;241;1;0;1
091600108;700;762;762;12;196;502;2;196;11;0;185;0;0;0
091600109;400;395;400;7;113;286;1;113;5;0;108;0;0;0
091600110;500;533;533;14;178;323;1;176;1;1;174;2;0;2
091600111;400;418;418;8;144;255;1;144;8;1;135;0;0;0
091600112;900;935;935;10;244;669;1;230;16;3;211;14;0;14
091600113;600;610;610;11;241;358;1;241;7;3;231;0;0;0
091600114;500;575;575;6;175;324;1;175;4;2;169;0;0;0
091600115;500;498;498;9;93;406;1;93;1;0;92;0;0;0
091600116;400;428;428;8;122;277;1;122;2;0;120;0;0;0
091600117;1000;1015;1015;13;278;721;1;278;3;2;273;0;0;0
091600118;1000;1070;1076;10;215;783;2;215;3;7;205;0;0;0
091600119;300;397;397;7;111;187;2;111;2;2;107;0;0;0
091600120;1000;1003;1010;15;232;767;1;232;8;3;221;0;0;0
091600121;400;464;465;8;141;257;2;141;7;0;134;0;0;0
091600122;500;621;617;11;170;327;3;170;1;1;168;0;0;0
091600123;100;162;162;7;62;37;1;62;2;0;60;0;0;0
091600124;700;730;732;12;208;489;3;208;11;2;195;0;0;0
091600125;300;356;356;11;110;206;1;93;0;1;92;17;0;17
091600126;400;474;474;12;195;398;1;1;0;0;1;194;1;193
091600127;700;723;733;5;181;520;1;179;7;3;169;2;0;2
091600128;800;804;813;7;214;600;1;199;6;5;188;15;1;14
091600129;1000;1060;1069;10;241;757;2;241;6;2;233;0;0;0
091600130;800;843;843;9;179;626;1;173;11;1;161;6;0;6
091600131;600;657;658;15;214;384;2;214;3;1;210;0;0;0
091600132;900;883;896;13;277;622;1;277;11;2;264;0;0;0
091600133;800;826;828;7;201;619;1;180;8;1;171;21;0;21
091600134;200;275;275;8;89;110;1;89;3;0;86;0;0;0
091600135;500;551;551;7;183;385;1;114;5;4;105;69;4;65
091600136;400;488;488;4;127;322;2;76;2;5;69;51;3;48
091600137;500;569;570;4;151;412;1;87;2;3;82;64;3;61
091600138;600;609;610;7;199;518;1;81;0;3;78;118;5;113
091600139;400;144;466;3;146;294;2;104;1;1;102;42;1;41
091600140;800;793;799;10;206;594;2;204;6;1;197;2;0;2
091600141;200;254;255;9;70;129;1;70;0;0;70;0;0;0
091600142;400;390;390;7;144;255;1;144;9;2;133;0;0;0
091600143;400;367;367;7;99;299;2;99;1;3;95;0;0;0
091600144;400;424;431;7;95;302;3;95;1;2;92;0;0;0
091600145;400;377;392;7;104;295;1;104;1;1;102;0;0;0
091600146;400;382;382;6;137;265;1;134;5;4;125;3;0;3
091600147;400;422;424;11;151;247;2;151;4;0;147;0;0;0
091600148;500;530;534;10;173;326;1;173;1;2;170;0;0;0
091600149;300;360;363;9;151;299;1;0;0;0;0;151;4;147
091600150;300;334;334;3;111;188;1;111;3;1;107;0;0;0
091600151;200;220;226;9;75;124;1;75;2;0;73;0;0;0
091600152;200;232;238;5;69;130;1;69;2;0;67;0;0;0
091600153;600;642;650;13;130;469;1;130;5;1;124;0;0;0
091600154;300;262;262;9;103;196;1;103;0;1;102;0;0;0
091600155;300;363;364;10;88;212;1;87;9;0;78;1;0;1
091600156;200;238;239;12;106;93;1;106;3;1;102;0;0;0
091600157;100;134;136;9;59;40;1;59;1;1;57;0;0;0
091600158;200;32;32;56;72;127;1;72;1;1;70;0;0;0
091600159;200;126;126;8;77;122;1;77;13;0;64;0;0;0
091600160;100;41;41;0;40;60;0;40;0;0;40;0;0;0
091600161;100;64;64;7;66;34;0;66;1;0;65;0;0;0
091600162;100;42;42;6;46;54;0;46;0;1;45;0;0;0
091600163;100;25;25;7;32;67;1;32;0;0;32;0;0;0
091600164;100;29;29;8;36;63;1;36;0;0;36;0;0;0
091600165;100;23;23;5;27;72;1;27;3;0;24;0;0;0
091600166;100;29;29;6;34;66;0;34;1;0;33;0;0;0
091600167;100;59;59;6;64;36;0;64;1;0;63;0;0;0
091600168;100;62;62;6;65;35;0;65;4;0;61;0;0;0
091600169;100;42;42;8;50;50;0;50;3;0;47;0;0;0
092100001;500;1200;1201;10;333;234;1;265;7;4;254;68;2;66
092100002;500;1315;1327;9;311;259;1;240;9;6;225;71;0;71
092100003;500;991;991;6;228;295;1;204;6;5;193;24;2;22
092100004;500;1054;1066;10;286;276;1;223;1;2;220;63;1;62
092100005;500;1191;1208;14;338;193;1;306;4;8;294;32;1;31
092100006;500;1375;1375;13;295;244;1;255;14;3;238;40;0;40
092100007;500;1558;1579;13;361;204;1;295;23;2;270;66;5;61
092100008;500;1391;1404;6;320;183;1;316;11;6;299;4;1;3
092100009;500;993;995;4;242;315;2;183;5;10;168;59;4;55
092100010;500;1221;1221;4;264;286;3;211;14;2;195;53;3;50
092100011;500;1394;1394;10;387;138;1;361;7;7;347;26;0;26
092100012;200;184;190;8;70;129;1;70;0;1;69;0;0;0
092100013;500;1140;1140;8;329;172;1;327;5;4;318;2;0;2
092100014;200;250;250;9;87;112;1;87;4;0;83;0;0;0
092100015;100;73;76;8;33;66;1;33;0;0;33;0;0;0
092100016;200;309;309;8;85;114;1;85;2;0;83;0;0;0
092100017;300;406;410;7;92;207;1;92;1;1;90;0;0;0
092100018;300;530;530;11;159;138;3;159;8;3;148;0;0;0
092100019;200;222;222;8;53;146;1;53;0;0;53;0;0;0
092100020;200;324;324;12;107;93;1;106;1;0;105;1;0;1
092100021;300;698;716;8;148;151;1;148;10;3;135;0;0;0
092100022;100;76;78;8;31;68;1;31;0;0;31;0;0;0
092100023;200;146;152;7;52;147;1;52;0;0;52;0;0;0
092100024;300;448;448;11;140;159;1;140;3;2;135;0;0;0
092100025;300;621;627;11;179;138;1;161;10;0;151;18;0;18
092100026;300;522;531;12;154;145;1;154;1;2;151;0;0;0
092100027;200;303;304;9;104;191;1;8;0;0;8;96;0;96
092100028;100;101;103;8;39;60;1;39;1;0;38;0;0;0
092100029;400;1012;1024;11;238;167;1;232;6;4;222;6;0;6
092100030;200;268;268;11;57;141;2;57;3;1;53;0;0;0
092100031;100;57;57;8;25;74;1;25;4;0;21;0;0;0
092100033;200;452;469;6;141;58;1;141;0;1;140;0;0;0
092100034;400;1032;1055;7;229;169;2;229;2;4;223;0;0;0
092100035;200;374;374;7;126;73;1;126;4;1;121;0;0;0
092100036;300;540;540;11;133;166;1;133;4;1;128;0;0;0
092100037;300;655;667;12;167;132;1;167;6;0;161;0;0;0
092100038;300;523;523;9;145;152;3;145;4;1;140;0;0;0
092100039;200;187;187;8;78;121;1;78;1;0;77;0;0;0
092100040;300;775;787;10;152;143;5;152;4;0;148;0;0;0
092100041;100;109;109;6;35;64;1;35;3;0;32;0;0;0
092100042;100;117;117;8;53;46;1;53;0;0;53;0;0;0
092100043;400;834;844;9;142;257;1;142;6;1;135;0;0;0
092100044;200;284;287;9;69;128;3;69;2;0;67;0;0;0
092100045;200;490;503;10;130;69;1;130;1;0;129;0;0;0
092100046;300;698;725;8;140;159;1;140;6;0;134;0;0;0
092100047;400;837;854;8;218;182;1;217;14;3;200;1;0;1
092100048;200;184;193;9;71;128;1;71;1;0;70;0;0;0
092100049;300;331;348;7;105;194;1;105;3;0;102;0;0;0
092100050;100;136;138;6;47;52;1;47;0;0;47;0;0;0
092100051;300;440;466;8;183;117;0;183;3;2;178;0;0;0
092100052;200;252;252;8;132;67;1;132;0;0;132;0;0;0
092100053;100;114;120;7;52;47;1;52;0;1;51;0;0;0
092100054;100;92;92;6;50;49;1;50;0;1;49;0;0;0
092100055;100;100;100;8;37;62;1;37;0;2;35;0;0;0
092100056;500;1122;1140;8;294;264;1;235;6;3;226;59;2;57
092100057;200;140;140;5;118;82;0;118;0;0;118;0;0;0
092100058;100;90;90;5;91;9;0;91;2;0;89;0;0;0
092100059;100;58;58;4;59;41;0;59;6;0;53;0;0;0
092100060;200;94;94;0;86;114;0;86;3;0;83;0;0;0
092100061;100;72;72;2;73;27;0;73;0;0;73;0;0;0
092100062;100;46;46;0;43;57;0;43;2;0;41;0;0;0
092100063;100;29;29;8;29;70;1;29;1;0;28;0;0;0
093500001;300;298;307;5;134;200;1;99;0;2;97;35;1;34
093500002;500;599;603;4;151;367;1;132;4;1;127;19;0;19
093500003;300;296;296;5;133;166;1;133;1;0;132;0;0;0
093500004;300;334;336;6;136;164;1;135;1;1;133;1;0;1
093500005;300;238;231;7;104;195;1;104;1;2;101;0;0;0
093500006;300;357;357;7;92;207;1;92;2;1;89;0;0;0
093500007;300;346;346;5;101;196;3;101;1;0;100;0;0;0
093500008;300;299;301;11;121;172;7;121;6;2;113;0;0;0
093500009;300;330;340;6;137;160;3;137;3;1;133;0;0;0
093500010;300;306;320;5;141;159;1;140;6;4;130;1;1;0
093500011;700;802;810;11;210;489;1;210;7;0;203;0;0;0
093500012;400;508;514;8;213;186;1;213;19;1;193;0;0;0
093500013;400;449;454;6;191;208;1;191;3;4;184;0;0;0
093500014;200;187;187;6;95;104;1;95;3;1;91;0;0;0
093500015;200;270;270;4;88;111;1;88;1;0;87;0;0;0
093500016;100;88;89;3;62;37;1;62;0;1;61;0;0;0
093500017;800;918;925;7;285;514;1;285;6;2;277;0;0;0
093500018;300;327;328;5;101;238;1;61;1;0;60;40;2;38
093500019;700;706;715;5;343;356;1;343;4;0;339;0;0;0
093500020;800;800;847;6;341;459;1;340;10;6;324;1;0;1
093500021;900;916;941;7;327;571;2;327;8;3;316;0;0;0
093500022;400;445;451;3;170;229;1;170;5;0;165;0;0;0
093500023;200;229;229;4;76;123;1;76;1;0;75;0;0;0
093500024;100;131;131;5;65;34;1;65;1;0;64;0;0;0
093500025;200;168;168;4;57;142;1;57;0;0;57;0;0;0
093500026;100;47;47;5;34;65;1;34;0;1;33;0;0;0
093500027;300;372;377;7;157;141;2;157;4;2;151;0;0;0
093500028;200;126;128;7;80;116;4;80;3;0;77;0;0;0
093500029;100;66;66;6;28;71;1;28;1;0;27;0;0;0
093500030;300;314;314;1;119;180;1;119;0;0;119;0;0;0
093500031;200;248;256;5;95;104;1;95;3;0;92;0;0;0
093500032;300;298;298;2;145;154;1;145;3;0;142;0;0;0
093500033;200;142;142;4;51;148;1;51;1;0;50;0;0;0
093500034;100;114;114;6;66;32;2;66;0;0;66;0;0;0
093500035;100;125;125;6;38;61;1;38;1;0;37;0;0;0
093500036;200;124;124;7;31;168;1;31;1;0;30;0;0;0
093500037;100;91;91;5;52;47;1;52;2;1;49;0;0;0
093500038;300;272;272;4;90;209;1;90;0;0;90;0;0;0
093500039;200;90;90;5;93;107;0;93;0;0;93;0;0;0
093500040;100;46;46;3;48;52;0;48;0;0;48;0;0;0
093500041;100;100;100;4;45;55;0;45;2;0;43;0;0;0
100400001;500;513;514;5;171;376;1;123;4;5;114;48;1;47
100400002;500;495;496;8;152;386;1;113;2;3;108;39;6;33
100400003;600;612;615;4;189;467;1;132;3;2;127;57;6;51
100400004;500;474;476;8;148;403;1;96;6;3;87;52;1;51
100400005;600;640;640;6;195;456;2;142;4;3;135;53;1;52
100400006;700;716;722;9;252;552;1;147;1;2;144;105;4;101
100400007;300;329;330;6;135;215;1;84;2;2;80;51;1;50
100400008;500;519;519;4;195;365;1;134;4;1;129;61;4;57
100400009;500;545;545;5;200;349;1;150;3;9;138;50;3;47
100400010;200;215;219;4;100;99;1;100;2;2;96;0;0;0
100400011;300;334;336;5;127;221;1;78;3;1;74;49;2;47
100400012;200;195;195;4;83;116;1;83;2;4;77;0;0;0
100400013;100;74;76;7;40;59;1;40;3;0;37;0;0;0
100400014;150;153;153;1;89;60;1;89;0;6;83;0;0;0
100400015;70;49;50;8;31;38;1;31;0;0;31;0;0;0
100400016;100;85;85;7;51;48;1;51;3;2;46;0;0;0
100400017;100;82;82;5;38;61;1;38;1;1;36;0;0;0
100400018;100;53;56;5;20;79;1;20;0;0;20;0;0;0
100400019;50;30;30;8;15;34;1;15;0;0;15;0;0;0
100400020;80;55;55;7;33;46;1;33;0;1;32;0;0;0
100400021;50;32;32;6;23;26;1;23;1;0;22;0;0;0
100400022;50;35;35;7;22;27;1;22;2;1;19;0;0;0
100400023;120;106;107;6;36;83;1;36;1;0;35;0;0;0
100400024;20;10;10;8;13;6;1;13;1;0;12;0;0;0
100400025;50;43;43;8;35;14;1;35;6;2;27;0;0;0
100400026;30;20;20;10;10;19;1;10;0;0;10;0;0;0
100400027;30;20;20;7;25;4;1;25;0;0;25;0;0;0
100500001;450;454;454;2;169;321;1;128;9;1;118;41;2;39
100500002;470;475;479;2;181;323;1;146;6;1;139;35;1;34
100500003;330;330;330;5;193;136;1;193;9;0;184;0;0;0
100500004;240;241;247;3;105;134;1;105;2;1;102;0;0;0
100500005;280;283;284;6;127;152;1;127;5;3;119;0;0;0
100500006;40;31;31;4;21;18;1;21;1;0;20;0;0;0
100500007;35;27;29;6;23;11;1;23;1;0;22;0;0;0
100500008;40;30;30;6;24;15;1;24;0;1;23;0;0;0
100500009;60;51;52;4;36;23;1;36;1;0;35;0;0;0
100500010;30;23;24;7;18;11;1;18;0;0;18;0;0;0
100500011;25;14;14;0;12;12;1;12;0;0;12;0;0;0
102700001;300;297;297;2;118;180;2;118;3;3;112;0;0;0
102700002;380;450;450;0;186;247;2;131;0;3;128;55;2;53
102700003;380;442;442;0;148;264;1;115;1;0;114;33;2;31
102700004;300;331;331;3;114;219;2;79;1;5;73;35;1;34
102700005;220;213;214;3;86;133;1;86;2;6;78;0;0;0
102700006;200;187;187;1;75;124;1;75;5;3;67;0;0;0
102700007;200;226;226;3;92;107;1;92;4;1;87;0;0;0
102700008;300;278;278;4;117;181;2;117;7;1;109;0;0;0
102700009;250;265;265;4;102;147;1;102;3;0;99;0;0;0
102700010;50;29;29;5;21;28;1;21;0;0;21;0;0;0
102700011;120;105;105;4;68;51;1;68;2;0;66;0;0;0
102700012;50;44;44;0;23;26;1;23;0;0;23;0;0;0
102700013;50;41;41;2;20;29;1;20;1;0;19;0;0;0
102700014;50;30;30;6;13;36;1;13;0;0;13;0;0;0
102700015;100;61;61;6;38;61;1;38;0;1;37;0;0;0
102700016;50;38;38;11;43;6;1;43;8;1;34;0;0;0
102900001;1000;1044;1046;9;166;854;1;145;41;2;102;21;2;19
102900002;1000;912;912;6;246;855;1;144;5;2;137;102;4;98
102900003;1000;892;895;4;222;885;1;114;3;2;109;108;1;107
102900004;1000;996;998;7;278;857;1;142;2;8;132;136;7;129
102900005;1000;926;927;7;182;895;2;103;2;4;97;79;5;74
102900006;500;533;533;4;166;411;2;87;1;1;85;79;5;74
102900007;500;572;572;9;196;389;2;109;1;2;106;87;7;80
102900008;500;641;643;5;226;358;1;141;4;1;136;85;7;78
102900009;1000;939;940;7;296;833;1;166;6;6;154;130;4;126
102900010;500;698;699;4;185;397;1;102;2;0;100;83;5;78
102900011;500;526;527;4;164;415;1;84;3;2;79;80;4;76
102900012;500;662;663;8;244;369;2;129;5;3;121;115;7;108
102900013;1000;895;899;6;229;836;1;163;7;8;148;66;4;62
102900014;1000;994;1039;9;197;863;1;136;6;1;129;61;2;59
102900015;1000;963;964;6;272;853;1;146;2;3;141;126;8;118
102900016;1000;1025;1029;7;175;853;2;145;12;3;130;30;3;27
102900017;1000;924;924;8;190;868;1;131;17;0;114;59;2;57
102900018;1000;985;986;6;207;891;1;108;4;4;100;99;5;94
102900019;500;830;832;9;144;407;2;91;0;0;91;53;0;53
102900020;1000;950;951;7;255;863;1;136;3;3;130;119;3;116
102900021;1000;909;912;6;299;822;1;177;2;2;173;121;6;115
102900022;500;663;664;9;198;415;1;84;2;1;81;114;7;107
102900023;1000;1114;1116;10;229;834;1;165;29;6;130;64;6;58
102900024;1000;942;946;10;304;825;1;174;3;2;169;130;6;124
102900025;500;884;884;4;267;355;1;144;2;3;139;123;5;118
102900026;500;758;759;6;217;389;1;110;4;1;105;107;10;97
102900027;500;762;762;7;242;375;2;123;4;6;113;119;5;114
102900028;1000;944;944;6;272;847;1;152;3;5;144;120;7;113
102900029;500;809;810;8;215;353;1;146;4;7;135;69;2;67
102900030;500;721;721;5;211;402;1;97;7;1;89;114;2;112
102900031;1000;976;977;6;328;844;1;155;5;6;144;173;8;165
102900032;1000;999;999;6;205;894;1;105;2;2;101;100;4;96
102900033;1000;985;985;7;274;865;2;133;1;0;132;141;5;136
102900034;500;750;750;9;193;400;1;99;2;5;92;94;3;91
102900035;500;800;801;8;231;385;2;113;1;3;109;118;11;107
102900036;500;678;679;9;190;322;2;176;0;6;170;14;0;14
102900037;700;784;784;9;240;579;2;119;1;4;114;121;4;117
102900038;500;812;814;8;277;339;1;160;6;2;152;117;5;112
102900039;800;882;882;8;271;531;2;267;7;6;254;4;1;3
102900040;700;742;745;2;226;585;1;114;1;0;113;112;8;104
102900041;700;724;726;8;224;570;4;126;5;1;120;98;6;92
102900042;800;820;820;2;196;691;2;107;1;6;100;89;4;85
102900043;500;604;604;9;194;405;1;94;4;1;89;100;6;94
102900044;1000;900;900;5;281;870;1;129;4;3;122;152;5;147
102900045;1000;918;921;4;263;854;5;141;4;7;130;122;3;119
102900046;700;719;719;7;231;599;1;100;7;2;91;131;3;128
102900047;800;788;788;8;202;690;1;109;5;1;103;93;5;88
102900048;1000;980;981;5;302;824;1;175;9;8;158;127;7;120
102900049;500;689;690;4;196;394;1;105;4;3;98;91;6;85
102900050;1000;991;991;4;177;856;12;132;12;1;119;45;4;41
102900051;1000;916;918;5;235;844;3;153;2;5;146;82;2;80
102900052;700;758;758;8;246;466;1;233;2;15;216;13;0;13
102900053;500;594;595;5;174;408;1;91;1;3;87;83;6;77
102900054;800;877;880;6;270;642;2;156;5;3;148;114;7;107
102900055;1000;946;946;3;291;831;8;161;7;4;150;130;6;124
102900056;800;861;861;9;219;663;1;136;0;2;134;83;6;77
102900057;700;747;747;6;181;610;1;89;1;0;88;92;7;85
102900058;800;850;850;6;136;704;1;95;5;2;88;41;4;37
102900059;700;774;775;6;189;591;1;108;7;4;97;81;5;76
102900060;700;685;686;5;176;589;1;110;7;4;99;66;1;65
102900061;700;656;657;5;151;617;2;81;3;1;77;70;4;66
102900062;100;48;48;8;19;80;1;19;0;0;19;0;0;0
102900063;500;599;599;3;120;409;2;89;3;0;86;31;2;29
102900064;200;205;206;6;67;130;3;67;4;2;61;0;0;0
102900065;100;46;46;6;16;83;1;16;0;0;16;0;0;0
102900066;100;13;13;6;10;89;1;10;0;0;10;0;0;0
102900067;100;84;84;7;43;56;1;43;0;0;43;0;0;0
102900068;100;65;65;6;23;76;1;23;2;0;21;0;0;0
102900069;100;12;12;7;11;88;1;11;0;0;11;0;0;0
102900070;100;21;21;7;12;87;1;12;0;0;12;0;0;0
102900071;200;207;207;5;56;143;1;56;3;2;51;0;0;0
102900072;300;248;248;5;58;241;1;58;4;2;52;0;0;0
102900073;100;77;77;6;19;80;1;19;0;0;19;0;0;0
102900074;500;503;504;4;163;384;3;113;1;6;106;50;4;46
102900075;400;413;413;3;141;310;1;89;2;4;83;52;2;50
102900076;300;261;262;4;75;224;1;75;2;5;68;0;0;0
102900077;300;361;361;5;124;213;1;86;5;1;80;38;3;35
102900078;100;101;101;5;40;59;1;40;2;2;36;0;0;0
102900079;200;261;261;6;25;174;1;25;1;0;24;0;0;0
102900080;700;786;787;6;231;554;1;145;4;2;139;86;8;78
102900081;900;878;879;6;230;735;1;164;2;5;157;66;3;63
102900082;500;553;557;5;144;382;1;117;5;3;109;27;0;27
102900083;100;21;21;4;13;86;1;13;0;0;13;0;0;0
102900084;100;106;108;4;50;48;2;50;2;0;48;0;0;0
102900085;100;123;124;7;60;39;1;60;3;1;56;0;0;0
102900086;100;123;123;6;36;63;1;36;0;2;34;0;0;0
102900087;500;497;500;5;145;405;1;94;4;0;90;51;2;49
102900088;800;825;825;9;259;617;1;182;4;10;168;77;5;72
102900089;100;156;156;3;71;28;1;71;0;1;70;0;0;0
102900090;900;970;970;6;217;723;1;176;1;5;170;41;1;40
102900091;700;200;742;5;205;579;2;119;6;7;106;86;5;81
102900092;100;104;104;6;58;41;1;58;1;1;56;0;0;0
102900093;600;687;687;4;203;459;1;140;1;10;129;63;6;57
102900094;100;75;75;7;32;67;1;32;1;0;31;0;0;0
102900095;100;124;125;5;54;45;1;54;2;2;50;0;0;0
102900096;400;414;414;4;87;330;2;68;1;0;67;19;0;19
102900097;100;109;110;4;32;66;2;32;0;2;30;0;0;0
102900098;200;195;195;6;80;119;1;80;0;1;79;0;0;0
102900099;100;86;86;4;39;60;1;39;1;0;38;0;0;0
102900100;300;328;328;3;129;226;1;73;2;2;69;56;4;52
102900101;200;200;200;6;76;123;1;76;7;5;64;0;0;0
102900102;500;519;519;3;144;404;1;95;4;8;83;49;2;47
102900103;100;74;74;7;35;64;1;35;2;2;31;0;0;0
102900104;400;422;423;6;114;318;1;81;2;3;76;33;0;33
102900105;300;331;331;4;105;192;3;105;1;0;104;0;0;0
102900106;600;686;689;2;204;477;2;121;2;2;117;83;6;77
102900107;100;161;161;3;57;41;2;57;1;0;56;0;0;0
102900108;800;882;890;2;167;675;2;123;4;6;113;44;1;43
102900109;100;68;68;10;48;51;1;48;5;2;41;0;0;0
102900110;100;17;17;12;20;79;1;20;1;0;19;0;0;0
102900111;100;68;68;6;36;63;1;36;1;4;31;0;0;0
102900113;100;20;20;3;23;76;1;23;0;0;23;0;0;0
102900114;100;18;18;6;24;75;1;24;0;0;24;0;0;0
103100001;250;275;275;6;100;149;1;100;2;2;96;0;0;0
103100002;30;20;20;6;13;16;1;13;0;0;13;0;0;0
103100003;100;99;99;7;44;55;1;44;3;0;41;0;0;0
103100004;35;23;23;5;21;13;1;21;0;0;21;0;0;0
103100005;80;72;72;6;39;40;1;39;1;0;38;0;0;0
103100006;70;55;55;7;33;36;1;33;0;1;32;0;0;0
103100007;65;52;52;6;34;30;1;34;1;0;33;0;0;0
103100008;30;16;16;6;15;14;1;15;0;0;15;0;0;0
103100009;45;29;29;7;24;20;1;24;0;1;23;0;0;0
103100010;110;110;110;4;28;81;1;28;2;0;26;0;0;0
103100011;35;23;23;7;25;9;1;25;2;0;23;0;0;0
103100012;245;413;413;7;157;132;1;112;7;4;101;45;5;40
103100013;80;73;73;4;40;40;0;40;0;1;39;0;0;0
103100014;45;32;32;7;26;18;1;26;1;3;22;0;0;0
103100015;70;61;61;5;35;34;1;35;0;1;34;0;0;0
103100016;50;39;39;6;16;33;1;16;0;0;16;0;0;0
103100017;90;90;90;5;42;47;1;42;1;0;41;0;0;0
103100018;35;25;25;6;19;15;1;19;1;0;18;0;0;0
103100019;35;21;21;6;13;21;1;13;0;0;13;0;0;0
103800001;660;647;649;6;236;492;1;167;8;6;153;69;8;61
103800002;660;641;647;3;229;465;1;194;8;8;178;35;1;34
103800003;750;697;703;1;204;597;1;152;8;6;138;52;6;46
103800004;50;26;26;6;18;31;1;18;0;0;18;0;0;0
103800005;140;96;96;6;50;89;1;50;3;2;45;0;0;0
103800006;160;132;132;5;62;97;1;62;1;0;61;0;0;0
103800007;50;16;16;7;19;30;1;19;2;0;17;0;0;0
103800008;30;11;11;0;11;18;1;11;0;0;11;0;0;0
104100001;500;373;377;0;149;386;1;113;1;5;107;36;5;31
104100002;500;618;623;0;206;327;1;172;2;6;164;34;2;32
104100003;700;726;733;5;284;496;1;203;7;7;189;81;5;76
104100004;800;869;872;3;394;507;1;292;10;5;277;102;4;98
104100005;1000;945;946;3;455;634;1;365;7;6;352;90;5;85
104100006;700;786;788;1;302;493;1;206;5;6;195;96;3;93
104100007;700;823;823;2;374;390;1;309;7;9;293;65;5;60
104100008;500;543;545;1;195;311;1;188;4;7;177;7;1;6
104100009;500;467;467;0;210;293;1;206;8;6;192;4;0;4
104100010;100;20;20;0;20;79;1;20;1;0;19;0;0;0
104800001;500;495;495;4;216;338;1;161;12;3;146;55;3;52
104800002;600;676;676;6;218;481;1;118;4;3;111;100;8;92
104800003;700;725;725;5;299;492;1;207;16;5;186;92;6;86
104800004;600;609;611;8;237;440;1;159;9;3;147;78;2;76
104800005;500;524;524;8;183;388;1;111;1;2;108;72;6;66
104800006;600;576;577;6;203;466;1;133;6;2;125;70;2;68
104800007;400;379;380;6;148;324;1;75;0;2;73;73;3;70
104800008;500;460;460;5;208;410;1;89;1;0;88;119;1;118
104800009;400;372;372;7;165;306;1;93;3;2;88;72;2;70
104800010;600;621;623;7;243;470;1;129;3;2;124;114;4;110
104800011;600;644;645;7;253;481;1;118;4;2;112;135;5;130
104800012;400;429;430;5;186;303;1;96;7;0;89;90;3;87
104800013;600;658;659;7;265;458;1;141;5;5;131;124;5;119
104800014;400;392;393;5;154;318;1;81;4;1;76;73;2;71
104800015;600;642;646;5;236;440;1;159;4;6;149;77;3;74
104800016;600;561;562;3;186;500;1;99;2;3;94;87;5;82
104800017;600;605;605;6;196;499;3;98;1;1;96;98;7;91
104800018;700;680;680;1;262;527;1;172;11;5;156;90;8;82
104800019;1000;1051;1050;4;448;598;4;398;43;1;354;50;1;49
104800020;800;858;858;4;312;616;2;182;7;4;171;130;7;123
104800021;700;681;681;3;250;554;2;144;6;5;133;106;9;97
104800022;700;777;777;6;285;535;1;164;4;6;154;121;3;118
104800023;800;840;841;2;238;677;2;121;3;4;114;117;5;112
104800024;800;839;840;6;298;639;1;160;5;3;152;138;6;132
104800025;800;826;827;5;245;649;1;150;5;6;139;95;7;88
104800026;800;789;789;6;245;673;1;126;4;6;116;119;5;114
104800027;400;445;448;3;156;316;1;83;0;2;81;73;6;67
104800028;600;650;653;5;242;481;1;118;2;4;112;124;8;116
104800029;500;529;531;3;220;395;1;104;4;0;100;116;4;112
104800030;700;699;699;5;293;500;1;199;4;4;191;94;9;85
104800031;700;666;666;0;253;544;1;155;6;8;141;98;3;95
104800032;500;522;523;1;171;388;1;111;2;5;104;60;2;58
104800033;600;643;642;1;194;490;1;109;1;2;106;85;4;81
104800034;800;863;863;0;234;598;1;201;7;3;191;33;3;30
104800035;700;717;718;3;208;573;1;126;6;0;120;82;1;81
104800036;600;579;579;0;202;483;1;116;3;4;109;86;4;82
104800037;400;419;419;4;157;302;2;96;0;5;91;61;4;57
104800038;600;636;636;6;211;481;2;117;5;2;110;94;5;89
104800039;700;681;683;6;241;572;1;127;1;1;125;114;5;109
104800040;700;687;687;3;272;548;1;151;2;4;145;121;6;115
104800041;700;728;727;5;257;577;1;122;4;3;115;135;6;129
104800042;700;718;718;5;279;556;1;143;21;3;119;136;8;128
104800043;400;435;436;7;141;319;1;80;2;1;77;61;2;59
104800044;500;528;529;6;180;404;1;95;1;3;91;85;5;80
104800045;600;657;658;5;210;500;1;99;0;3;96;111;4;107
104800046;800;802;803;2;279;579;2;219;10;5;204;60;2;58
104800047;900;913;914;6;324;664;2;234;12;3;219;90;4;86
104800048;500;507;507;4;165;372;1;127;6;4;117;38;3;35
104800049;700;760;760;4;282;476;1;223;7;7;209;59;2;57
104800050;500;484;490;3;168;381;1;118;7;0;111;50;1;49
104800051;600;587;586;3;182;433;1;166;2;6;158;16;1;15
104800052;100;28;28;4;28;71;1;28;1;1;26;0;0;0
104800053;600;646;646;4;217;455;2;143;4;7;132;74;4;70
104800054;700;769;770;3;260;540;3;157;2;4;151;103;5;98
104800055;200;151;151;5;70;129;1;70;1;2;67;0;0;0
104800056;200;115;115;3;39;160;1;39;0;0;39;0;0;0
104800057;500;541;542;4;170;393;1;106;1;1;104;64;3;61
104800058;500;494;495;2;164;402;1;97;2;6;89;67;2;65
104800059;600;599;599;3;172;477;1;122;2;2;118;50;1;49
104800060;300;252;252;6;146;153;1;146;7;3;136;0;0;0
104800061;100;86;86;6;66;33;1;66;1;0;65;0;0;0
104800062;100;20;20;4;16;83;1;16;1;1;14;0;0;0
104800063;200;185;185;7;98;101;1;98;3;2;93;0;0;0
104800064;100;39;39;6;29;70;1;29;0;0;29;0;0;0
104800065;100;53;53;7;41;58;1;41;1;0;40;0;0;0
104800066;100;81;81;6;51;48;1;51;1;2;48;0;0;0
104800067;400;387;387;4;113;318;1;81;1;3;77;32;1;31
104800068;500;482;483;5;138;403;1;96;7;5;84;42;4;38
104800069;500;520;523;4;157;397;1;102;4;1;97;55;4;51
104800070;600;601;601;2;191;444;1;155;8;1;146;36;1;35
104800071;400;357;357;0;116;321;1;78;2;3;73;38;3;35
104800072;500;499;499;5;268;247;1;252;14;2;236;16;2;14
104800073;100;23;23;0;21;77;2;21;1;1;19;0;0;0
105000001;150;171;171;5;84;65;1;84;2;5;77;0;0;0
105000002;30;25;24;3;21;8;1;21;0;0;21;0;0;0
105000003;40;34;34;3;26;13;1;26;0;0;26;0;0;0
105000004;70;63;63;3;38;31;1;38;1;2;35;0;0;0
105000005;55;47;47;0;32;22;1;32;0;0;32;0;0;0
105000006;30;19;19;6;20;9;1;20;0;0;20;0;0;0
105000007;30;20;25;7;20;9;1;20;0;0;20;0;0;0
105000008;35;27;27;6;21;13;1;21;0;2;19;0;0;0
105000009;50;39;39;2;32;17;1;32;1;0;31;0;0;0
110200001;500;612;612;2;264;355;1;144;3;2;139;120;7;113
110200002;400;548;549;1;252;261;1;138;2;1;135;114;5;109
110200003;400;445;445;1;148;264;1;135;1;4;130;13;0;13
110200004;400;530;534;0;195;275;1;124;3;3;118;71;3;68
110200005;100;53;53;4;37;61;2;37;0;2;35;0;0;0
110200006;100;89;89;5;48;51;1;48;2;0;46;0;0;0
110200007;100;54;55;6;38;61;1;38;2;4;32;0;0;0
111700001;600;611;612;0;201;469;2;129;4;4;121;72;2;70
111700002;500;549;549;1;201;382;1;117;4;4;109;84;3;81
111700003;500;527;527;2;136;396;1;103;3;0;100;33;0;33
111700004;700;782;782;2;164;550;1;149;7;0;142;15;0;15
111700005;800;818;819;0;184;632;1;167;9;5;153;17;0;17
111700006;400;404;404;1;143;285;1;114;5;6;103;29;0;29
111700007;350;296;297;2;121;228;1;121;2;1;118;0;0;0
111700008;150;71;71;3;43;106;1;43;2;0;41;0;0;0
111800001;500;695;690;9;205;356;1;143;3;2;138;62;2;60
111800002;500;605;605;5;243;404;1;95;4;2;89;148;7;141
111800003;500;529;529;5;187;394;1;105;0;4;101;82;1;81
111800004;500;542;544;8;191;393;2;105;1;1;103;86;3;83
111800005;500;513;513;8;216;390;1;109;4;2;103;107;1;106
111800006;500;745;745;7;278;352;1;147;5;1;141;131;5;126
111800007;500;517;517;9;188;424;1;75;0;4;71;113;11;102
111800008;500;580;582;5;176;386;1;113;2;5;106;63;2;61
111800009;500;447;450;7;179;392;1;107;4;3;100;72;1;71
111800010;500;484;484;4;181;388;2;110;1;4;105;71;6;65
111800011;500;484;484;6;152;424;0;76;2;0;74;76;2;74
111800012;500;465;465;6;147;407;1;92;2;5;85;55;1;54
111800013;500;661;661;7;178;405;1;94;0;3;91;84;2;82
111800014;500;546;547;8;163;406;1;93;3;1;89;70;5;65
111800015;500;693;694;6;281;366;1;133;2;5;126;148;10;138
111800016;500;521;523;7;207;398;1;101;0;1;100;106;3;103
111800017;500;461;461;5;199;424;2;74;2;1;71;125;5;120
111800018;500;554;554;8;211;382;4;114;3;6;105;97;3;94
111800019;500;641;641;8;201;398;1;101;4;4;93;100;3;97
111800020;500;756;756;4;255;372;1;127;2;3;122;128;2;126
111800021;500;608;608;7;243;387;1;112;0;3;109;131;6;125
111800022;500;463;465;5;210;372;1;127;2;1;124;83;3;80
111800023;500;464;465;3;187;429;1;70;1;2;67;117;3;114
111800024;500;472;472;5;165;407;1;92;2;0;90;73;3;70
111800025;500;490;491;8;157;425;1;74;2;4;68;83;1;82
111800026;500;623;624;5;224;384;1;115;5;0;110;109;4;105
111800027;500;491;494;7;197;401;1;98;3;4;91;99;7;92
111800028;500;627;629;6;193;397;1;102;5;2;95;91;4;87
111800029;500;612;614;5;174;405;1;94;1;1;92;80;5;75
111800030;500;583;585;3;143;405;1;94;3;2;89;49;5;44
111800031;500;636;637;4;152;403;5;92;4;2;86;60;1;59
111800032;500;624;626;5;182;357;1;142;4;2;136;40;0;40
111800033;500;428;428;6;93;434;1;65;2;0;63;28;0;28
111800034;500;451;451;6;109;412;1;87;2;2;83;22;1;21
111800035;500;583;588;4;209;380;1;119;3;3;113;90;1;89
111800036;500;492;492;7;220;375;1;124;3;7;114;96;7;89
111800037;300;239;240;2;114;185;1;114;5;6;103;0;0;0
111800038;500;482;489;2;181;358;1;141;3;4;134;40;1;39
111800040;200;176;176;7;87;112;1;87;3;2;82;0;0;0
111800041;300;237;237;5;101;198;1;101;1;3;97;0;0;0
111800042;500;791;796;6;381;180;2;318;15;10;293;63;2;61
111800044;500;557;557;5;247;331;1;168;3;6;159;79;0;79
111800046;500;459;473;2;179;378;1;121;8;2;111;58;3;55
111800048;500;453;453;2;206;312;1;187;9;1;177;19;0;19
111800050;200;128;129;7;86;113;1;86;2;3;81;0;0;0
111800051;100;83;83;6;57;42;1;57;3;2;52;0;0;0
111800052;500;525;532;6;243;289;1;210;10;3;197;33;1;32
111800054;200;125;125;4;72;127;1;72;3;1;68;0;0;0
111800055;100;68;69;4;52;47;1;52;1;0;51;0;0;0
111800057;100;22;22;6;14;85;1;14;0;0;14;0;0;0
111800058;200;159;160;5;76;123;1;76;1;5;70;0;0;0
111800059;200;105;106;5;65;134;1;65;3;0;62;0;0;0
111800060;100;67;69;8;46;53;1;46;0;1;45;0;0;0
111800061;100;97;97;6;72;27;1;72;3;0;69;0;0;0
111800062;100;93;93;4;56;43;1;56;3;3;50;0;0;0
111800063;300;198;201;2;103;196;1;103;3;0;100;0;0;0
111800064;200;185;185;8;105;94;1;105;1;0;104;0;0;0
111800065;200;195;195;3;114;85;1;114;4;1;109;0;0;0
111800066;100;59;59;6;48;51;1;48;0;2;46;0;0;0
111800067;500;790;791;6;259;360;1;139;4;7;128;120;7;113
111800068;500;208;724;6;214;393;1;106;3;2;101;108;7;101
111800069;500;507;507;6;112;429;1;70;2;5;63;42;1;41
111800070;500;661;662;5;210;367;1;132;7;2;123;78;5;73
111800071;500;876;877;5;196;342;2;156;12;1;143;40;0;40
111800072;500;718;718;7;128;391;1;108;7;1;100;20;0;20
111800074;200;158;159;4;98;101;1;98;5;6;87;0;0;0
111800075;200;171;176;7;97;102;1;97;2;2;93;0;0;0
111800076;500;799;805;6;259;290;10;200;0;6;194;59;5;54
111800078;100;75;78;5;46;53;1;46;2;3;41;0;0;0
111800079;300;282;282;3;94;205;1;94;3;2;89;0;0;0
111800080;300;219;219;7;102;197;1;102;5;4;93;0;0;0
111800081;100;26;26;5;19;80;1;19;0;0;19;0;0;0
111800082;500;596;598;7;178;403;1;96;2;3;91;82;4;78
111800083;500;638;639;6;183;403;1;96;1;4;91;87;4;83
111800084;500;506;507;7;164;411;1;88;3;0;85;76;3;73
111800085;500;755;757;9;250;376;1;123;5;5;113;127;5;122
111800086;500;543;544;6;149;416;1;83;1;1;81;66;3;63
111800087;500;477;477;7;204;395;1;104;1;0;103;100;4;96
111800088;500;453;454;5;178;402;1;97;1;0;96;81;6;75
111800089;500;540;540;6;216;409;1;90;2;6;82;126;7;119
111800090;500;413;413;5;160;427;1;72;1;1;70;88;6;82
111800091;500;596;600;3;222;386;1;113;1;3;109;109;6;103
111800092;500;662;664;5;252;374;1;125;4;5;116;127;5;122
111800093;500;739;739;5;225;355;1;144;6;2;136;81;2;79
111800094;500;561;562;9;175;409;1;90;3;3;84;85;2;83
111800096;500;519;521;2;129;415;1;84;3;2;79;45;0;45
111800097;100;77;77;8;44;55;1;44;1;3;40;0;0;0
111800098;100;42;42;6;29;70;1;29;0;1;28;0;0;0
111800099;500;472;484;8;179;407;1;92;2;4;86;87;3;84
111800100;500;480;482;6;170;417;1;82;2;5;75;88;3;85
111800101;500;507;507;4;202;408;1;91;1;5;85;111;8;103
111800102;100;17;17;51;56;43;1;56;0;2;54;0;0;0
111800103;100;39;39;21;56;43;1;56;1;1;54;0;0;0
111800104;100;36;36;11;30;69;1;30;3;0;27;0;0;0
111800105;100;17;17;10;27;72;1;27;4;0;23;0;0;0
111800106;200;125;125;23;80;119;1;80;15;0;65;0;0;0
111800107;100;50;50;3;53;46;1;53;1;0;52;0;0;0
111900001;800;816;820;2;208;633;1;166;7;5;154;42;1;41
111900002;600;649;649;0;181;460;2;138;2;6;130;43;4;39
111900003;700;747;748;2;250;451;1;248;9;12;227;2;0;2
111900004;500;516;518;0;180;402;1;97;3;1;93;83;1;82
111900005;700;714;715;3;231;571;2;127;3;0;124;104;2;102
111900006;700;785;785;4;305;508;1;191;6;1;184;114;5;109
111900007;800;816;818;3;228;667;1;132;10;2;120;96;6;90
111900008;900;933;932;0;235;666;1;233;29;0;204;2;0;2
111900009;700;758;759;4;208;526;1;173;12;6;155;35;3;32
111900010;900;974;974;8;289;628;2;270;49;0;221;19;2;17
111900011;400;475;475;2;170;251;1;148;4;0;144;22;0;22
111900012;300;300;301;5;143;156;1;143;5;1;137;0;0;0
111900013;600;609;610;3;306;350;2;248;6;7;235;58;2;56
111900014;400;186;454;2;188;249;1;150;15;0;135;38;0;38
111900015;300;309;309;3;96;223;1;76;6;0;70;20;2;18
111900016;100;81;81;6;62;37;1;62;5;0;57;0;0;0
111900017;100;62;55;5;47;52;1;47;2;1;44;0;0;0
111900018;600;618;620;2;271;362;2;236;15;0;221;35;0;35
111900019;600;609;611;1;289;352;1;247;11;4;232;42;1;41
111900020;500;532;535;3;196;332;2;166;8;0;158;30;0;30
111900021;400;459;465;0;215;219;2;179;10;3;166;36;1;35
111900022;800;855;861;2;337;490;2;308;14;1;293;29;0;29
111900023;500;573;575;2;237;299;1;200;9;1;190;37;1;36
111900024;500;501;501;1;119;398;1;101;2;2;97;18;0;18
111900025;400;430;435;1;85;335;1;64;6;0;58;21;0;21
111900027;100;70;70;12;44;55;1;44;12;2;30;0;0;0
111900028;100;28;28;0;27;72;1;27;0;0;27;0;0;0
113300001;300;254;254;1;55;244;1;55;0;0;55;0;0;0
113300002;500;461;461;2;252;247;1;252;7;1;244;0;0;0
113300003;500;543;544;2;313;202;2;296;7;4;285;17;0;17
113300004;200;180;180;2;55;144;1;55;0;3;52;0;0;0
113300005;800;875;876;0;444;367;2;431;16;2;413;13;0;13
113300006;600;655;657;2;292;312;10;278;10;0;268;14;0;14
113300007;500;526;528;4;308;198;1;301;10;0;291;7;1;6
113300008;600;639;640;0;262;347;1;252;6;2;244;10;0;10
113300009;700;676;677;0;279;420;1;279;3;1;275;0;0;0
113300010;700;750;751;2;298;470;1;229;13;2;214;69;0;69
113300012;100;61;61;6;23;76;1;23;1;0;22;0;0;0
113300014;300;295;295;2;218;81;1;218;2;11;205;0;0;0
113300015;100;54;54;3;42;57;1;42;0;1;41;0;0;0
113300016;600;607;608;2;240;378;1;221;6;2;213;19;0;19
113300017;800;892;892;0;384;437;1;362;20;3;339;22;1;21
113300018;100;111;111;5;69;30;1;69;0;2;67;0;0;0
113300019;100;42;42;4;27;72;1;27;1;0;26;0;0;0
113300020;500;461;461;5;194;347;1;152;4;2;146;42;0;42
113300021;200;226;226;1;91;108;1;91;1;1;89;0;0;0
113300022;100;122;122;5;57;42;1;57;1;1;55;0;0;0
113300023;700;702;706;8;246;527;1;172;6;5;161;74;2;72
113300024;400;464;464;5;134;311;1;88;2;1;85;46;2;44
113300025;500;467;467;4;142;413;1;86;2;2;82;56;4;52
113300026;600;688;690;6;200;474;1;125;4;2;119;75;3;72
113300027;800;804;804;6;248;652;1;147;5;1;141;101;3;98
113300028;600;653;656;5;218;454;1;145;0;7;138;73;6;67
113300029;600;626;631;3;171;494;1;105;4;9;92;66;7;59
113300031;500;543;543;2;172;380;2;118;3;0;115;54;2;52
113300032;800;847;847;8;291;564;1;235;28;0;207;56;0;56
113300033;500;508;509;3;182;394;1;105;7;3;95;77;8;69
113300034;500;465;465;5;185;383;1;116;1;6;109;69;2;67
113300035;400;421;421;5;164;261;1;138;11;0;127;26;1;25
113300036;700;767;770;2;210;572;1;127;2;2;123;83;4;79
113300038;300;329;329;5;133;204;2;94;4;3;87;39;2;37
113300040;200;139;142;2;68;131;1;68;1;3;64;0;0;0
113300041;100;12;12;14;23;76;1;23;3;0;20;0;0;0
113400001;600;588;588;7;133;539;1;60;1;0;59;73;2;71
113400002;550;553;553;6;178;477;2;71;2;1;68;107;4;103
113400003;600;605;608;4;194;493;1;106;3;3;100;88;5;83
113400004;600;644;644;6;200;489;1;110;4;2;104;90;7;83
113400005;700;702;702;5;235;559;1;140;3;2;135;95;2;93
113400006;400;450;450;3;157;337;1;62;2;0;60;95;8;87
113400007;500;528;528;4;168;418;1;81;0;3;78;87;5;82
113400008;400;428;429;5;162;340;2;58;2;3;53;104;4;100
113400009;300;245;245;5;98;201;1;98;1;3;94;0;0;0
113400010;600;591;591;5;221;483;5;112;4;1;107;109;5;104
113400011;300;330;332;5;128;245;1;54;5;4;45;74;2;72
113400012;400;475;476;3;144;338;2;60;3;0;57;84;0;84
113400013;500;506;508;4;211;398;1;101;3;2;96;110;4;106
113400014;600;584;590;8;200;497;1;102;1;4;97;98;6;92
113400015;600;652;655;1;246;487;1;112;2;6;104;134;7;127
113400016;600;602;603;6;199;490;1;109;7;7;95;90;5;85
113400017;500;496;498;4;208;377;1;122;2;3;117;86;2;84
113400018;600;573;574;1;194;484;1;115;0;1;114;79;1;78
113400019;500;539;539;4;165;393;1;106;0;4;102;59;0;59
113400020;500;471;471;6;175;419;1;80;3;2;75;95;9;86
113400021;700;216;721;5;216;604;1;95;1;3;91;121;6;115
113400022;500;465;466;4;159;418;1;81;3;3;75;78;6;72
113400023;400;380;381;6;94;348;1;51;0;1;50;43;1;42
113400024;800;822;823;4;189;694;1;105;7;4;94;84;3;81
113400025;400;418;418;5;80;361;1;38;1;0;37;42;2;40
113400026;200;200;200;5;48;151;1;48;0;1;47;0;0;0
113400027;100;97;97;4;35;64;1;35;0;0;35;0;0;0
113400028;500;493;493;5;158;406;1;93;2;7;84;65;4;61
113400029;500;519;519;8;164;406;1;93;1;1;91;71;5;66
113400030;600;596;596;4;157;517;1;82;1;2;79;75;4;71
113400031;500;488;489;7;146;420;1;79;2;1;76;67;0;67
113400032;600;661;661;1;198;492;1;107;2;1;104;91;2;89
113400033;400;455;457;5;144;332;1;67;0;0;67;77;2;75
113400034;500;568;569;5;196;385;4;111;3;2;106;85;0;85
113400035;600;598;598;6;188;500;1;99;5;7;87;89;2;87
113400036;400;392;391;5;77;350;5;45;4;2;39;32;3;29
113400037;100;70;70;7;42;57;1;42;1;1;40;0;0;0
113400038;100;106;101;5;40;59;1;40;0;1;39;0;0;0
113400039;300;285;285;2;147;152;1;147;3;5;139;0;0;0
113400040;200;161;161;4;78;121;1;78;3;6;69;0;0;0
113400041;200;217;218;6;109;90;1;109;3;1;105;0;0;0
113400042;200;143;143;3;72;127;1;72;5;2;65;0;0;0
113400043;400;461;461;1;149;305;1;94;1;1;92;55;4;51
113400044;200;222;223;3;108;91;1;108;1;1;106;0;0;0
113400045;300;257;257;1;108;191;1;108;1;2;105;0;0;0
113400046;200;231;231;3;126;73;1;126;6;6;114;0;0;0
113400047;200;228;229;6;86;113;1;86;1;3;82;0;0;0
113400048;400;441;443;1;164;256;1;143;8;5;130;21;3;18
113400049;200;208;209;3;108;90;2;108;4;2;102;0;0;0
113400050;800;779;779;4;318;610;1;189;5;5;179;129;6;123
113400051;800;817;817;5;288;646;1;153;6;5;142;135;8;127
113400052;600;648;648;2;241;432;1;167;3;5;159;74;2;72
113400053;700;647;654;1;380;384;1;315;21;10;284;65;5;60
113400054;100;49;49;4;29;69;2;29;1;0;28;0;0;0
113400055;500;505;506;1;191;386;1;113;2;4;107;78;4;74
113400056;200;151;151;3;82;117;1;82;1;1;80;0;0;0
113400057;400;452;452;3;261;200;2;198;11;3;184;63;1;62
113400058;200;157;157;4;87;112;1;87;4;2;81;0;0;0
113400059;500;557;557;4;258;325;1;174;3;0;171;84;7;77
113400060;50;12;12;17;23;26;1;23;0;1;22;0;0;0
113400061;50;17;17;13;23;26;1;23;1;2;20;0;0;0
113400062;50;16;16;1;17;32;1;17;0;0;17;0;0;0
113600001;600;845;846;2;251;384;1;215;17;1;197;36;2;34
113600002;600;790;798;2;269;413;1;186;14;4;168;83;3;80
113600003;300;409;414;0;122;193;1;106;4;2;100;16;0;16
113600004;100;111;112;4;75;24;1;75;0;0;75;0;0;0
113600005;200;293;293;3;129;70;1;129;8;0;121;0;0;0
113600006;100;107;107;3;65;34;1;65;2;1;62;0;0;0
113600007;100;67;68;6;54;45;1;54;5;1;48;0;0;0
113600008;700;795;796;5;351;413;1;286;11;6;269;65;0;57
113600009;800;978;986;4;466;397;1;402;14;8;380;64;8;56
113600010;100;22;22;11;29;70;1;29;0;2;27;0;0;0
113600011;100;106;107;6;63;36;1;63;5;0;58;0;0;0
113600012;100;99;99;5;57;42;1;57;0;4;53;0;0;0
113600013;100;89;89;7;52;47;1;52;0;0;52;0;0;0
113600014;100;18;18;1;16;83;1;16;1;0;15;0;0;0
113800001;600;728;729;2;271;428;1;171;2;2;167;100;2;98
113800002;600;687;689;2;313;356;1;243;17;0;226;70;1;69
113800003;600;741;741;2;342;383;1;216;6;0;210;126;2;124
113800004;100;112;112;3;78;21;1;78;3;1;74;0;0;0
113800005;600;758;758;5;202;432;1;167;8;0;159;35;2;33
113800006;100;72;72;6;33;66;1;33;0;2;31;0;0;0
113800007;300;380;380;4;249;75;1;224;6;0;218;25;1;24
113800008;100;44;44;7;33;66;1;33;0;1;32;0;0;0
113800009;600;662;662;5;299;350;1;249;21;3;225;50;3;47
113800010;200;159;159;4;89;110;1;89;2;4;83;0;0;0
113800011;200;220;220;3;63;136;1;63;2;0;61;0;0;0
120200001;200;244;244;4;107;91;2;107;1;2;104;0;0;0
120200002;400;619;623;3;272;210;2;188;4;0;184;84;0;84
120200003;400;693;696;1;263;247;1;152;1;5;146;111;5;106
120200004;300;479;484;4;179;189;3;108;1;6;101;71;3;68
120200005;300;440;445;2;180;192;2;106;3;1;102;74;6;68
120200006;300;523;524;6;210;158;1;141;1;2;138;69;3;66
120200007;300;493;500;4;207;171;4;125;1;3;121;82;6;76
120200008;400;647;653;0;236;253;1;146;3;3;140;90;3;87
120200009;300;427;427;3;160;217;1;82;1;0;81;78;2;76
120200010;200;348;349;0;146;91;1;108;2;4;102;38;1;37
120200011;300;529;530;6;226;175;1;124;11;4;109;102;5;97
120200012;300;517;522;8;220;163;1;136;4;5;127;84;2;82
120200013;200;476;476;3;178;92;1;107;4;3;100;71;3;68
120200014;200;482;482;4;207;78;1;121;5;2;114;86;2;84
120200015;300;516;521;5;205;150;2;148;3;3;142;57;1;56
120200016;300;517;521;6;180;196;1;103;3;1;99;77;3;74
120200017;300;515;519;6;200;179;1;120;1;4;115;80;3;77
120200018;500;1086;1087;6;376;122;3;375;36;2;337;1;0;1
120200019;500;932;933;9;269;234;1;265;25;0;240;4;0;4
120200020;500;988;988;7;305;199;1;300;15;0;285;5;1;4
120200021;100;99;82;4;57;42;1;57;11;2;44;0;0;0
120200022;200;141;141;4;62;137;1;62;1;2;59;0;0;0
120200023;100;52;52;4;32;67;1;32;0;1;31;0;0;0
120200024;100;33;34;5;24;75;1;24;0;1;23;0;0;0
120200025;100;46;45;4;25;74;1;25;1;1;23;0;0;0
120200026;100;18;18;6;17;82;1;17;0;0;17;0;0;0
120200027;100;30;30;6;32;67;1;32;1;1;30;0;0;0
120200028;200;183;183;3;85;114;1;85;1;0;84;0;0;0
120200029;100;99;100;5;64;35;1;64;14;0;50;0;0;0
120200030;100;91;91;6;57;42;1;57;2;3;52;0;0;0
120200031;100;24;24;7;24;75;1;24;1;0;23;0;0;0
120200032;100;26;26;6;21;78;1;21;1;0;20;0;0;0
120200033;100;34;34;3;24;75;1;24;2;0;22;0;0;0
120200034;200;147;148;6;89;110;1;89;2;3;84;0;0;0
120200035;200;127;127;5;80;119;1;80;2;2;76;0;0;0
120200036;400;564;565;10;193;270;1;129;3;3;123;64;7;57
120200037;400;574;574;7;223;194;1;205;2;7;196;18;2;16
120200038;300;476;480;4;266;54;13;233;0;4;229;33;4;29
120200039;400;479;480;3;244;175;2;223;8;2;213;21;1;20
120200040;400;411;411;1;200;217;1;182;6;3;173;18;1;17
120200041;100;37;37;0;37;63;0;37;3;0;34;0;0;0
120400001;500;636;636;2;218;321;2;177;5;6;166;41;2;39
120400002;400;488;488;5;198;229;1;170;6;2;162;28;2;26
120400003;150;149;149;5;63;86;1;63;0;2;61;0;0;0
120400004;400;492;495;0;251;152;1;247;0;1;246;4;0;4
120400005;500;249;529;0;249;266;0;234;9;0;225;15;0;15
120400006;600;634;635;2;267;368;1;231;7;3;221;36;0;36
120400007;500;513;514;1;277;238;1;261;4;0;257;16;2;14
120400008;400;413;413;5;155;277;2;121;4;1;116;34;2;32
120400009;300;261;262;2;127;172;1;127;6;3;118;0;0;0
120400010;400;364;364;1;220;180;1;219;1;2;216;1;0;1
120400011;50;38;38;4;25;24;1;25;1;0;24;0;0;0
120400012;100;45;45;7;28;71;1;28;0;0;28;0;0;0
120400013;150;133;133;1;82;67;1;82;4;0;78;0;0;0
120400014;300;361;361;1;161;157;2;141;11;1;129;20;1;19
120400015;500;535;535;2;292;231;2;267;21;3;243;25;0;25
120400016;400;472;474;0;246;183;1;216;12;2;202;30;0;30
120400017;500;531;532;4;264;280;1;219;4;5;210;45;2;43
120400018;250;208;208;2;119;130;1;119;1;1;117;0;0;0
120400019;100;39;38;0;32;67;1;32;3;0;29;0;0;0
120700001;500;532;556;2;231;306;1;193;10;3;180;38;0;38
120700002;300;361;376;1;155;165;1;134;3;3;128;21;0;21
120700003;270;283;296;6;173;96;1;173;8;5;160;0;0;0
120700004;100;80;84;3;57;42;1;57;0;0;57;0;0;0
120700005;100;102;104;0;72;27;1;72;1;0;71;0;0;0
120700006;100;105;105;3;65;34;1;65;0;10;55;0;0;0
120700007;400;469;494;0;293;126;1;273;16;8;249;20;2;18
120700008;300;297;310;0;161;138;1;161;28;0;133;0;0;0
120700009;400;420;423;3;190;240;2;158;3;1;154;32;0;32
120700010;500;511;526;3;266;248;2;250;13;4;233;16;3;13
120700011;260;266;278;3;183;76;1;183;3;2;178;0;0;0
120700012;100;98;101;3;55;44;1;55;0;5;50;0;0;0
120700013;50;39;39;0;32;17;1;32;1;0;31;0;0;0
120700014;50;35;35;1;35;14;1;35;5;0;30;0;0;0
120700015;40;30;30;0;28;11;1;28;1;1;26;0;0;0
120700016;30;22;22;0;22;7;1;22;0;1;21;0;0;0
121100001;400;439;440;0;142;296;2;102;6;4;92;40;1;39
121100002;400;476;476;4;214;265;1;134;5;1;128;80;6;74
121100003;400;476;476;3;175;271;2;127;3;2;122;48;3;45
121100004;600;599;600;3;239;374;1;225;9;1;215;14;0;14
121100005;700;658;654;4;242;506;2;192;8;3;181;50;4;46
121100006;100;29;27;4;13;86;1;13;0;0;13;0;0;0
121100007;300;355;355;3;172;127;1;172;8;3;161;0;0;0
121100008;400;435;437;1;231;180;1;219;4;0;215;12;0;12
121100009;300;302;302;4;135;181;4;115;2;0;113;20;0;20
121100010;100;49;49;7;26;71;3;26;2;0;24;0;0;0
121100011;300;342;342;4;122;182;1;117;1;1;115;5;0;5
121100012;200;219;220;4;98;101;1;98;1;2;95;0;0;0
121100013;100;31;31;3;20;79;1;20;0;1;19;0;0;0
121100014;200;157;157;4;73;126;1;73;0;1;72;0;0;0
121100015;300;312;312;2;155;145;1;154;2;1;151;1;0;1
121100016;300;242;242;1;92;207;1;92;4;1;87;0;0;0
121100017;300;241;242;2;84;215;1;84;2;0;82;0;0;0
121100018;200;152;152;3;64;135;1;64;2;3;59;0;0;0
121100019;800;788;788;3;446;353;1;446;5;5;436;0;0;0
121100020;500;494;494;3;300;199;1;300;6;0;294;0;0;0
121100021;100;87;87;5;53;46;1;53;0;1;52;0;0;0
121200001;600;638;641;2;240;450;1;149;1;9;139;91;4;87
121200002;1050;1135;1138;2;538;510;2;538;34;2;502;0;0;0
121200003;450;491;491;4;202;343;1;106;3;2;101;96;4;92
121200004;700;734;734;0;291;506;1;193;8;4;181;98;4;94
121200005;600;653;655;0;250;470;2;128;1;3;124;122;7;115
121200006;400;448;448;0;128;328;1;71;0;1;70;57;1;56
121200007;300;348;349;0;144;208;1;91;3;0;88;53;2;51
121200008;400;405;406;1;157;299;2;99;1;2;96;58;3;55
121200009;300;313;313;4;191;108;1;191;3;7;181;0;0;0
121200010;80;75;75;7;59;20;1;59;2;1;56;0;0;0
121200011;50;34;34;7;31;18;1;31;0;1;30;0;0;0
121200012;300;286;286;4;159;140;1;159;9;3;147;0;0;0
121200013;170;171;172;3;90;79;1;90;2;3;85;0;0;0
121200014;50;31;31;3;22;26;2;22;1;0;21;0;0;0
121200015;150;137;138;4;85;64;1;85;2;4;79;0;0;0
121200016;150;134;135;5;82;67;1;82;7;4;71;0;0;0
121200017;250;107;107;48;102;146;2;102;5;2;95;0;0;0
121400001;100;75;75;5;56;43;1;56;0;1;55;0;0;0
121400002;200;171;172;2;113;86;1;113;3;5;105;0;0;0
121400003;200;328;334;7;168;58;1;141;2;5;134;27;1;26
121400004;100;50;52;3;36;63;1;36;1;2;33;0;0;0
121400005;200;258;261;4;121;78;1;121;6;4;111;0;0;0
121400006;100;71;71;4;51;48;1;51;1;4;46;0;0;0
121400007;100;120;121;2;83;16;1;83;2;6;75;0;0;0
121400008;100;19;19;5;17;82;1;17;1;0;16;0;0;0
121400009;100;79;81;5;49;50;1;49;0;0;49;0;0;0
121400010;300;373;384;5;193;140;2;158;9;4;145;35;1;34
121400011;200;149;149;7;97;102;1;97;2;0;95;0;0;0
121400012;100;57;51;6;34;65;1;34;2;0;32;0;0;0
121400013;100;14;14;2;14;86;0;14;0;0;14;0;0;0
121400014;100;15;15;0;15;85;0;15;0;0;15;0;0;0
122400001;600;580;584;5;234;439;1;160;6;3;151;74;0;74
122400002;600;565;566;2;216;465;1;134;3;2;129;82;2;80
122400003;500;496;500;8;164;416;1;83;3;1;79;81;3;78
122400004;300;329;332;4;114;236;1;63;1;4;58;51;0;51
122400005;400;398;402;6;164;295;1;104;0;5;99;60;0;60
122400006;400;429;429;2;140;315;1;84;1;1;82;56;0;56
122400007;600;614;614;4;210;472;1;127;2;1;124;83;5;78
122400008;600;569;571;5;197;502;1;97;3;2;92;100;4;96
122400009;500;474;478;5;147;412;1;87;3;2;82;60;7;53
122400010;500;454;456;5;149;397;2;101;4;1;98;51;5;46
122400011;600;583;584;6;189;506;1;93;2;3;88;96;4;92
122400012;500;504;504;9;188;386;1;113;6;2;105;75;4;71
122400013;400;384;384;5;135;331;1;68;1;1;66;67;0;67
122400014;500;526;529;6;199;387;1;112;1;2;109;87;4;83
122400015;600;574;577;6;163;498;1;101;0;3;98;62;1;61
122400016;600;568;570;7;182;465;1;134;4;3;127;48;1;47
122400017;700;683;685;6;254;445;1;254;2;0;252;0;0;0
122400018;600;647;649;4;252;356;1;243;15;0;228;9;1;8
122400019;400;473;475;6;132;314;1;85;2;2;81;47;2;45
122400020;500;567;570;5;169;391;1;108;2;2;104;61;0;61
122400021;500;493;495;5;128;424;1;75;2;1;72;53;3;50
122400022;400;455;455;5;156;301;2;97;2;0;95;59;1;58
122400023;500;494;494;8;183;381;1;118;1;3;114;65;3;62
122400024;500;532;537;6;146;411;1;88;11;1;76;58;0;58
122400025;400;485;485;7;111;349;1;50;5;0;45;61;2;59
122400026;500;472;476;5;113;407;1;92;10;3;79;21;0;21
122400027;700;677;687;3;151;585;2;113;7;0;106;38;2;36
122400028;500;558;559;6;138;393;1;106;11;1;94;32;1;31
122400029;500;506;515;7;163;381;1;118;16;1;101;45;2;43
122400030;500;534;538;5;164;368;1;131;5;6;120;33;0;33
122400031;700;734;736;8;171;563;1;136;20;1;115;35;0;35
122400032;500;524;528;5;100;411;1;88;15;0;73;12;0;12
122400033;1000;1074;1084;4;269;730;1;269;2;1;266;0;0;0
122400034;300;358;358;7;136;176;1;123;6;0;117;13;0;13
122400035;200;149;150;4;94;105;1;94;7;1;86;0;0;0
122400036;400;434;438;3;143;278;1;121;10;0;111;22;1;21
122400037;300;279;281;4;78;221;1;78;5;1;72;0;0;0
122400038;200;217;220;3;151;48;1;151;1;2;148;0;0;0
122400039;300;371;371;3;233;84;1;215;3;4;208;18;0;18
122400040;500;519;529;2;249;268;1;231;5;2;224;18;0;18
122400041;500;471;475;0;236;284;1;215;10;3;202;21;0;21
122400042;200;115;115;4;51;148;1;51;3;0;48;0;0;0
122400043;200;160;160;6;81;118;1;81;8;1;72;0;0;0
122400044;100;45;45;7;16;83;1;16;1;0;15;0;0;0
122400045;400;437;442;3;208;204;2;194;8;3;183;14;1;13
122400046;300;359;360;3;189;144;1;155;14;1;140;34;0;34
122400047;200;183;184;2;114;85;1;114;2;3;109;0;0;0
122400048;300;357;357;6;134;200;1;99;0;1;98;35;1;34
122400049;600;595;597;4;193;456;1;143;1;6;136;50;6;44
122400050;100;100;100;4;76;24;0;76;2;2;72;0;0;0
122400051;100;29;29;5;32;66;2;32;0;0;32;0;0;0
122400052;100;15;15;8;23;76;1;23;5;0;18;0;0;0
122400053;100;11;11;33;41;58;1;41;1;1;39;0;0;0
122600001;280;255;254;3;139;140;1;139;4;1;134;0;0;0
122600002;80;67;67;3;38;41;1;38;1;0;37;0;0;0
122600003;760;741;752;0;346;433;5;322;9;4;309;24;0;24
122600004;560;534;535;2;199;360;1;199;2;4;193;0;0;0
122600005;380;356;360;2;151;245;1;134;3;1;130;17;2;15
122600006;420;395;397;2;134;316;2;102;5;2;95;32;0;32
122600007;500;476;476;7;204;321;1;178;11;7;160;26;0;26
122600008;20;14;14;1;14;5;1;14;1;1;12;0;0;0
122900001;300;569;569;4;222;210;3;87;1;4;82;135;6;129
122900002;300;561;562;5;244;108;1;191;6;6;179;53;6;47
122900003;400;691;693;5;259;210;1;189;3;7;179;70;2;68
122900004;400;768;768;6;302;250;1;149;6;2;141;153;11;142
122900005;300;510;510;6;186;211;1;88;0;4;84;98;6;92
122900006;400;754;754;8;286;266;1;133;4;6;123;153;4;149
122900007;400;789;790;3;305;255;1;144;1;7;136;161;4;157
122900008;300;579;579;6;200;192;1;107;2;7;98;93;9;84
122900009;400;825;825;6;290;276;1;123;2;1;120;167;9;158
122900010;300;569;569;4;208;192;1;107;4;6;97;101;8;93
122900011;300;611;612;5;232;185;2;113;2;5;106;119;6;113
122900012;400;701;701;8;273;299;1;100;1;2;97;173;9;164
122900013;400;707;708;3;279;274;1;125;1;3;121;153;9;144
122900014;300;471;471;2;169;207;4;89;3;3;83;80;2;78
122900015;400;737;738;7;231;300;1;99;0;3;96;132;1;131
122900016;300;664;664;5;214;179;2;119;1;8;110;95;7;88
122900017;400;763;763;9;240;281;1;118;2;3;113;122;4;118
122900018;300;582;582;6;191;207;1;92;3;6;83;99;7;92
122900019;300;571;571;8;181;229;1;70;3;2;65;111;7;104
122900020;300;555;555;4;163;219;2;79;0;2;77;84;6;78
122900021;300;541;541;11;228;216;1;83;3;3;77;145;7;138
122900022;300;593;593;6;237;208;1;91;0;3;88;146;9;137
122900023;300;613;613;9;231;194;1;105;1;5;99;126;11;115
122900024;300;624;626;4;184;208;1;91;2;3;86;93;4;89
122900025;400;791;791;4;224;297;1;102;3;1;98;122;3;119
122900026;400;763;763;7;247;288;1;111;2;6;103;136;9;127
122900027;400;789;791;8;292;294;1;105;4;4;97;187;7;180
122900028;300;691;691;7;216;167;2;131;6;10;115;85;8;77
122900029;300;589;591;9;179;209;1;90;2;2;86;89;6;83
122900030;400;788;789;7;225;279;1;120;2;4;114;105;8;97
122900031;400;697;697;7;167;317;1;82;2;4;76;85;2;83
122900032;400;846;846;7;266;264;1;135;0;6;129;131;6;125
122900033;400;787;788;6;250;294;0;106;1;3;102;144;10;134
122900034;300;698;698;8;228;194;2;104;0;0;104;124;2;122
122900035;300;649;652;7;192;201;1;98;3;5;90;94;3;91
122900036;300;670;670;7;217;213;0;87;1;3;83;130;6;124
122900037;300;683;684;6;225;192;1;107;2;5;100;118;8;110
122900038;300;561;561;7;194;212;1;87;3;0;84;107;10;97
122900039;400;773;773;7;281;290;2;108;1;0;107;173;13;160
122900040;300;628;629;8;230;176;1;123;1;5;117;107;6;101
122900041;300;601;601;5;232;194;2;104;2;3;99;128;4;124
122900042;200;461;462;4;156;137;1;62;2;1;59;94;3;91
122900043;200;462;463;5;173;130;2;68;0;4;64;105;5;100
122900044;300;510;511;9;207;188;4;108;2;4;102;99;1;97
122900045;300;555;555;7;153;200;1;99;3;4;92;54;8;46
122900046;500;932;932;6;249;258;1;241;5;0;236;8;2;6
122900047;300;601;602;7;193;206;1;93;2;2;89;100;6;94
122900048;300;523;523;9;147;218;2;80;1;2;77;67;3;64
122900049;400;693;694;7;217;297;1;102;2;2;98;115;2;113
122900050;300;630;630;5;241;175;1;124;1;6;117;117;2;115
122900051;300;665;666;5;198;206;1;93;3;3;87;105;6;99
122900052;400;702;703;5;258;298;1;101;2;0;99;157;4;153
122900053;300;540;540;7;186;203;1;96;2;5;89;90;1;89
122900054;300;604;605;9;194;206;1;93;2;2;89;101;1;100
122900055;600;1037;1037;6;517;120;3;477;30;6;441;40;0;40
122900056;700;1017;1015;3;609;118;1;581;62;2;517;28;0;28
122900057;300;235;236;6;154;145;1;154;5;0;149;0;0;0
122900058;300;264;265;1;143;157;0;143;9;3;131;0;0;0
122900059;400;436;446;3;166;248;7;145;6;1;138;21;0;21
122900060;400;423;460;5;287;202;1;197;5;9;183;90;4;86
122900061;200;202;202;5;97;102;1;97;1;3;93;0;0;0
122900062;300;300;302;6;144;155;1;144;7;7;130;0;0;0
122900063;100;57;57;4;38;61;1;38;1;0;37;0;0;0
122900064;700;841;853;6;488;222;1;477;11;3;463;11;0;11
122900065;200;94;123;7;68;131;1;68;2;0;66;0;0;0
122900066;300;333;348;4;217;81;2;217;4;4;209;0;0;0
122900067;400;481;483;1;218;223;2;175;12;0;163;43;1;42
122900068;200;162;163;5;109;90;1;109;1;6;102;0;0;0
122900069;200;123;127;5;54;145;1;54;0;2;52;0;0;0
122900070;100;70;74;6;51;48;1;51;2;1;48;0;0;0
122900071;200;224;228;4;145;54;1;145;0;8;137;0;0;0
122900072;200;203;206;6;141;58;1;141;3;5;133;0;0;0
122900073;300;351;354;3;208;137;2;161;12;4;145;47;1;46
122900074;200;212;213;4;114;85;1;114;5;7;102;0;0;0
122900075;600;671;701;3;390;235;1;364;8;10;346;26;0;26
122900076;400;412;416;1;199;241;4;155;1;2;152;44;3;41
122900077;400;377;375;3;184;242;1;157;10;3;144;27;1;26
122900078;200;218;219;2;145;54;1;145;12;6;127;0;0;0
122900079;100;70;70;6;53;46;1;53;4;0;49;0;0;0
122900080;100;35;35;2;36;64;0;36;0;0;36;0;0;0
122900081;100;52;52;0;51;49;0;51;0;1;50;0;0;0
122900082;100;42;42;4;41;59;0;41;0;0;41;0;0;0
122900083;100;37;37;3;40;59;1;40;5;0;35;0;0;0
122900084;100;87;87;73;87;12;1;87;4;7;76;0;0;0
123600001;450;468;474;1;227;264;1;185;8;5;172;42;1;41
123600002;500;536;546;4;250;287;2;211;7;13;191;39;2;37
123600003;450;442;446;1;207;303;1;146;11;7;128;61;6;55
123600004;220;212;212;1;95;124;1;95;3;4;88;0;0;0
123600005;250;240;242;2;130;118;2;130;4;11;115;0;0;0
123600006;330;318;342;3;207;151;1;178;10;5;163;29;0;29
123600007;160;143;143;3;105;54;1;105;2;1;102;0;0;0
123600008;160;148;151;3;125;34;1;125;0;0;125;0;0;0
123600009;180;169;170;2;98;80;2;98;3;2;93;0;0;0
123600010;70;57;57;5;46;23;1;46;1;1;44;0;0;0
123600011;100;83;84;2;62;37;1;62;1;1;60;0;0;0
123600012;40;27;28;5;23;16;1;23;1;0;22;0;0;0
123600013;40;19;19;0;19;21;0;19;0;0;19;0;0;0
123600014;50;30;30;0;29;21;0;29;1;0;28;0;0;0
123800001;260;265;265;1;143;116;1;143;4;2;137;0;0;0
123800002;300;323;323;4;160;157;1;142;5;2;135;18;0;18
123800003;380;380;380;4;174;232;1;147;9;2;136;27;2;25
123800004;220;232;232;2;112;107;1;112;7;2;103;0;0;0
123800005;350;364;364;2;116;248;2;100;2;1;97;16;0;16
123800006;250;248;249;2;73;176;1;73;2;2;69;0;0;0
123800007;580;582;582;1;332;252;1;327;4;4;319;5;0;5
123800008;340;354;353;0;105;252;1;87;2;1;84;18;0;18
123800009;320;322;321;2;148;170;2;148;4;1;143;0;0;0
130300001;400;432;436;1;154;300;1;99;3;7;89;55;5;50
130300002;400;394;394;1;188;252;1;147;3;6;138;41;3;38
130300003;600;580;581;1;221;453;1;146;6;4;136;75;6;69
130300004;500;498;498;0;164;397;1;102;2;3;97;62;0;62
130300005;500;512;513;0;152;411;1;88;3;1;84;64;1;63
130300006;700;771;781;5;339;389;1;310;11;11;288;29;0;29
130300007;600;669;683;4;266;362;7;231;6;4;221;35;2;33
130300008;700;692;705;5;423;316;1;383;5;9;369;40;2;38
130300009;500;489;489;5;236;280;2;218;2;2;214;18;0;18
130300010;100;44;44;0;40;58;2;40;2;1;37;0;0;0
130400001;800;863;863;1;321;602;1;197;5;7;185;124;5;119
130400002;800;845;846;4;337;523;2;275;3;12;260;62;4;58
130400003;800;778;779;1;265;602;2;196;6;3;187;69;1;68
130400004;800;797;799;2;296;618;2;180;6;6;168;116;7;109
130400005;400;361;361;3;155;285;2;113;1;2;110;42;2;40
130400006;800;748;748;2;221;648;1;151;6;4;141;70;5;65
130400007;400;372;369;3;138;303;1;96;1;7;88;42;2;40
130400008;700;737;737;3;292;495;1;204;5;14;185;88;5;83
130400009;900;866;866;4;452;538;10;352;9;7;336;100;7;93
130400011;300;329;330;0;169;173;1;126;3;6;117;43;4;38
130400012;300;327;327;4;128;222;1;77;4;0;73;51;2;49
130600001;600;664;664;2;217;473;1;126;7;2;117;91;2;89
130600002;500;572;572;0;183;388;1;111;1;5;105;72;7;65
130600003;400;445;445;5;166;281;1;118;3;2;113;48;3;45
130600004;500;519;520;6;180;400;1;99;1;2;96;81;0;81
130600005;600;600;600;2;221;472;2;126;2;4;120;95;2;93
130600006;400;437;437;3;37;362;1;37;8;1;28;0;0;0
130600007;400;378;379;6;167;265;1;134;2;4;128;33;1;32
130600008;300;311;312;6;117;197;1;102;6;3;93;15;1;14
130600009;500;509;510;4;153;385;1;114;5;2;107;39;3;36
130600010;600;565;565;2;134;501;1;98;0;3;95;36;1;35
130600011;400;430;430;2;173;273;1;126;8;2;116;47;2;45
130600012;600;593;594;5;129;470;1;129;10;0;119;0;0;0
130600013;500;556;556;6;142;380;3;117;7;0;110;25;1;24
130600014;300;329;329;2;102;230;1;69;0;0;69;33;2;31
130600015;300;293;293;3;98;201;1;98;5;2;91;0;0;0
130600016;100;38;38;7;17;82;1;17;0;1;16;0;0;0
130800001;500;836;837;5;256;332;1;167;3;8;156;89;4;85
130800002;500;979;981;6;213;371;1;128;3;6;119;85;5;80
130800003;500;893;897;6;249;351;1;148;10;3;135;101;5;96
130800004;500;908;910;3;286;372;2;126;5;7;114;160;8;152
130800005;500;853;857;3;296;380;1;119;5;8;106;177;8;169
130800006;500;853;855;5;349;336;3;161;2;4;155;188;12;176
130800007;500;849;870;4;266;297;10;193;5;5;183;73;3;70
130800008;500;1074;1074;2;56;467;1;32;5;0;27;24;0;24
130800009;500;863;866;8;335;350;2;148;4;4;140;187;3;184
130800010;500;911;914;2;346;342;1;157;7;8;142;189;11;178
130800011;500;975;977;5;347;286;1;213;5;7;201;134;2;132
130800012;500;984;985;8;251;360;4;136;3;2;131;115;0;115
130800013;500;819;821;3;308;340;2;158;17;3;138;150;3;147
130800014;500;945;949;4;359;278;2;220;9;6;205;139;12;127
130800015;500;889;893;6;332;328;3;169;3;3;163;163;10;153
130800016;500;882;884;6;305;289;1;210;5;5;200;95;5;90
130800017;500;876;876;3;301;328;1;171;6;4;161;130;4;126
130800018;500;905;906;2;310;285;10;205;9;4;192;105;11;94
130800019;500;889;889;2;215;380;1;119;2;5;112;96;4;92
130800020;500;1071;1071;2;80;419;1;80;17;0;63;0;0;0
130800021;500;980;981;6;214;358;1;141;11;2;128;73;8;65
130800022;500;929;929;4;272;326;1;173;2;7;164;99;11;88
130800023;300;251;251;5;168;130;2;168;1;5;162;0;0;0
130800024;300;205;205;2;131;168;1;131;0;0;131;0;0;0
130800025;200;155;155;5;118;81;1;118;0;0;118;0;0;0
130800026;100;50;50;21;64;34;2;64;2;0;62;0;0;0
130800027;100;27;27;5;29;70;1;29;4;1;24;0;0;0
130800028;200;43;43;36;79;120;1;79;5;1;73;0;0;0
130800029;200;37;37;47;84;114;2;84;1;5;78;0;0;0
130800036;700;1072;1072;4;297;455;2;243;7;5;231;54;7;47
130800037;700;1018;1018;5;280;462;1;237;5;3;229;39;2;37
130800038;700;1020;1020;6;287;463;2;235;4;1;230;52;4;48
130800039;700;941;941;3;273;481;4;215;3;0;212;58;0;58
130800041;700;767;768;9;393;351;4;345;17;1;327;48;1;47
130800042;300;224;224;7;110;189;1;110;4;0;106;0;0;0
130800043;800;672;672;7;244;572;3;225;4;1;220;19;0;19
130800044;700;554;555;6;215;503;1;196;10;4;182;19;2;17
130800045;300;209;209;4;165;132;3;165;3;1;161;0;0;0
130800046;800;674;674;5;311;494;2;304;10;10;284;7;0;7
130800047;400;320;320;4;235;164;1;235;1;0;234;0;0;0
130800048;200;120;120;4;90;109;1;90;1;0;89;0;0;0
130800049;200;172;172;3;103;96;1;103;2;1;100;0;0;0
130800050;200;141;141;3;71;128;1;71;0;0;71;0;0;0
130800051;400;309;309;4;178;230;0;170;8;0;162;8;0;8
130800052;200;151;151;6;78;122;0;78;2;0;76;0;0;0
130800053;200;110;110;4;74;125;1;74;1;0;73;0;0;0
130800054;200;164;164;4;110;89;1;110;1;3;106;0;0;0
130800055;400;308;308;3;204;195;1;204;1;0;203;0;0;0
130800056;1000;855;855;6;535;469;1;530;6;2;522;5;0;5
130800057;200;139;139;4;63;136;1;63;0;0;63;0;0;0
130800059;100;19;19;0;18;82;0;18;3;0;15;0;0;0
131400001;600;615;624;2;282;319;2;279;7;7;265;3;1;2
131400002;500;467;470;3;171;322;18;160;17;2;141;9;0;9
131400003;300;301;301;3;94;205;1;94;1;0;93;0;0;0
131400004;400;464;469;2;185;218;1;181;5;8;168;4;0;4
131400005;400;449;451;0;158;277;1;122;2;4;116;36;2;34
131400006;250;294;294;7;140;99;11;140;10;1;129;0;0;0
131400007;600;670;670;1;240;394;1;205;9;3;193;35;0;35
131400008;200;189;192;1;100;99;1;100;5;4;91;0;0;0
131400009;50;30;30;2;24;25;1;24;0;0;24;0;0;0
131400010;650;646;646;2;248;431;1;218;15;0;203;30;0;30
131400011;50;20;20;0;20;29;1;20;1;0;19;0;0;0
131900001;300;611;613;7;219;200;1;99;2;4;93;120;8;112
131900002;400;741;743;7;292;269;1;130;4;0;126;162;13;149
131900003;300;650;651;6;255;187;1;112;2;1;109;143;8;135
131900004;300;659;662;10;306;178;1;121;8;3;110;185;5;180
131900005;400;799;803;7;350;243;2;155;5;4;146;195;14;181
131900006;500;970;975;7;403;331;1;168;5;4;159;235;10;225
131900007;400;905;906;8;334;242;5;153;4;7;142;181;5;176
131900008;400;779;781;12;313;296;1;103;1;2;100;210;9;201
131900009;400;833;835;6;326;281;2;117;2;2;113;209;9;200
131900010;300;551;551;9;187;201;1;98;1;6;91;89;2;87
131900011;400;740;742;9;308;268;1;131;1;6;124;177;7;170
131900012;300;615;615;8;218;160;1;139;1;4;134;79;2;77
131900013;300;586;587;4;230;200;1;99;2;4;93;131;4;127
131900014;400;816;817;9;343;251;1;148;5;4;139;195;8;187
131900015;400;762;764;7;233;285;1;114;2;0;112;119;3;116
131900016;400;852;853;4;301;260;1;139;5;1;133;162;11;151
131900017;400;706;708;7;273;283;1;116;3;6;107;157;9;148
131900018;400;792;792;4;334;275;1;124;4;4;116;210;6;204
131900019;300;647;647;7;268;187;1;112;1;4;107;156;11;145
131900020;300;589;591;5;241;201;1;98;3;0;95;143;9;134
131900021;400;854;857;7;346;238;5;157;3;1;153;189;11;178
131900022;400;705;707;7;255;264;3;133;2;2;129;122;5;117
131900023;400;722;722;10;292;274;1;125;5;5;115;167;7;160
131900024;400;683;686;8;256;288;1;111;4;2;105;145;3;142
131900025;400;732;732;7;166;317;4;79;1;0;78;87;3;84
131900026;300;603;604;4;183;211;1;88;0;3;85;95;5;90
131900027;300;675;675;10;123;240;1;59;2;2;55;64;1;63
131900028;400;842;847;7;298;259;1;140;6;4;130;158;14;144
131900029;300;530;537;13;189;212;1;87;4;1;82;102;8;94
131900030;300;578;579;6;211;194;1;105;1;3;101;106;8;98
131900031;400;748;749;6;306;252;1;147;2;2;143;159;8;151
131900032;400;784;784;4;314;282;1;117;2;8;107;197;11;186
131900033;400;704;708;7;313;256;2;142;4;3;135;171;8;163
131900034;500;929;930;8;365;355;1;144;3;1;140;221;10;211
131900035;400;809;809;8;286;255;1;144;4;0;140;142;10;132
131900036;400;887;889;6;275;284;1;115;2;3;110;160;7;153
131900037;400;773;773;5;124;339;1;60;0;4;56;64;3;61
131900038;400;770;769;9;287;268;2;130;0;4;126;157;12;145
131900039;200;320;320;6;117;109;3;88;0;3;85;29;1;28
131900040;400;750;751;9;282;276;1;123;3;3;117;159;8;151
131900041;400;902;901;9;356;233;2;165;0;4;161;191;11;180
131900042;300;534;535;6;96;239;1;60;0;4;56;36;0;36
131900043;600;977;977;6;46;558;1;41;9;0;32;5;0;5
131900044;600;1021;1023;10;28;578;1;21;2;0;19;7;0;7
131900045;300;619;619;8;210;195;2;103;2;1;100;107;7;100
131900046;300;675;675;6;276;170;1;129;12;2;115;147;9;138
131900047;400;795;798;5;236;259;1;140;8;6;126;96;3;93
131900048;400;751;751;7;262;284;1;115;3;1;111;147;5;142
131900049;300;520;521;5;165;226;1;73;2;3;68;92;5;87
131900050;400;717;716;10;233;300;1;99;2;6;91;134;5;129
131900051;300;507;507;7;71;256;3;41;6;0;35;30;1;29
131900052;400;688;687;8;130;341;1;58;0;1;57;72;4;68
131900053;400;677;678;10;46;353;1;46;7;1;38;0;0;0
131900054;400;629;631;8;72;350;1;49;4;0;45;23;2;21
131900055;300;516;513;8;157;170;1;129;6;8;115;28;1;27
131900056;400;676;675;7;202;283;1;116;3;2;111;86;5;81
131900057;400;786;785;9;227;283;1;116;6;4;106;111;4;107
131900058;400;840;840;7;295;266;1;133;3;6;124;162;12;150
131900059;400;721;721;7;229;304;1;95;1;5;89;134;7;127
131900060;500;843;843;8;30;469;1;30;3;0;27;0;0;0
131900061;400;749;749;10;23;398;1;1;0;0;1;22;0;22
131900062;400;807;809;8;309;268;3;129;2;2;125;180;7;173
131900063;300;484;485;7;183;209;1;90;2;1;87;93;6;87
131900064;300;497;499;7;150;227;1;72;1;2;69;78;1;77
131900065;400;846;847;6;239;254;2;144;7;4;133;95;3;92
131900066;400;771;771;9;252;277;1;122;4;4;114;130;4;126
131900067;400;230;769;6;236;286;1;113;7;5;101;123;8;115
131900068;300;628;630;8;182;210;2;88;3;2;83;94;10;84
131900069;400;783;783;9;269;284;1;115;7;1;107;154;4;150
131900070;400;769;771;7;225;304;1;95;3;4;88;130;10;120
131900071;300;655;656;7;242;191;1;108;3;0;105;134;14;120
131900072;500;758;759;8;90;449;2;49;2;2;45;41;4;37
131900073;400;621;624;6;142;336;1;63;3;2;58;79;4;75
131900074;400;698;699;7;213;310;1;89;0;3;86;124;10;114
131900075;400;685;685;7;282;291;1;108;2;3;103;174;7;167
131900076;400;628;629;8;62;364;1;35;7;0;28;27;0;27
131900077;600;1014;1014;6;29;570;1;29;7;0;22;0;0;0
131900078;400;801;801;10;228;300;1;99;3;3;93;129;4;125
131900079;400;662;663;9;248;306;1;93;1;1;91;155;7;148
131900080;400;650;652;8;277;249;2;149;1;11;137;128;4;124
131900081;400;731;737;8;222;297;1;102;8;3;91;120;11;109
131900082;300;523;522;4;145;234;3;63;2;2;59;82;4;78
131900083;600;960;958;7;43;565;1;34;5;0;29;9;1;8
131900084;600;922;922;6;27;578;1;21;3;0;18;6;0;6
131900085;600;1002;1004;6;48;563;1;36;4;0;32;12;0;12
131900086;500;737;737;7;29;485;1;14;1;0;13;15;0;15
131900087;300;611;613;7;197;236;1;63;0;6;57;134;4;130
131900088;200;211;212;7;109;90;1;109;1;5;103;0;0;0
131900089;300;632;632;6;28;275;1;24;4;0;20;4;0;4
131900090;300;581;581;7;239;218;1;81;1;4;76;158;4;154
131900091;500;790;791;5;23;479;1;20;4;0;16;3;0;3
131900092;100;22;22;52;54;45;1;54;0;1;53;0;0;0
131900093;100;24;24;15;33;66;1;33;2;2;29;0;0;0
131900094;100;26;26;31;57;42;1;57;6;0;51;0;0;0
131900095;200;114;114;10;60;139;1;60;16;1;43;0;0;0
131900100;100;26;26;7;33;66;1;33;0;0;33;0;0;0
131900151;400;832;829;4;175;237;1;162;9;2;151;13;0;13
131900152;500;978;980;4;149;365;2;133;8;0;125;16;0;16
131900153;300;640;642;5;146;213;2;85;4;2;79;61;4;57
131900154;200;350;350;7;104;104;1;95;8;1;86;9;1;8
131900155;400;706;706;6;197;287;1;112;4;3;105;85;5;80
131900156;600;1038;1037;6;151;470;1;129;18;4;107;22;1;21
131900157;400;709;711;0;255;237;1;162;8;7;147;93;9;84
131900158;300;556;556;1;133;213;1;86;3;3;80;47;2;45
131900159;300;554;554;2;179;180;1;119;6;5;108;60;3;57
131900160;300;575;576;8;174;203;3;94;6;2;86;80;7;73
131900161;300;464;464;6;179;215;1;84;3;4;77;95;8;87
131900162;700;702;702;3;391;316;5;379;43;4;332;12;1;11
131900163;300;668;671;4;237;128;1;171;5;5;161;66;0;66
131900164;300;634;640;6;275;126;1;173;9;6;158;102;3;99
131900165;300;504;504;6;145;226;1;73;2;4;67;72;3;68
131900166;400;832;832;3;191;285;1;114;2;4;108;77;4;73
131900167;300;698;698;2;178;189;2;109;1;3;105;69;7;62
131900168;400;884;885;3;147;311;1;88;4;6;78;59;2;57
131900169;400;739;739;5;216;287;1;112;4;1;107;104;3;101
131900170;400;866;866;4;144;317;2;81;6;1;74;63;3;60
131900171;200;328;328;2;146;69;2;129;5;3;121;17;1;16
131900172;400;716;716;6;164;257;1;142;5;4;133;22;2;20
131900173;400;794;797;2;175;265;1;134;6;3;125;41;6;35
131900174;500;980;981;6;68;442;4;54;11;0;43;14;0;14
131900175;400;701;702;5;160;317;1;82;2;3;77;78;4;74
131900176;300;481;481;4;218;141;2;157;2;5;150;61;2;59
131900177;400;755;756;5;194;246;1;153;4;4;145;41;3;38
131900178;400;809;810;2;254;244;1;155;3;2;150;98;10;88
131900179;300;574;574;2;167;210;1;89;5;0;84;78;9;69
131900180;400;770;770;4;114;314;1;85;6;0;79;29;0;29
131900181;300;485;485;2;173;202;1;97;3;3;91;76;10;66
131900182;300;425;425;2;153;200;1;99;1;2;96;54;6;48
131900183;300;455;455;2;185;166;2;132;1;2;129;53;2;51
131900184;200;154;155;3;57;142;1;57;0;2;55;0;0;0
131900185;400;823;827;3;227;252;1;147;9;4;134;80;3;77
131900186;400;740;741;2;245;235;1;164;9;2;153;81;7;74
131900187;400;878;877;3;265;201;1;198;8;1;189;67;3;64
131900188;300;412;412;1;162;195;2;103;2;2;99;59;1;58
131900189;300;638;638;3;184;150;7;143;8;0;135;41;1;40
131900190;300;546;546;3;123;198;2;100;6;2;92;23;1;22
131900191;400;735;739;4;220;265;2;133;14;1;118;87;2;85
131900192;400;890;891;4;211;203;3;194;11;5;178;17;0;17
131900193;400;703;705;4;300;144;1;255;13;8;234;45;4;41
131900194;200;161;161;0;65;133;2;65;1;0;64;0;0;0
131900195;300;391;390;5;118;201;1;98;4;0;94;20;1;18
131900196;200;206;207;5;99;100;1;99;0;1;98;0;0;0
131900197;400;745;745;5;263;182;2;216;18;1;197;47;1;46
131900198;200;130;131;4;76;123;1;76;3;2;71;0;0;0
131900200;300;518;518;3;232;131;2;167;10;0;157;65;6;59
131900201;400;679;679;2;61;347;1;52;2;0;50;9;0;9
131900202;300;446;446;1;167;194;1;105;2;7;96;62;3;59
131900203;300;639;639;4;147;214;1;85;4;2;79;62;3;59
131900204;400;777;777;3;243;246;2;152;8;1;143;91;6;85
131900205;400;670;670;4;176;224;1;175;16;2;157;1;0;1
132000001;900;886;888;0;306;750;1;149;2;4;143;157;10;147
132000002;800;806;808;0;240;690;3;107;2;5;100;133;7;126
132000003;900;909;914;0;335;565;2;333;1;4;328;2;0;2
132000004;900;877;878;0;258;740;1;159;5;4;150;99;1;98
132000005;900;868;868;0;254;772;2;126;2;4;120;128;7;121
132000006;800;845;845;0;311;633;1;166;7;6;153;145;10;135
132000007;800;847;848;0;122;743;1;56;3;1;52;66;9;57
132000008;900;895;895;0;240;779;1;120;6;4;110;120;3;117
132000009;900;922;922;2;354;724;2;174;6;7;161;180;6;174
132000010;800;874;876;0;277;672;1;127;2;5;120;150;12;138
132000011;800;883;885;3;272;649;1;150;4;3;143;122;5;117
132000012;700;731;732;0;308;553;1;146;4;4;138;162;8;154
132000013;700;663;663;0;211;586;1;113;6;5;102;98;4;94
132000014;900;917;920;2;293;739;2;159;4;5;150;134;6;128
132000015;900;896;896;0;204;773;1;126;2;3;121;78;3;75
132000016;800;823;824;0;251;653;1;146;4;2;140;105;3;102
132000017;900;908;908;0;301;746;1;153;1;6;146;148;6;142
132000018;500;542;545;3;217;342;1;157;4;11;142;60;2;58
132000019;800;824;824;1;287;634;3;163;7;3;153;124;4;120
132000020;500;506;506;0;176;366;1;133;0;1;132;43;1;42
132000021;500;515;516;3;214;309;1;190;12;2;176;24;0;24
132000022;900;886;888;1;258;753;1;146;5;3;138;112;7;105
132000023;200;207;207;6;82;117;1;82;1;1;80;0;0;0
132000024;600;594;594;2;204;411;3;186;21;1;164;18;2;16
132000025;700;762;763;1;216;535;1;164;3;2;159;52;3;49
132000026;700;717;717;3;183;568;2;130;1;3;126;53;2;51
132000027;300;10;10;65;72;226;2;72;5;4;63;0;0;0
132100001;1000;1205;1206;3;201;801;1;198;47;1;150;3;0;3
132100002;1000;1216;1216;5;215;861;1;138;26;1;111;77;0;77
132100003;500;433;433;4;180;382;2;116;3;1;112;64;3;61
132100004;900;869;871;5;244;764;2;134;8;2;124;110;6;104
132100005;1000;1052;1052;5;176;837;1;162;27;0;135;14;0;14
132100006;1000;1190;1190;8;250;761;1;238;54;1;183;12;1;11
132100007;600;561;562;5;203;458;1;141;3;1;137;62;0;62
132100008;600;600;602;4;214;417;2;181;4;2;175;32;2;30
132100009;800;804;805;3;296;621;1;178;4;10;164;118;4;114
132100010;500;538;538;5;239;358;4;138;4;2;132;101;1;100
132100011;600;608;608;0;253;439;1;160;3;8;149;93;7;86
132100012;500;522;523;0;196;384;2;114;2;1;111;82;4;78
132100013;500;456;456;3;172;406;4;90;0;2;88;82;4;78
132100014;600;580;581;1;219;476;3;121;1;2;118;98;7;91
132100015;500;443;446;0;196;385;1;114;5;2;107;82;8;74
132100016;600;577;578;6;233;458;1;141;6;6;129;92;5;87
132100017;500;523;523;6;201;400;1;99;2;7;90;102;6;96
132100018;700;613;613;6;232;543;1;156;2;15;139;76;3;73
132100019;900;848;853;5;324;696;2;202;5;7;190;122;3;119
132100020;800;713;718;2;250;653;1;146;2;3;141;104;4;100
132100021;800;742;742;6;261;666;2;132;4;2;126;129;5;124
132100022;500;418;419;7;175;408;1;91;3;5;83;84;1;83
132100023;1000;1214;1214;7;245;790;1;209;29;1;179;36;0;36
132100024;100;24;24;0;22;77;1;22;1;0;21;0;0;0
132100026;500;587;588;0;247;310;1;189;9;5;175;58;4;52
132100027;500;497;499;0;232;343;3;154;5;4;145;78;2;76
132100028;500;555;557;5;162;379;2;119;3;2;114;43;2;41
132400001;700;653;653;5;258;523;2;175;4;5;166;83;0;83
132400002;700;696;696;1;267;525;1;174;7;3;164;93;4;89
132400003;600;650;650;0;299;383;1;216;6;8;202;83;4;79
132400004;700;666;666;1;267;500;2;198;15;3;180;69;6;63
132400005;500;535;536;1;276;250;1;249;7;5;237;27;0;27
132400006;800;763;763;0;363;495;1;304;10;6;288;59;2;57
132400007;1000;1143;1144;0;302;698;1;301;35;1;265;1;0;1
132400008;1000;1094;1094;0;284;715;1;284;20;2;262;0;0;0
132400009;700;762;762;7;309;389;2;309;6;5;298;0;0;0
132400010;800;809;809;0;296;522;1;277;11;5;261;19;0;19
132400011;1000;967;967;0;462;570;1;429;12;10;407;33;6;27
132400012;1000;1029;1029;0;389;629;1;370;17;8;345;19;0;19
132400013;700;711;711;3;357;364;1;335;11;10;314;22;1;21
132400014;900;939;939;0;413;560;1;339;16;5;318;74;6;68
132400015;700;667;670;3;389;310;1;389;13;7;369;0;0;0
132400016;700;689;689;0;176;544;1;155;12;0;143;21;0;21
132900001;1000;1061;1062;0;413;588;1;411;14;1;396;2;0;2
132900002;1000;1058;1058;7;413;587;1;412;28;1;383;1;0;1
132900003;800;837;837;2;246;625;1;174;3;12;159;72;6;66
132900004;700;735;738;0;242;527;1;172;4;4;164;70;2;68
132900005;800;810;810;0;294;588;2;210;3;7;200;84;4;80
132900006;700;738;740;2;253;545;2;153;2;2;149;93;10;83
132900007;700;749;750;1;268;546;2;152;4;7;141;116;3;113
132900008;800;803;803;4;287;618;1;181;3;2;176;106;7;99
132900009;600;252;600;4;256;405;1;194;8;9;177;62;7;55
132900010;900;877;878;2;318;653;1;246;13;6;227;72;3;69
132900011;800;818;818;3;251;635;1;164;6;6;152;87;4;83
132900012;600;608;608;1;182;484;1;115;3;1;111;67;3;64
132900013;700;650;650;3;200;563;2;135;7;1;127;65;2;63
132900014;900;921;924;2;322;618;1;281;14;6;261;41;2;39
132900015;600;534;536;0;160;493;1;106;5;3;98;54;1;53
132900016;500;489;489;0;137;409;1;90;4;2;84;47;5;42
132900017;500;531;531;0;167;382;1;117;4;8;105;50;1;49
132900018;600;587;587;5;267;358;1;241;13;5;223;26;2;24
132900019;500;509;509;0;204;347;1;152;11;3;138;52;0;52
132900020;100;24;24;6;18;81;1;18;1;0;17;0;0;0
132900021;800;778;778;3;470;338;1;461;6;3;452;9;0;9
132900022;900;859;859;1;300;658;1;241;10;3;228;59;3;56
132900023;1100;1117;1117;0;408;691;1;408;51;2;355;0;0;0
132900024;400;416;416;3;172;286;1;113;1;2;110;59;2;57
132900025;600;594;594;4;313;321;1;278;6;3;269;35;1;34
132900026;800;778;779;4;241;630;1;169;6;8;155;72;5;67
132900027;700;738;738;4;271;513;2;185;6;5;174;86;2;84
132900028;900;899;899;3;650;252;4;644;34;2;608;6;0;6
132900029;700;735;737;2;301;484;1;215;6;9;200;86;7;79
132900030;300;224;224;7;92;207;1;92;0;3;89;0;0;0
133200001;700;711;712;6;285;513;1;186;8;3;175;99;1;98
133200002;900;876;877;3;364;563;1;336;9;10;317;28;3;25
133200003;700;741;743;1;221;556;2;142;7;1;134;79;2;77
133200004;600;537;537;3;197;494;2;104;2;3;99;93;4;89
133200005;600;575;575;5;208;480;1;119;4;1;114;89;1;88
133200006;100;123;123;8;64;34;2;64;2;2;60;0;0;0
133200007;200;181;182;6;107;91;2;107;5;1;101;0;0;0
133200008;100;113;113;5;52;47;1;52;6;1;45;0;0;0
133200009;100;122;122;5;57;42;1;57;4;0;53;0;0;0
133900001;900;943;1027;8;695;277;0;623;13;9;601;72;3;69
133900002;900;888;987;3;650;282;1;617;8;6;603;33;3;30
133900003;900;891;998;6;508;431;1;468;3;9;456;40;0;40
133900004;400;463;538;2;370;35;2;363;2;0;361;7;0;7
133900005;400;517;570;2;297;111;1;288;5;4;279;9;0;9
133900006;300;288;288;0;271;29;0;271;0;1;270;0;0;0
133900007;200;128;128;0;128;71;1;128;0;0;128;0;0;0
140800001;500;827;827;7;146;411;1;88;2;3;83;58;1;57
140800002;500;788;790;7;229;360;1;139;0;7;132;90;3;87
140800003;500;780;786;6;250;353;1;146;4;8;134;104;9;95
140800004;500;791;797;5;227;377;1;122;4;2;116;105;6;99
140800005;100;21;21;10;15;84;1;15;1;0;14;0;0;0
140800006;100;17;17;4;20;79;1;20;0;1;19;0;0;0
140800007;100;25;24;8;22;77;1;22;0;0;22;0;0;0
140800008;100;37;37;5;19;80;1;19;0;2;17;0;0;0
140800009;100;68;68;7;44;55;1;44;1;1;42;0;0;0
140800010;100;40;40;8;20;79;1;20;0;1;19;0;0;0
140800011;100;23;23;6;17;82;1;17;1;0;16;0;0;0
140800012;100;52;52;5;26;73;1;26;0;1;25;0;0;0
140800013;100;69;70;6;31;68;1;31;2;1;28;0;0;0
140800014;100;62;62;6;31;68;1;31;2;0;29;0;0;0
140800015;100;94;96;8;52;47;1;52;2;0;50;0;0;0
140800016;100;39;39;7;26;73;1;26;1;2;23;0;0;0
140800017;100;26;26;8;24;75;1;24;0;0;24;0;0;0
140800018;200;112;113;3;73;126;1;73;0;5;68;0;0;0
140800019;200;128;135;3;59;140;1;59;1;1;57;0;0;0
140800020;100;91;91;9;42;57;1;42;0;2;40;0;0;0
140800021;100;35;36;7;22;77;1;22;1;0;21;0;0;0
140800022;500;427;427;3;157;385;1;114;1;2;111;43;3;40
140800023;200;113;115;5;53;146;1;53;5;1;47;0;0;0
140800024;100;71;72;6;44;55;1;44;0;0;44;0;0;0
140800025;200;171;171;5;62;137;1;62;1;1;60;0;0;0
141900001;300;250;252;6;117;181;2;117;2;9;106;0;0;0
141900002;600;511;514;5;232;450;1;149;5;4;140;82;3;79
141900003;500;436;437;4;152;387;1;112;2;4;106;40;5;35
141900004;100;48;48;7;34;65;1;34;0;1;33;0;0;0
141900005;100;48;48;4;23;76;1;23;5;1;17;0;0;0
141900006;200;103;103;6;71;128;1;71;1;1;69;0;0;0
141900007;100;57;60;8;36;63;1;36;3;1;32;0;0;0
141900008;100;80;80;5;42;57;1;42;1;0;41;0;0;0
141900009;100;26;26;7;19;80;1;19;0;0;19;0;0;0
141900010;100;45;45;8;22;77;1;22;1;2;19;0;0;0
141900011;100;41;41;7;28;71;1;28;2;1;25;0;0;0
141900012;200;122;122;5;87;112;1;87;0;3;84;0;0;0
141900013;100;61;61;7;48;50;2;48;0;0;48;0;0;0
141900014;100;21;21;0;20;80;0;20;0;0;20;0;0;0
142200001;100;70;70;5;40;59;1;40;0;0;40;0;0;0
142200002;100;73;73;7;47;52;1;47;2;1;44;0;0;0
142200003;300;147;168;5;86;212;2;86;3;3;80;0;0;0
142200004;300;199;199;5;105;194;1;105;2;1;102;0;0;0
142200005;100;42;42;7;28;71;1;28;0;0;28;0;0;0
142200006;200;144;144;3;102;96;2;102;4;1;97;0;0;0
142200007;300;214;214;2;115;184;1;115;4;4;107;0;0;0
142200008;200;119;119;2;74;125;1;74;3;2;69;0;0;0
142200009;100;21;21;5;14;85;1;14;0;0;14;0;0;0
142200010;100;19;19;8;21;78;1;21;4;0;17;0;0;0
143200001;300;580;581;8;156;211;2;87;0;2;85;69;6;63
143200002;200;446;446;6;151;117;3;80;1;2;77;71;2;69
143200003;500;932;934;4;314;355;1;144;7;4;133;170;7;163
143200004;300;515;517;9;212;185;2;113;3;2;108;99;4;95
143200005;300;470;470;5;164;209;1;90;3;3;84;74;2;72
143200006;200;474;477;6;176;91;1;108;3;2;103;68;4;64
143200007;300;497;497;8;180;218;3;79;2;1;76;101;4;97
143200008;300;569;569;5;195;183;1;116;4;3;109;79;4;75
143200009;300;622;623;6;226;188;2;110;2;6;102;116;3;113
143200010;500;877;879;5;324;358;1;141;0;4;137;183;13;170
143200011;300;594;594;8;250;193;2;105;2;3;100;145;7;138
143200012;300;540;540;9;216;203;1;96;3;2;91;120;5;115
143200013;500;741;742;10;261;381;1;118;3;3;112;143;12;131
143200014;300;427;427;5;159;205;1;94;1;1;92;65;3;62
143200015;300;517;519;6;183;213;3;84;6;4;74;99;5;94
143200016;300;496;497;6;152;216;1;83;2;6;75;69;2;67
143200017;300;632;632;4;205;191;1;108;5;5;98;97;7;90
143200018;500;854;857;6;297;357;1;142;2;7;133;155;7;148
143200019;300;525;525;5;211;177;1;122;3;3;116;89;2;87
143200020;300;653;654;9;209;203;1;96;2;2;92;113;5;108
143200021;200;467;467;6;158;142;1;57;4;2;51;101;4;97
143200022;300;561;561;10;157;230;1;69;2;2;65;88;2;86
143200023;300;652;653;11;232;195;1;104;0;1;103;128;2;126
143200024;300;555;555;6;198;206;2;92;0;0;92;106;9;97
143200025;300;515;515;6;155;209;1;90;3;5;82;64;4;60
143200026;500;702;702;9;256;406;3;91;2;0;89;165;8;157
143200027;300;660;662;2;213;206;2;92;1;4;87;121;7;114
143200028;400;656;657;8;202;279;3;118;7;3;108;84;8;76
143200029;200;425;425;7;142;135;1;64;2;2;60;78;2;76
143200030;200;427;427;5;140;133;1;66;1;3;62;74;5;69
143200031;300;709;710;7;240;175;2;123;3;3;117;117;7;110
143200032;300;530;530;9;196;198;1;101;2;5;94;95;3;92
143200033;500;869;873;9;257;377;1;122;1;5;116;135;6;129
143200034;500;798;798;5;275;352;1;147;6;5;136;128;11;117
143200035;400;487;488;2;302;175;1;224;7;6;211;78;9;69
143200036;300;527;527;9;198;173;1;126;0;1;125;72;1;71
143200037;300;497;497;5;213;166;2;132;4;2;126;81;3;78
143200038;300;556;558;4;250;152;1;147;5;3;139;103;4;99
143200039;300;603;603;5;237;215;1;84;1;1;82;153;11;142
143200040;300;715;717;5;247;178;1;121;2;3;116;126;4;122
143200041;300;594;596;7;183;204;1;95;1;4;90;88;3;85
143200042;300;629;631;9;214;198;1;101;2;2;97;113;3;110
143200043;300;669;669;4;166;217;1;82;2;1;79;84;4;80
143200044;300;594;596;8;222;209;1;90;5;3;82;132;8;124
143200045;500;757;758;7;224;406;1;93;5;5;83;131;11;120
143200046;500;751;751;5;255;366;1;133;1;5;127;122;9;113
143200047;400;527;530;3;197;269;1;130;3;3;124;67;0;67
143200048;400;560;560;3;347;161;1;238;5;3;230;109;5;104
143200049;400;525;529;4;250;161;2;237;2;6;229;13;1;12
143200050;700;941;941;4;389;521;1;178;8;4;166;211;6;205
143200051;200;136;136;5;73;126;1;73;0;1;72;0;0;0
143200052;100;11;11;0;11;89;0;11;0;0;11;0;0;0
143200053;200;483;484;3;151;124;2;74;5;0;69;77;2;75
143200054;300;671;671;1;241;160;1;139;2;7;130;102;3;99
143200055;300;546;546;3;196;179;1;120;5;10;105;76;8;68
143200056;300;583;583;4;173;212;1;87;0;3;84;86;3;83
143200057;300;568;569;4;191;199;1;100;5;4;91;91;7;84
143200058;300;551;553;4;160;200;1;99;4;6;89;61;4;57
143200059;300;555;557;4;174;214;2;84;5;3;76;90;5;85
143200060;300;561;562;2;177;205;1;94;4;4;86;83;6;77
143200061;300;621;622;10;214;203;1;96;7;4;85;118;5;113
143200062;500;781;783;0;121;450;1;49;4;0;45;72;1;71
143200063;300;644;644;6;82;240;1;59;3;1;55;23;1;22
143200064;500;868;871;13;331;281;1;218;11;6;201;113;7;106
143200065;300;643;644;6;219;179;1;120;5;2;113;99;3;96
143200066;500;788;789;5;282;350;1;149;2;5;142;133;5;128
143200067;200;416;417;6;152;122;1;77;2;4;71;75;3;72
143200068;300;737;740;4;249;200;1;99;4;3;92;150;8;142
143200069;300;488;489;3;191;189;2;109;3;3;103;82;6;76
143200070;500;791;792;5;318;336;2;162;2;11;149;156;9;147
143200071;500;750;752;6;277;322;2;176;8;5;163;101;7;94
143200072;500;810;810;6;91;434;1;65;1;0;64;26;0;26
143200073;500;891;893;4;336;278;1;221;2;2;217;115;7;108
143200074;300;680;680;8;312;180;2;118;5;5;108;194;18;176
143200075;300;463;463;5;206;187;1;112;3;3;106;94;1;93
143200076;500;704;706;8;286;396;1;103;1;3;99;183;16;167
143200077;300;672;672;6;308;172;5;123;2;2;119;185;14;171
143200078;300;518;518;5;226;176;1;123;5;5;113;103;3;100
143200079;300;492;493;7;194;228;1;71;2;1;68;123;8;115
143200080;300;640;640;4;282;150;3;147;2;3;142;135;9;126
143200081;300;621;622;8;264;148;2;150;3;5;142;114;10;104
143200082;300;513;513;8;254;176;1;123;3;2;118;131;6;125
143200083;500;728;729;5;283;357;2;141;4;4;133;142;8;134
143200084;500;757;759;7;350;332;2;166;4;10;152;184;14;170
143200085;300;525;526;4;192;202;2;96;0;2;94;96;3;93
143200086;300;527;530;5;211;192;1;107;5;4;98;104;4;100
143200087;300;510;510;8;186;211;1;88;2;6;80;98;7;91
143200088;500;797;798;9;316;307;1;192;3;7;182;124;5;119
143200089;300;441;441;7;172;205;3;92;2;2;88;80;7;73
143200090;300;620;621;6;244;99;3;198;20;4;174;46;3;43
143200091;300;541;542;6;283;89;1;210;6;6;198;73;4;69
143200092;500;791;791;8;297;322;2;176;4;3;169;121;7;114
143200093;300;554;555;6;188;211;1;88;5;2;81;100;9;91
143200094;500;829;830;8;288;309;1;190;9;7;174;98;6;92
143200095;300;654;654;4;227;188;2;110;4;3;103;117;9;108
143200096;300;670;670;7;242;158;5;137;4;6;127;105;4;101
143200097;300;500;502;6;206;175;1;124;2;6;116;82;5;77
143200098;500;688;689;8;280;297;1;202;7;7;188;78;3;75
143200099;300;556;558;4;217;173;3;124;3;4;117;93;5;88
143200100;200;470;470;5;205;89;4;107;7;3;97;98;3;95
143200101;500;781;781;8;331;275;1;224;7;10;207;107;5;102
143200102;200;401;403;4;134;122;1;77;0;0;77;57;1;56
143200103;200;451;452;4;150;137;1;62;1;4;57;88;3;85
143200104;300;521;522;5;183;213;1;86;3;0;83;97;6;91
143200105;500;729;730;4;259;367;1;132;5;3;124;127;3;124
143200106;500;693;695;5;250;368;1;131;6;4;121;119;8;111
143200107;300;566;566;6;222;184;1;115;6;2;107;107;7;100
143200108;300;507;507;3;201;201;1;98;1;4;93;103;10;93
143200109;300;509;511;6;186;193;1;106;3;3;100;80;7;73
143200110;500;804;805;8;289;330;1;169;10;7;152;120;7;113
143200111;300;536;536;6;204;205;3;92;6;1;85;112;6;106
143200112;500;808;808;7;285;341;1;158;8;0;150;127;6;121
143200113;200;455;455;7;212;71;2;127;2;2;123;85;4;81
143200114;300;552;553;6;216;165;1;134;1;5;128;82;3;79
143200115;500;677;681;17;254;245;2;253;3;10;240;1;0;1
143200116;200;358;359;10;148;133;1;66;1;5;60;82;6;76
143200117;500;718;718;11;312;341;1;158;3;2;153;154;8;146
143200118;500;628;628;6;262;325;4;171;4;4;163;91;4;87
143200119;500;717;719;6;314;266;1;233;8;4;221;81;7;74
143200120;500;714;715;4;336;283;1;216;6;4;206;120;5;115
143200121;500;651;652;2;254;302;2;196;2;3;191;58;5;53
143200122;300;195;195;4;104;195;1;104;1;1;102;0;0;0
143200123;300;260;261;3;102;197;1;102;2;2;98;0;0;0
143200124;200;58;58;8;37;162;1;37;0;1;36;0;0;0
143200125;100;30;30;7;30;69;1;30;3;0;27;0;0;0
143200126;300;572;572;4;179;188;1;111;2;0;109;68;2;66
143200127;300;616;616;4;168;176;1;123;3;5;115;45;1;44
143200128;300;562;563;7;172;183;1;116;1;5;110;56;2;54
143200129;300;211;211;2;113;185;2;113;1;3;109;0;0;0
143200130;300;307;307;5;111;188;1;111;7;5;99;0;0;0
143200131;300;365;366;3;166;176;1;123;1;1;121;43;2;41
143200132;300;434;439;5;216;167;1;132;5;2;125;84;5;79
143200133;100;80;82;3;51;47;2;51;1;2;48;0;0;0
143200134;100;73;73;4;48;51;1;48;1;1;46;0;0;0
143200135;100;89;89;6;49;49;2;49;2;1;46;0;0;0
143200136;400;567;567;2;272;267;1;132;1;5;126;140;8;132
143200137;100;15;15;0;15;85;0;15;0;0;15;0;0;0
143200138;100;18;18;50;62;37;1;62;5;3;54;0;0;0
143200139;100;41;41;9;14;85;1;14;0;1;13;0;0;0
143200140;100;5;5;5;10;88;2;10;0;2;8;0;0;0
143600001;300;532;532;7;188;208;1;91;3;0;88;97;6;91
143600002;500;809;811;3;177;417;1;82;6;1;75;95;4;91
143600003;500;836;837;5;258;376;3;121;5;7;109;137;4;133
143600004;500;726;726;6;186;429;1;70;7;4;59;116;8;108
143600005;500;641;641;5;215;397;1;102;3;6;93;113;8;105
143600006;500;612;612;6;224;389;1;110;2;4;104;114;9;105
143600007;500;670;670;9;187;400;1;99;6;6;87;88;2;86
143600008;500;509;509;1;183;424;1;75;0;0;75;108;5;103
143600009;500;482;483;6;97;434;1;65;1;3;61;32;2;30
143600010;500;675;675;8;185;422;1;77;2;1;74;108;7;101
143600011;400;387;387;2;140;330;2;68;0;4;64;72;3;69
143600012;500;809;810;3;131;435;1;64;3;2;59;67;8;59
143600013;500;731;733;6;165;421;1;78;4;6;68;87;10;77
143600014;500;677;677;3;140;426;2;72;0;2;70;68;6;62
143600015;500;801;802;7;134;405;1;94;1;4;89;40;0;40
143600016;500;382;383;3;100;456;1;43;2;3;38;57;7;50
143600017;500;806;806;3;185;411;1;88;6;2;80;97;6;91
143600018;500;544;544;8;166;404;2;94;4;1;89;72;3;69
143600019;300;203;203;4;62;237;1;62;0;2;60;0;0;0
143600020;300;287;287;4;89;210;1;89;1;2;86;0;0;0
143600021;200;153;153;5;61;138;1;61;0;1;60;0;0;0
143600022;300;318;318;7;201;98;1;201;5;5;191;0;0;0
143600023;200;117;117;7;72;127;1;72;1;1;70;0;0;0
143600024;200;149;149;6;71;128;1;71;4;5;62;0;0;0
143600025;300;291;291;6;106;193;1;106;2;3;101;0;0;0
143600026;200;119;119;7;57;142;1;57;1;1;55;0;0;0
143600027;200;97;97;6;39;160;1;39;0;4;35;0;0;0
143600028;100;92;92;6;72;27;1;72;2;1;69;0;0;0
143600029;200;90;90;6;55;144;1;55;2;1;52;0;0;0
143600030;100;27;25;6;18;81;1;18;1;0;17;0;0;0
143600031;100;47;47;8;33;66;1;33;1;2;30;0;0;0
143600032;300;208;208;3;89;210;1;89;3;7;79;0;0;0
143600033;300;318;320;5;132;167;1;132;3;6;123;0;0;0
143600035;100;65;65;7;42;57;1;42;7;0;35;0;0;0
143600036;200;173;173;6;61;138;1;61;0;1;60;0;0;0
143600037;400;392;392;4;158;296;2;102;2;4;96;56;2;54
143600038;100;67;67;8;43;56;1;43;1;0;42;0;0;0
143600039;100;35;35;8;28;71;1;28;1;1;26;0;0;0
143600040;100;50;50;7;38;61;1;38;1;0;37;0;0;0
143600041;200;95;95;6;63;136;1;63;2;0;61;0;0;0
143600042;200;105;106;5;50;149;1;50;2;0;48;0;0;0
143600043;100;26;62;8;34;65;1;34;1;2;31;0;0;0
143600044;100;53;53;6;40;59;1;40;1;4;35;0;0;0
143600045;100;44;44;8;40;59;1;40;2;0;38;0;0;0
143600046;200;102;104;6;45;154;1;45;0;1;44;0;0;0
143600047;100;29;29;7;26;73;1;26;0;1;25;0;0;0
143600048;100;20;20;8;15;84;1;15;0;0;15;0;0;0
143600049;100;27;27;6;24;75;1;24;0;0;24;0;0;0
143600050;100;58;58;7;38;61;1;38;1;0;37;0;0;0
143600051;100;73;73;21;68;31;1;68;10;6;52;0;0;0
145100001;500;470;480;1;143;398;1;101;7;4;90;42;3;39
145100002;500;398;399;2;151;397;1;102;4;7;91;49;4;45
145100003;500;587;592;0;171;357;1;142;4;5;133;29;4;25
145100004;500;607;612;1;135;389;3;108;7;6;95;27;1;26
145100005;200;109;109;1;63;136;1;63;1;2;60;0;0;0
145100006;200;115;121;4;75;124;1;75;2;2;71;0;0;0
145100007;200;108;108;5;59;138;3;59;4;7;48;0;0;0
145100008;200;73;74;7;49;150;1;49;0;0;49;0;0;0
145100009;200;49;49;4;39;160;1;39;0;0;39;0;0;0
145100010;200;72;77;6;36;163;1;36;2;0;34;0;0;0
145100011;100;33;33;7;24;75;1;24;0;1;23;0;0;0
145100012;100;41;41;7;26;72;2;26;0;0;26;0;0;0
145100013;100;25;25;5;21;78;1;21;0;1;20;0;0;0
145100014;100;43;43;6;19;80;1;19;0;0;19;0;0;0
145100015;100;21;23;7;19;80;1;19;0;0;19;0;0;0
145100016;200;93;93;5;49;150;1;49;0;0;49;0;0;0
145100017;200;114;114;3;55;144;1;55;4;2;49;0;0;0
145100018;100;57;57;7;39;60;1;39;1;1;37;0;0;0
145100019;100;36;37;7;23;76;1;23;2;2;19;0;0;0
145100020;100;28;28;8;29;70;1;29;1;0;28;0;0;0
145100021;100;58;58;5;13;86;1;13;0;0;13;0;0;0
145100022;100;15;15;3;16;84;0;16;0;0;16;0;0;0
150300001;800;813;815;0;306;603;1;196;6;10;180;110;9;101
150300002;600;623;626;0;190;485;4;111;3;2;106;79;4;75
150300003;800;828;828;0;247;651;1;148;5;6;137;99;3;96
150300004;500;498;498;1;168;395;2;103;1;4;98;65;3;62
150300005;500;468;468;0;169;377;1;122;1;5;116;47;5;42
150300006;600;608;608;0;161;503;2;95;4;3;88;66;4;62
150300007;700;752;753;0;172;590;1;109;2;3;104;63;6;57
150300008;900;873;873;0;281;718;1;181;4;9;168;100;4;96
150300009;300;337;337;6;108;228;1;71;3;1;67;37;4;33
150300010;200;175;175;5;76;122;2;76;4;3;69;0;0;0
150300011;200;242;242;3;110;89;1;110;2;5;103;0;0;0
150300012;100;107;107;6;61;38;1;61;2;0;59;0;0;0
150300013;200;221;221;5;70;129;1;70;1;2;67;0;0;0
150300014;100;20;20;0;19;80;1;19;1;2;16;0;0;0
150300015;300;286;286;0;93;206;1;93;1;3;89;0;0;0
150300016;700;683;685;0;211;589;1;110;5;4;101;101;9;92
150800001;300;621;621;1;227;124;1;175;6;3;166;52;3;49
150800002;300;463;463;0;132;192;0;108;3;2;103;24;2;22
150800003;400;781;781;0;241;212;1;187;1;10;176;54;1;53
150800004;400;750;750;0;234;214;1;185;21;1;163;49;2;47
150800005;200;243;243;3;125;73;2;125;1;4;120;0;0;0
150800006;200;218;218;3;76;123;1;76;2;0;74;0;0;0
150800007;200;272;272;2;100;99;1;100;5;1;94;0;0;0
150800008;400;728;729;0;206;245;1;154;3;3;148;52;3;49
150800009;300;602;604;0;151;189;1;110;1;1;108;41;0;41
150800010;300;363;364;3;119;195;1;104;4;1;99;15;0;15
150800011;300;478;478;0;142;181;1;118;2;1;115;24;1;23
150800012;300;490;492;2;172;165;1;134;3;1;130;38;0;38
150800013;300;559;560;7;167;165;5;130;5;0;125;37;1;36
150800014;300;443;443;1;164;150;1;149;9;2;138;15;0;15
150800015;300;143;481;3;146;176;1;123;6;0;117;23;0;23
150800016;300;566;569;2;209;108;1;191;8;2;181;18;0;18
150800017;300;391;392;2;127;189;2;109;1;1;107;18;0;18
150800018;100;149;149;3;52;46;2;52;1;1;50;0;0;0
150800019;200;210;212;2;81;118;1;81;2;4;75;0;0;0
150800020;300;318;331;3;102;228;1;71;1;0;70;31;0;31
150800021;100;18;18;0;18;81;1;18;0;0;18;0;0;0
151000001;300;297;297;1;131;168;1;131;2;3;126;0;0;0
151000002;200;440;440;2;118;112;1;87;8;2;77;31;2;29
151000003;500;810;820;4;248;307;1;192;11;1;180;56;0;56
151000004;200;368;371;1;143;69;1;130;6;3;121;13;0;13
151000005;300;519;519;2;156;202;1;97;4;3;90;59;3;56
151000006;200;424;424;5;130;108;1;91;0;2;89;39;0;39
151000007;200;459;461;1;124;117;1;82;2;3;77;42;2;40
151000008;200;158;158;2;82;117;1;82;1;2;79;0;0;0
151000009;300;611;612;7;185;196;1;103;5;1;97;82;1;81
151000010;300;645;647;3;204;166;1;133;8;2;123;71;4;67
151000011;300;640;642;6;220;176;1;123;4;1;118;97;7;90
151000012;500;806;810;2;233;327;3;170;4;3;163;63;0;63
151000013;200;456;459;4;140;95;1;104;2;3;99;36;3;33
151000014;200;317;317;2;94;126;1;73;5;0;68;21;0;21
151000015;200;320;320;4;79;128;1;71;0;1;70;8;0;8
151000016;200;385;386;4;102;105;1;94;6;1;87;8;0;8
151000017;200;345;348;5;129;118;1;81;2;4;75;48;2;46
151000018;200;420;420;3;109;109;1;90;5;0;85;19;1;18
151000019;200;237;239;1;76;123;1;76;1;4;71;0;0;0
151000020;200;414;414;3;153;145;1;54;2;0;52;99;3;96
151000021;400;636;638;3;246;154;1;245;3;11;231;1;0;1
151000022;400;537;538;4;273;189;2;209;5;5;199;64;0;64
151000023;200;346;348;1;131;100;1;99;6;1;92;32;1;31
151000024;200;328;329;0;94;125;1;74;2;2;70;20;1;19
151000025;200;465;466;1;130;91;1;108;7;0;101;22;0;22
151000026;200;456;460;2;130;91;2;107;10;1;96;23;1;22
151000027;500;570;571;2;198;339;1;160;6;4;150;38;0;38
151000028;300;372;373;1;138;199;2;99;2;0;97;39;0;39
151000029;200;444;444;4;156;103;1;96;0;2;94;60;3;57
151000030;200;414;416;6;117;87;1;112;4;1;107;5;0;5
151000031;500;617;619;1;151;396;1;103;4;1;98;48;2;46
151000032;500;634;636;4;154;376;1;123;9;3;111;31;2;29
151000033;300;464;464;2;102;241;1;58;4;0;54;44;1;43
151000034;100;23;23;0;22;77;1;22;0;0;22;0;0;0
151100001;200;725;725;6;159;100;3;97;8;2;87;62;3;59
151100002;200;531;531;3;163;108;1;91;4;2;85;72;6;66
151100003;200;460;460;3;141;148;1;51;1;0;50;90;1;89
151100004;200;549;550;3;181;99;2;99;1;2;96;82;4;78
151100005;200;476;476;5;161;110;1;89;2;2;85;72;5;67
151100006;200;429;429;6;144;121;1;78;11;1;66;66;3;63
151100007;200;423;424;4;130;123;1;76;4;1;71;54;1;53
151100008;200;890;890;4;129;95;1;104;9;2;93;25;0;25
151100009;200;489;489;3;80;139;1;60;5;2;53;20;2;18
151100010;200;617;618;5;100;122;1;77;5;1;71;23;0;23
151100011;200;603;606;5;114;115;1;84;5;1;78;30;0;30
151100012;200;797;798;5;106;104;1;95;6;3;86;11;1;10
151100013;200;485;487;5;140;98;1;101;3;7;91;39;1;38
151100014;300;622;622;7;217;106;1;193;5;8;180;24;0;24
151100015;200;443;445;1;161;81;2;117;6;1;110;44;1;43
151100016;200;756;757;0;142;85;1;114;3;0;111;28;1;27
151100017;200;310;310;3;120;79;1;120;1;1;118;0;0;0
151100018;200;379;379;4;127;83;1;116;0;1;115;11;0;11
151100019;200;590;591;4;153;93;1;106;8;1;97;47;1;46
151100020;200;471;471;5;112;111;1;88;6;0;82;24;0;24
151100021;200;550;549;3;102;126;1;73;6;0;67;29;2;27
151600001;300;539;541;4;200;204;1;95;3;1;91;105;5;100
151600002;500;701;701;2;249;372;1;127;1;1;125;122;1;121
151600003;500;715;718;0;260;359;1;140;5;1;134;120;5;115
151600004;300;555;555;4;146;220;1;79;2;4;73;67;3;64
151600005;200;454;455;3;147;106;1;93;1;1;91;54;1;53
151600006;500;762;762;1;221;388;1;111;3;3;105;110;9;101
151600007;500;742;747;1;245;302;2;196;6;4;186;49;1;48
151600008;500;878;885;5;290;254;1;245;12;2;231;45;1;44
151600009;800;1071;1084;6;312;523;3;274;26;4;244;38;0;38
151600010;500;850;855;1;245;282;1;217;12;5;200;28;3;25
151600011;300;515;515;6;187;192;1;107;8;1;98;80;1;79
151600012;400;590;594;0;180;303;1;96;4;0;92;84;2;82
151600013;300;444;447;0;161;217;1;82;2;1;79;79;2;77
151600014;100;12;12;2;10;89;1;10;0;0;10;0;0;0
151600015;400;648;653;6;192;228;2;170;11;5;154;22;0;22
151600016;400;636;636;0;157;256;1;143;5;4;134;14;0;14
151600017;200;450;450;1;95;118;1;81;8;0;73;14;0;14
151600018;100;70;70;7;41;58;1;41;3;0;38;0;0;0
151600019;400;615;624;0;187;265;1;134;3;1;130;53;3;50
151600020;100;15;15;3;9;90;1;9;0;1;8;0;0;0
151600021;300;460;462;1;150;192;1;107;9;1;97;43;0;43
151600022;200;324;324;0;110;103;1;96;4;2;90;14;0;14
151600023;200;333;342;2;138;77;1;122;2;3;117;16;0;16
151600024;300;585;589;0;237;69;1;230;5;13;212;7;0;7
151600025;300;473;476;2;162;169;1;130;4;3;123;32;0;32
151600026;300;564;564;1;181;175;1;124;5;3;116;57;3;54
151600027;200;384;384;7;125;119;1;80;2;4;74;45;7;38
151600028;300;497;502;7;131;204;1;95;2;5;88;36;6;30
151600029;400;661;667;7;159;264;2;134;7;1;126;25;0;25
151600030;200;305;307;2;97;102;4;94;3;1;90;3;0;3
151600031;300;437;437;2;204;135;1;164;6;3;155;40;1;39
151600032;100;49;49;0;48;52;0;48;1;0;47;0;0;0
151600033;100;47;47;0;46;54;0;46;6;0;40;0;0;0
152100001;900;925;1003;4;400;509;1;390;14;8;368;10;0;10
152100002;300;597;609;5;201;125;1;174;10;7;157;27;0;27
152100003;500;1026;1075;4;306;202;2;296;14;6;276;10;1;9
152100004;300;689;702;8;232;112;1;187;2;8;177;45;1;44
152100005;300;447;455;1;219;112;1;187;11;0;176;32;1;31
152100006;400;515;517;4;210;215;1;184;8;4;172;26;2;24
152100007;200;112;116;4;67;132;1;67;0;2;65;0;0;0
152100008;200;140;140;4;75;124;1;75;2;0;73;0;0;0
152100009;300;348;353;0;160;156;1;143;2;5;136;17;0;17
152100010;100;74;74;4;39;60;1;39;0;1;38;0;0;0
152100011;400;557;559;0;228;195;1;204;5;6;193;24;1;23
152100012;100;53;53;6;36;63;1;36;2;0;34;0;0;0
152100013;300;388;388;1;172;149;1;150;4;2;144;22;0;22
152100014;200;157;157;1;57;142;1;57;2;1;54;0;0;0
152100015;500;835;844;5;344;250;1;249;10;3;236;95;3;92
152100016;200;231;232;1;119;80;1;119;5;6;108;0;0;0
152100017;300;360;363;1;203;120;3;177;7;1;169;26;2;24
152100018;200;146;146;1;145;55;0;145;1;0;144;0;0;0
152100019;100;27;27;4;31;69;0;31;0;0;31;0;0;0
152300001;900;896;899;5;166;774;1;125;8;2;115;41;0;41
152300002;650;608;614;5;154;536;1;113;6;1;106;41;3;38
152300003;700;678;681;0;194;556;1;143;7;3;133;51;3;48
152300004;700;656;659;0;213;537;1;162;4;4;154;51;6;45
152300005;500;445;451;1;177;376;1;123;4;5;114;54;2;52
152300006;500;483;485;2;185;365;1;134;12;1;121;51;1;50
152300007;500;488;489;1;179;370;1;129;9;5;115;50;1;49
152300008;650;634;642;4;223;483;1;166;14;5;147;57;0;57
152300009;400;356;361;4;110;307;1;92;2;2;88;18;1;17
152300010;450;409;416;2;178;292;2;156;7;1;148;22;1;21
152300011;50;31;31;1;32;17;1;32;1;0;31;0;0;0
152400001;500;837;838;17;316;336;1;163;4;1;158;153;9;144
152400002;500;789;790;25;283;385;1;114;1;3;110;169;6;163
152400003;500;836;838;22;343;341;1;158;0;8;150;185;3;182
152400004;300;441;441;7;164;220;1;79;1;1;77;85;0;85
152400005;400;687;688;8;200;309;1;90;1;1;88;110;5;105
152400006;500;954;954;8;319;282;1;217;14;2;201;102;3;99
152400007;500;917;918;6;380;322;2;176;2;5;169;204;4;200
152400008;500;883;885;9;337;316;1;183;7;4;172;154;4;150
152400009;500;805;806;9;310;365;1;134;4;4;126;176;7;169
152400010;500;785;787;7;285;373;1;126;2;1;123;159;6;153
152400011;500;892;895;13;355;160;1;339;1;5;333;16;1;15
152400012;500;817;821;8;249;383;1;116;2;4;110;133;4;129
152400013;500;801;801;8;254;384;1;115;7;3;105;139;4;135
152400014;500;815;815;7;245;378;1;121;3;7;111;124;5;119
152400015;500;754;755;10;247;369;1;130;3;0;127;117;5;112
152400016;500;804;806;6;233;366;1;133;5;3;125;100;8;92
152400017;400;653;655;9;196;262;1;137;3;4;130;59;1;58
152400018;500;731;735;9;230;376;1;123;2;0;121;107;8;99
152400019;500;860;861;6;254;373;1;126;2;2;122;128;2;126
152400020;500;791;795;8;252;394;1;105;5;3;97;147;6;141
152400021;500;834;834;7;213;413;1;86;1;3;82;127;9;118
152400022;500;829;830;7;288;375;1;124;2;2;120;164;12;152
152400023;500;848;850;6;266;352;1;147;6;4;137;119;3;116
152400024;500;910;912;8;267;390;1;109;4;3;102;158;8;150
152400025;500;746;748;6;257;389;1;110;2;0;108;147;0;147
152400026;500;768;768;9;233;377;1;122;1;3;118;111;4;107
152400027;400;678;680;7;153;331;1;68;2;1;65;85;2;83
152400028;500;947;947;8;299;360;1;139;4;3;132;160;3;157
152400029;500;892;894;4;306;336;1;163;3;5;155;143;3;140
152400030;500;817;819;11;230;368;1;131;2;0;129;99;3;96
152400031;500;754;755;8;239;385;1;114;5;3;106;125;7;118
152400032;500;786;787;8;275;383;1;116;0;2;114;159;7;152
152400033;500;786;788;8;209;399;1;100;1;1;98;109;0;109
152400034;500;850;852;7;316;338;2;160;8;5;147;156;5;151
152400035;500;831;824;9;271;361;3;136;3;8;125;135;12;123
152400036;500;877;878;8;349;376;1;123;2;2;119;226;10;216
152400037;500;856;858;6;272;248;1;251;8;8;235;21;1;20
152400038;500;750;751;9;267;399;1;100;3;4;93;167;8;159
152400039;500;761;763;10;240;402;2;96;2;1;93;144;5;139
152400040;500;815;816;6;271;384;1;115;0;1;114;156;6;150
152400041;500;729;733;7;210;409;1;90;2;7;81;120;7;113
152400042;500;735;738;6;221;408;1;91;3;4;84;130;9;121
152400043;500;731;732;8;301;364;1;135;2;2;131;166;10;156
152400044;500;795;797;6;298;372;1;127;2;1;124;171;13;158
152400045;500;735;736;7;217;401;1;98;2;2;94;119;5;114
152400046;500;779;781;5;229;390;1;109;5;3;101;120;6;114
152400047;500;840;840;7;255;383;1;116;5;1;110;139;6;133
152400048;300;531;532;7;186;156;1;143;3;3;137;43;3;40
152400049;500;827;828;9;279;353;1;146;7;5;134;133;5;128
152400050;500;681;682;9;202;383;1;116;2;3;111;86;1;85
152400051;500;825;826;6;255;374;1;125;0;2;123;130;5;125
152400052;500;703;705;7;219;387;1;112;6;4;102;107;3;104
152400053;500;744;746;7;259;378;2;120;3;1;116;139;6;133
152400054;500;707;708;4;204;411;2;87;2;3;82;117;1;116
152400055;500;774;776;7;237;404;1;95;1;0;94;142;4;138
152400056;500;694;696;7;242;394;1;105;4;0;101;137;2;135
152400057;400;630;630;9;224;284;1;115;5;0;110;109;2;107
152400058;500;694;694;5;195;406;1;93;4;3;86;102;5;97
152400059;500;721;724;8;219;393;1;106;5;6;95;113;4;109
152400060;400;675;675;9;257;279;1;120;4;1;115;137;9;128
152400061;300;544;547;14;162;222;1;77;2;0;75;85;0;85
152400062;500;864;865;7;250;353;1;146;4;6;136;104;8;96
152400063;400;608;608;8;154;320;1;79;3;1;75;75;3;72
152400064;500;952;954;11;254;374;1;125;4;4;117;129;7;122
152400065;500;1006;1007;12;402;299;1;200;8;3;189;202;6;196
152400066;500;889;889;8;332;332;1;167;2;11;154;165;8;157
152400067;500;773;773;6;279;376;1;123;1;3;119;156;6;150
152400068;500;939;942;6;370;331;3;166;2;8;156;204;7;197
152400069;500;736;737;7;268;397;1;102;0;4;98;166;6;160
152400070;500;787;789;9;343;354;1;145;4;4;137;198;11;187
152400071;500;696;698;7;243;395;1;104;2;1;101;139;5;134
152400072;300;565;566;9;250;209;1;90;1;1;88;160;8;152
152400073;500;768;770;8;276;377;1;122;1;2;119;154;7;147
152400074;500;840;840;8;299;240;1;259;8;9;242;40;1;39
152400075;500;993;993;10;374;313;2;185;4;1;180;189;4;185
152400076;500;763;766;8;280;370;1;129;9;2;118;151;6;145
152400077;300;553;555;8;230;181;1;118;1;1;116;112;5;106
152400078;500;781;782;8;246;370;1;129;1;0;128;117;2;115
152400079;400;630;633;9;207;313;1;86;3;2;81;121;3;118
152400080;300;568;570;7;196;222;1;77;5;1;71;119;2;117
152400081;300;505;508;6;215;221;1;78;4;1;73;137;7;130
152400082;300;482;483;7;195;218;1;81;1;2;78;114;4;110
152400083;400;668;670;12;169;304;1;95;14;0;81;74;5;69
152400084;400;614;617;10;245;293;1;106;6;2;98;139;4;135
152400085;500;727;730;5;243;390;1;109;0;6;103;134;5;129
152400086;500;745;746;7;281;390;1;109;3;2;104;172;10;162
152400087;300;538;540;6;197;196;1;103;4;9;90;94;8;86
152400088;400;609;611;9;222;280;1;119;2;2;115;103;3;100
152400089;400;676;682;7;256;292;1;107;2;1;104;149;8;141
152400090;300;537;538;11;217;208;1;91;0;0;91;126;3;123
152400091;500;915;915;4;324;367;1;132;0;6;126;192;14;178
152400092;500;766;766;13;331;353;1;146;4;2;140;185;10;175
152400093;500;759;761;5;254;388;1;111;2;3;106;143;4;139
152400094;500;834;836;10;324;358;1;141;5;6;130;183;7;176
152400095;500;772;773;14;281;369;1;130;2;5;123;151;3;148
152400096;500;972;973;9;383;344;1;155;2;2;151;228;9;219
152400097;500;724;725;7;295;356;1;143;2;2;139;152;9;143
152400098;500;954;954;10;361;344;1;155;0;5;150;206;8;198
152400099;500;865;866;6;397;325;1;174;6;3;165;223;11;212
152400100;400;629;633;5;257;281;1;118;2;0;116;139;9;130
152400101;500;921;921;9;372;316;2;182;5;5;172;190;12;178
152400102;500;679;679;14;300;346;1;153;5;0;148;147;11;136
152400103;500;723;724;8;307;349;2;149;4;0;145;158;6;152
152400104;500;769;769;9;293;357;1;142;1;3;138;151;4;147
152400105;400;596;596;8;242;265;4;131;3;5;123;111;3;108
152400106;400;730;730;6;262;271;1;128;2;5;121;134;6;128
152400107;400;619;620;11;257;272;1;127;4;3;120;130;7;123
152400108;400;749;750;8;354;235;1;164;3;1;160;190;2;188
152400109;300;513;513;9;218;202;1;97;2;2;93;121;5;116
152400110;400;621;623;19;263;267;1;132;2;3;127;131;5;126
152400111;400;588;590;11;249;293;1;106;8;5;93;143;7;136
152400112;400;671;671;11;281;294;1;105;2;1;102;176;7;169
152400113;500;787;789;9;321;360;1;139;7;3;129;182;6;176
152400114;500;819;824;7;322;369;1;130;4;1;125;192;6;186
152400115;500;847;848;8;363;336;1;163;8;2;153;200;7;193
152400116;500;837;837;10;343;361;1;138;5;5;128;205;10;195
152400117;400;643;643;10;264;287;2;111;3;3;105;153;3;150
152400118;400;665;666;10;258;220;4;176;3;5;168;82;2;80
152400119;400;636;636;9;249;293;1;106;0;2;104;143;10;133
152400120;400;629;633;6;252;277;2;121;4;8;109;131;5;126
152400121;300;549;550;8;223;183;1;116;3;4;109;107;7;100
152400122;400;634;635;6;206;328;1;71;2;1;68;135;5;130
152400123;500;756;756;7;273;361;1;138;2;3;133;135;5;130
152400124;500;844;845;6;346;359;1;140;3;4;133;206;6;200
152400125;500;730;730;8;260;376;1;123;2;3;118;137;6;131
152400126;500;863;864;8;355;357;1;142;4;5;133;213;8;205
152400127;500;945;946;5;376;352;1;147;0;3;144;229;8;221
152400129;100;44;44;7;49;50;1;49;0;1;48;0;0;0
152400130;100;39;39;4;43;55;2;43;4;1;38;0;0;0
152400131;100;58;58;8;61;38;1;61;3;4;54;0;0;0
152400132;100;30;30;10;26;73;1;26;5;0;21;0;0;0
152400133;200;94;94;42;102;97;1;102;2;5;95;0;0;0
152400200;500;493;495;3;192;353;1;146;5;1;140;46;1;45
152400201;400;466;467;3;217;231;1;168;9;1;158;49;1;48
152400202;500;691;692;6;304;297;1;202;9;5;188;102;5;97
152400203;500;550;551;5;250;249;1;250;22;2;226;0;0;0
152400204;500;789;789;9;312;244;1;255;7;2;246;57;4;53
152400205;1000;1153;1153;5;670;332;1;667;4;0;663;3;0;3
152400206;1000;1105;1106;5;565;472;1;527;2;0;525;38;0;38
152400207;400;420;423;3;166;283;1;116;2;2;112;50;3;47
152400208;100;126;126;5;92;7;1;92;0;1;91;0;0;0
152400209;500;528;529;3;196;370;2;128;6;3;119;68;1;67
152400210;500;733;734;5;304;302;1;197;3;2;192;107;6;101
152400211;500;643;643;9;179;346;2;152;16;2;134;27;1;26
152400212;500;668;675;12;318;265;2;233;9;9;215;85;3;82
152400213;100;112;114;6;74;24;2;74;0;0;74;0;0;0
152400214;200;221;221;9;108;90;2;108;0;5;103;0;0;0
152400215;100;63;63;5;50;49;1;50;0;0;50;0;0;0
152400216;500;523;524;5;379;166;1;333;13;1;319;46;2;44
152400217;400;463;463;6;165;258;1;141;8;0;133;24;0;24
152400218;500;729;729;9;245;386;1;113;2;4;107;132;6;126
152400219;500;647;648;7;260;333;1;166;1;3;162;94;3;91
152400220;300;405;409;5;214;115;3;182;3;5;174;32;0;32
152400221;300;365;365;6;103;242;1;57;2;1;54;46;1;45
152400222;200;211;212;5;112;87;1;112;2;1;109;0;0;0
152400223;500;532;536;4;164;365;1;134;12;1;121;30;0;30
152400224;500;893;902;4;324;180;1;319;10;1;308;5;0;5
152400225;400;455;456;0;148;302;2;96;3;2;91;52;0;52
152400226;500;839;845;1;256;289;1;210;4;3;203;46;0;46
152400227;500;731;739;3;228;345;1;154;6;4;144;74;1;73
152400228;300;289;289;2;215;84;1;215;6;2;207;0;0;0
152400229;200;222;222;5;110;89;1;110;4;2;104;0;0;0
152400230;500;801;801;4;338;183;1;316;31;5;280;22;1;21
152400231;500;760;763;2;242;371;1;128;3;2;123;114;6;108
152400232;500;786;787;3;259;336;1;163;4;2;157;96;1;95
152400233;500;533;533;7;143;414;1;85;5;0;80;58;2;56
152700001;500;593;594;3;169;344;1;155;9;4;142;14;1;13
152700002;500;544;544;6;164;342;2;156;4;11;141;8;0;8
152700003;400;451;451;2;157;307;1;92;2;0;90;65;1;64
152700004;100;116;117;6;57;42;1;57;2;0;55;0;0;0
152700005;500;620;621;6;226;315;1;184;4;1;179;42;0;42
152700006;300;424;424;5;147;195;1;104;11;4;89;43;0;43
152700007;500;614;614;4;170;364;1;135;9;0;126;35;1;34
152700008;100;57;57;6;40;59;1;40;0;0;40;0;0;0
152700009;600;763;764;4;272;341;1;258;13;2;243;14;0;14
152700010;300;344;345;6;121;208;1;91;3;0;88;30;1;29
153700001;300;290;291;3;154;145;1;154;5;3;146;0;0;0
153700002;500;450;452;1;244;258;1;241;13;2;226;3;0;3
153700003;600;626;626;0;364;245;1;354;12;1;341;10;0;10
153700004;500;408;411;3;188;337;1;162;10;1;151;26;1;25
153700005;600;644;651;4;257;360;1;239;13;1;225;18;0;18
153700006;500;543;545;5;155;368;1;131;6;2;123;24;0;24
153700007;600;671;673;0;223;422;1;177;10;1;166;46;2;44
153700008;600;586;589;2;231;413;1;186;7;4;175;45;1;44
153700009;700;721;724;0;243;514;2;184;9;5;170;59;1;58
153700010;1000;930;933;0;268;769;1;230;12;8;210;38;2;36
153700011;700;752;752;2;256;477;1;222;9;1;212;34;0;34
153700012;300;306;307;1;135;170;1;129;3;3;123;6;0;6
153700013;600;610;610;2;174;460;2;138;3;1;134;36;0;36
153700014;500;541;542;3;149;373;1;126;2;3;121;23;2;21
153700015;600;641;642;3;376;261;1;338;15;3;320;38;0;38
153700016;700;711;717;2;287;460;1;239;6;5;228;48;4;44
153700017;1000;923;926;1;306;755;1;244;11;2;231;62;3;59
153700018;500;519;519;0;236;265;1;234;1;1;232;2;0;2
153700019;300;305;307;1;120;179;1;120;7;0;113;0;0;0
153700020;400;320;320;2;150;248;2;150;5;2;143;0;0;0
153700021;500;579;581;0;213;367;1;132;2;1;129;81;6;75
153700022;600;619;621;0;184;493;1;106;3;2;101;78;3;75
153700023;700;704;704;1;237;572;1;127;3;5;119;110;3;107
153700024;500;582;584;1;238;368;1;131;0;4;127;107;8;99
153700025;600;606;606;4;215;497;1;102;2;1;99;113;3;110
153700026;700;695;697;0;222;581;1;118;4;2;112;104;4;100
153700027;500;565;568;5;185;383;1;116;5;2;109;69;4;65
153700028;700;745;746;2;235;588;1;111;3;5;103;124;5;119
153700029;600;650;650;4;189;509;1;90;2;2;86;99;5;94
153700030;600;647;648;0;226;480;1;119;2;1;116;107;6;101
153700031;700;712;713;0;224;560;1;139;0;1;138;85;4;81
153700032;600;643;645;0;275;460;1;139;3;2;134;136;3;133
153700033;800;814;815;5;214;689;1;110;3;3;104;104;3;101
153700034;800;820;822;1;200;655;1;144;3;1;140;56;2;54
153700035;800;861;863;0;220;676;1;123;5;1;117;97;3;94
153700036;700;726;727;4;179;534;1;165;7;1;157;14;1;13
153700037;600;614;614;4;161;454;1;145;10;1;134;16;0;16
153700038;400;411;411;2;204;236;1;163;3;0;160;41;1;40
153700039;400;426;427;4;184;250;1;149;5;4;140;35;2;33
153700040;100;20;20;0;19;81;0;19;1;0;18;0;0;0
153700041;100;22;22;0;22;78;0;22;1;0;21;0;0;0
153900001;800;759;768;8;301;605;1;194;0;11;183;107;3;104
153900002;600;616;623;6;215;406;1;193;10;3;180;22;3;19
153900003;700;732;732;6;243;459;1;240;1;16;223;3;0;3
153900004;500;654;656;7;272;326;1;173;3;5;165;99;5;94
153900005;600;685;693;7;283;408;1;191;4;11;176;92;2;90
153900006;600;590;597;6;224;405;2;193;20;4;169;31;2;29
153900007;800;832;832;7;320;515;1;284;38;3;243;36;1;35
153900008;600;678;689;7;238;367;1;232;7;9;216;6;0;6
153900009;500;543;550;6;204;353;1;146;5;4;137;58;3;55
153900010;600;589;599;6;261;412;1;187;7;4;176;74;3;71
153900011;500;500;506;9;229;343;1;156;2;7;147;73;4;69
153900012;800;734;748;5;377;446;3;351;12;8;331;26;1;25
153900013;600;675;681;7;368;242;2;356;13;0;343;12;0;12
153900014;700;667;690;3;309;455;1;244;9;3;232;65;4;61
153900015;600;607;633;3;278;356;1;243;9;6;228;35;0;35
153900016;700;757;794;5;433;300;1;399;18;9;372;34;2;32
153900017;300;246;260;2;153;146;1;153;4;5;144;0;0;0
153900018;100;71;71;2;70;29;1;70;4;0;66;0;0;0
153900019;100;47;47;0;46;54;0;46;5;0;41;0;0;0
153900020;100;35;35;2;37;61;2;37;1;0;36;0;0;0
153900021;100;14;14;5;18;81;1;18;3;0;15;0;0;0
153900022;100;36;36;38;44;55;1;44;3;0;41;0;0;0
162201001;400;434;434;14;203;326;1;73;2;0;71;130;4;126
162201002;500;486;486;10;213;423;2;75;1;2;72;138;3;135
162201003;500;490;489;8;207;408;2;90;2;1;87;117;6;111
162201004;700;654;654;7;256;580;1;119;4;4;111;137;4;133
162201005;400;334;334;11;152;325;4;71;0;1;70;81;3;78
162201006;400;400;400;7;173;336;2;62;2;1;59;111;5;106
162201007;500;496;496;8;233;409;1;90;2;5;83;143;6;137
162201008;700;742;743;10;336;578;1;121;0;3;118;215;14;201
162201009;800;749;750;6;313;673;1;126;3;3;120;187;4;183
162201010;500;499;501;6;190;442;1;57;2;0;55;133;9;124
162201011;300;331;331;36;153;240;1;59;3;4;52;94;5;89
162201012;600;626;626;9;234;497;1;102;2;0;100;132;12;120
162201013;800;748;748;11;296;658;1;141;0;3;138;155;7;148
162201014;700;699;700;7;295;580;1;119;4;6;109;176;8;168
162201015;500;464;464;5;154;434;2;64;0;1;63;90;1;89
162201016;700;677;677;7;277;593;5;102;6;1;95;175;8;167
162201017;500;500;500;8;197;427;1;72;3;0;69;125;5;120
162201018;400;426;427;2;191;331;2;67;3;0;64;124;4;120
162201019;600;605;605;5;272;509;1;90;2;1;87;182;7;175
162201020;500;509;509;8;240;415;1;84;0;0;84;156;5;151
162201021;700;674;674;7;323;563;2;135;4;7;124;188;10;178
162201022;700;652;652;9;305;593;1;106;3;3;100;199;6;193
162201023;600;620;623;11;293;476;2;122;1;4;117;171;13;158
162201024;700;715;715;9;287;577;1;122;4;4;114;165;3;162
162201025;400;422;422;6;168;336;3;61;0;2;59;107;2;105
162201026;800;770;770;8;322;649;1;150;2;3;145;172;13;159
162201027;900;974;973;10;430;755;1;144;3;1;140;286;24;262
162201028;1000;1078;1079;8;470;810;3;187;4;8;175;283;14;269
162201029;600;626;626;11;299;474;3;123;2;6;115;176;7;169
162201030;900;913;914;9;410;623;3;274;3;9;262;136;5;131
162201031;500;509;510;11;232;394;1;105;2;3;100;127;4;123
162201032;500;514;516;6;223;424;4;72;0;3;69;151;6;145
162201033;700;659;659;7;270;591;1;108;5;5;98;162;11;151
162201034;800;785;786;8;296;685;1;114;3;2;109;182;9;173
162201035;600;552;552;7;189;530;1;69;2;1;66;120;6;114
162201036;900;837;837;8;350;757;1;142;1;1;140;208;12;196
162201037;900;870;870;7;346;772;7;121;3;3;115;225;8;217
162201038;700;661;661;6;276;600;3;97;4;0;93;179;6;173
162201039;500;478;478;6;215;400;1;99;7;3;89;116;12;104
162201040;700;752;752;9;295;607;1;92;0;2;90;203;12;191
162201041;500;457;457;8;174;430;1;69;2;0;67;105;6;99
162201042;600;640;642;9;250;491;3;106;4;2;100;144;9;135
162201043;900;917;914;5;397;748;1;151;1;5;145;246;10;236
162201044;900;990;990;4;426;714;1;185;7;8;170;241;8;233
162201045;400;438;438;17;212;298;1;101;2;8;91;111;4;107
162201046;700;654;654;8;261;581;1;118;3;2;113;143;4;139
162201047;600;613;614;7;265;476;1;123;5;4;114;142;7;135
162201048;800;792;792;9;332;657;2;141;6;8;127;191;6;185
162201049;500;498;498;7;191;420;2;78;3;2;73;113;4;109
162201050;600;599;599;9;223;519;1;80;3;1;76;143;7;136
162201051;500;534;535;9;198;431;1;68;1;0;67;130;4;126
162201052;500;443;444;4;178;433;1;66;0;2;64;112;6;106
162201053;800;836;838;14;362;681;1;118;0;4;114;244;17;227
162201054;900;843;845;8;352;743;1;156;9;7;140;196;9;187
162201055;900;969;971;7;408;751;1;148;3;10;135;260;15;245
162201056;700;737;737;9;316;591;1;108;2;0;106;208;8;200
162201057;800;770;771;5;284;685;1;114;2;4;108;170;7;163
162201058;900;854;856;9;362;746;1;153;4;3;146;209;14;195
162201059;700;709;709;15;308;581;1;118;6;1;111;190;11;179
162201060;900;946;944;13;431;713;1;186;5;4;177;245;14;231
162201061;900;864;864;8;362;755;1;144;5;7;132;218;13;205
162201062;700;712;709;9;325;562;1;137;6;6;125;188;10;178
162201063;700;688;689;10;317;561;1;138;0;8;130;179;6;173
162201064;700;738;738;6;284;598;2;100;2;6;92;184;8;176
162201065;700;709;710;7;287;583;2;115;2;4;109;172;13;159
162201066;600;646;646;11;300;493;3;104;3;1;100;196;10;186
162201067;500;477;478;9;198;425;1;74;0;4;70;124;3;121
162201068;400;397;399;9;183;318;1;81;1;2;78;102;7;95
162201069;700;670;670;5;279;566;1;133;6;3;124;146;10;136
162201070;800;759;759;9;355;573;3;224;8;11;205;131;5;126
162201071;500;440;440;7;217;424;1;75;3;2;70;142;5;137
162201072;800;806;806;5;353;646;2;152;3;4;145;201;6;195
162201073;800;834;835;6;354;677;2;121;1;2;118;233;10;223
162201074;900;833;834;11;398;730;2;168;9;6;153;230;25;205
162201075;600;600;601;14;281;515;1;84;0;3;81;197;13;184
162201076;600;609;609;18;284;486;1;113;3;7;103;171;7;164
162201077;700;639;639;7;282;564;1;135;4;5;126;147;8;139
162201078;600;580;580;6;241;517;1;82;2;5;75;159;7;152
162201079;800;742;739;8;343;659;1;140;3;2;135;203;13;190
162201080;900;907;907;9;337;612;1;287;8;3;276;50;3;47
162201081;500;527;527;13;183;387;4;109;8;1;100;74;7;67
162201082;700;692;692;5;307;548;1;151;6;1;144;156;5;151
162201083;900;884;885;5;316;725;1;174;9;4;161;142;5;137
162201084;500;500;500;5;156;372;1;127;11;0;116;29;2;27
162201085;400;423;423;5;164;338;1;61;1;0;60;103;7;96
162201086;700;730;730;7;289;557;2;141;3;3;135;148;6;142
162201087;600;584;584;9;240;489;1;110;4;4;102;130;3;127
162201088;600;744;744;9;298;444;1;155;0;0;155;143;5;138
162201089;700;696;696;4;261;547;1;152;10;4;138;109;3;106
162201090;600;667;667;11;211;498;1;101;4;3;94;110;7;103
162201091;700;673;674;9;237;589;1;110;6;4;100;127;7;120
162201092;800;770;770;12;336;669;1;130;5;2;123;206;6;200
162201093;600;567;567;9;238;502;3;95;1;3;91;143;4;139
162201094;400;441;441;9;192;281;6;113;4;6;103;79;3;76
162201095;900;873;874;7;336;726;1;173;7;10;156;163;10;153
162201096;600;561;563;8;251;499;1;100;3;1;96;151;11;140
162201097;400;399;399;4;174;332;1;67;0;2;65;107;3;104
162201098;500;460;460;6;183;437;1;62;1;0;61;121;0;121
162201099;700;701;701;8;286;604;1;95;1;5;89;191;14;177
162201100;500;518;519;7;222;407;1;92;5;4;83;130;8;122
162201101;100;31;31;8;39;61;0;39;1;0;38;0;0;0
162201102;200;11;11;33;40;159;1;40;1;1;38;0;0;0
162201103;100;18;18;22;32;67;1;32;2;3;27;0;0;0
162202001;500;495;495;9;104;440;1;59;5;1;53;45;2;43
162202002;800;769;769;6;179;651;1;148;15;0;133;31;1;30
162202003;600;584;584;4;146;494;1;105;9;2;94;41;2;39
162202004;600;643;643;6;156;504;1;95;5;2;88;61;2;59
162202005;600;550;551;8;153;497;2;101;10;0;91;52;1;51
162202006;500;523;523;8;147;424;1;75;5;4;66;72;4;68
162202007;500;492;492;5;130;414;1;85;2;1;82;45;4;41
162202008;600;572;572;6;144;508;1;91;8;1;82;53;2;51
162202009;500;529;531;9;150;407;1;92;4;2;86;58;3;55
162202010;500;486;486;4;114;436;1;63;2;0;61;51;2;49
162202011;700;670;670;6;200;610;1;89;1;2;86;111;5;106
162202012;500;452;452;6;147;438;1;61;1;2;58;86;5;81
162202013;600;554;554;7;193;498;3;99;5;1;93;94;2;92
162202014;500;511;511;4;156;424;1;75;3;0;72;81;6;75
162202015;600;648;648;9;209;491;1;108;2;2;104;101;4;97
162202016;400;413;413;0;93;345;1;54;1;1;52;39;1;38
162202017;500;543;543;5;167;407;1;92;2;2;88;75;7;68
162202018;500;487;487;6;172;402;1;97;4;1;92;75;4;71
162202019;500;554;554;8;137;426;1;73;5;1;67;64;8;56
162202020;500;545;545;7;185;415;1;84;8;2;74;101;8;93
162202021;600;606;606;7;137;468;2;130;33;0;97;7;0;7
162202022;600;596;597;9;133;517;1;82;6;3;73;51;5;46
162202023;600;610;610;4;157;466;1;133;18;1;114;24;0;24
162202024;800;840;840;6;220;579;1;220;30;3;187;0;0;0
162202025;600;610;611;6;135;471;2;127;24;1;102;8;1;7
162202026;700;709;709;5;231;476;1;223;46;0;177;8;0;8
162202027;700;722;723;7;240;469;1;230;73;3;154;10;1;9
162202028;500;481;482;4;154;414;1;85;9;4;72;69;4;65
162202029;500;474;474;5;116;433;1;66;2;3;61;50;4;46
162202030;500;491;491;6;129;383;1;116;13;1;102;13;0;13
162202031;600;664;665;19;150;449;1;150;27;1;122;0;0;0
162202032;600;616;616;7;189;414;1;185;22;0;163;4;0;4
162202033;700;714;714;11;201;498;1;201;23;1;177;0;0;0
162202034;700;748;748;5;194;503;3;194;26;0;168;0;0;0
162202035;600;558;558;4;113;487;1;112;24;0;88;1;0;1
162202036;600;590;592;6;122;479;1;120;14;0;106;2;0;2
162202037;600;624;625;7;200;399;1;200;32;2;166;0;0;0
162202038;700;714;714;9;220;479;1;220;22;1;197;0;0;0
162202039;900;892;892;4;254;677;1;222;109;2;111;32;0;32
162202040;800;772;772;14;160;639;1;160;25;2;133;0;0;0
162202041;900;895;895;7;177;722;1;177;24;0;153;0;0;0
162202042;800;778;779;9;130;674;1;125;15;0;110;5;1;4
162202043;700;706;709;6;122;573;5;122;16;0;106;0;0;0
162202044;700;755;755;13;139;583;2;115;13;1;101;24;0;24
162202045;600;624;624;6;82;539;1;60;12;0;48;22;0;22
162202046;700;734;728;8;158;567;2;131;18;0;113;27;2;25
162202047;600;602;602;6;67;534;1;65;8;1;56;2;0;2
162202048;700;676;678;8;240;459;1;240;61;3;176;0;0;0
162202049;800;774;774;5;148;651;1;148;32;0;116;0;0;0
162202050;900;877;881;7;228;671;1;228;35;0;193;0;0;0
162202051;800;845;845;9;159;645;1;154;31;2;121;5;2;3
162202052;800;862;862;7;196;604;1;195;37;2;156;1;0;1
162202053;900;890;892;6;119;780;1;119;16;2;101;0;0;0
162202054;800;793;793;9;286;631;1;168;33;2;133;118;10;108
162202055;600;609;609;7;244;475;1;124;4;3;117;120;7;113
162202056;700;678;680;5;247;605;1;94;3;4;87;153;8;145
162202057;700;748;748;7;334;429;2;269;3;12;254;65;11;54
162202058;600;576;577;5;211;540;1;59;0;3;56;152;5;147
162202059;500;491;492;9;196;433;1;66;2;0;64;130;5;125
162202060;800;806;807;10;356;679;1;120;4;3;113;236;13;223
162202061;600;585;586;7;240;507;1;92;2;1;89;148;14;134
162202062;600;622;622;7;285;494;2;104;2;4;98;181;10;171
162202063;600;633;633;7;260;493;1;106;6;8;92;154;6;148
162202064;500;455;456;11;195;418;1;81;4;8;69;114;12;102
162202065;700;669;669;10;270;594;1;105;5;1;99;165;8;157
162202066;700;679;679;12;270;586;1;113;1;4;108;157;9;148
162202067;700;708;708;6;301;589;1;110;1;3;106;191;11;180
162202068;800;759;759;7;342;677;1;122;5;4;113;220;14;206
162202069;600;634;634;9;284;318;1;281;3;13;265;3;0;3
162202070;700;656;658;4;248;607;1;92;0;5;87;156;5;151
162203001;600;620;620;8;232;492;1;107;4;1;102;125;3;122
162203002;600;694;694;7;294;483;1;116;3;3;110;178;10;168
162203003;600;590;590;7;253;475;1;124;1;9;114;129;4;125
162203004;600;629;630;8;268;485;2;113;3;2;108;155;6;149
162203005;600;689;690;8;254;490;1;109;0;4;105;145;6;139
162203006;600;599;599;8;261;476;1;123;0;5;118;138;6;132
162203007;600;581;582;7;219;494;2;104;4;2;98;115;3;112
162203008;600;602;603;6;238;449;1;150;4;3;143;88;4;84
162203009;600;687;687;23;261;489;1;110;2;1;107;151;7;144
162203010;800;858;859;9;331;646;1;153;7;2;144;178;18;160
162203011;700;700;700;6;238;596;3;101;4;8;89;137;10;127
162203012;700;796;797;9;300;584;1;115;0;4;111;185;8;177
162203013;900;959;959;7;418;727;2;171;0;8;163;247;16;231
162203014;300;162;162;71;125;174;1;125;5;12;108;0;0;0
162203015;500;200;576;8;208;400;2;98;2;1;95;110;4;106
162203016;600;693;694;6;271;499;1;100;1;1;98;171;8;163
162203017;500;583;583;7;228;410;1;89;1;2;86;139;7;132
162203018;800;879;880;6;352;661;1;138;1;3;134;214;5;209
162203019;800;873;875;9;358;622;1;177;8;8;161;181;5;176
162203020;700;776;776;6;304;554;1;145;10;6;129;159;3;156
162203021;600;674;674;7;207;488;1;111;3;3;105;96;5;91
162203022;600;682;682;7;271;491;1;108;3;0;105;163;4;159
162203023;600;670;670;8;261;488;1;111;7;0;104;150;8;142
162203024;600;607;608;7;216;501;1;98;3;3;92;118;4;114
162203025;1000;902;902;6;340;853;2;145;1;3;141;195;11;184
162203026;600;664;664;2;257;465;16;119;1;4;114;138;11;127
162203027;600;661;661;5;247;479;1;120;4;9;107;127;6;121
162203028;700;762;762;8;296;534;1;165;2;2;161;131;7;124
162203029;700;712;712;6;218;608;1;91;5;5;81;127;6;121
162203030;1000;1047;1047;4;377;831;1;168;7;6;155;209;11;198
162203031;700;738;738;9;304;576;3;121;1;2;118;183;8;175
162203032;500;559;559;7;233;400;2;98;1;2;95;135;9;126
162203033;600;648;648;13;293;447;1;152;0;6;146;141;6;135
162203034;900;893;894;7;392;755;2;143;2;8;133;249;17;232
162203035;500;548;548;7;201;404;1;95;3;2;90;106;10;96
162203036;600;657;658;7;275;475;1;124;0;5;119;151;6;145
162203037;700;697;697;6;335;600;1;99;5;1;93;236;15;221
162203038;700;734;734;8;326;577;3;120;4;4;112;206;11;195
162203039;800;807;808;5;350;662;1;137;1;2;134;213;12;201
162203040;600;650;650;7;253;422;1;177;3;12;162;76;5;71
162203041;800;791;792;9;299;660;1;139;4;7;128;160;6;154
162203042;800;876;876;7;352;610;2;188;4;8;176;164;3;161
162203043;800;852;852;3;306;632;2;166;4;8;154;140;17;123
162203044;900;933;933;7;328;646;7;247;6;23;218;81;4;77
162203045;900;910;910;5;359;706;1;193;3;6;184;166;12;154
162203046;600;666;666;5;220;499;1;100;1;2;97;120;9;111
162203047;500;347;347;8;152;426;1;73;0;3;70;79;2;77
162203048;300;16;16;96;96;203;1;96;8;8;80;0;0;0
162203049;300;35;35;65;71;228;1;71;1;8;62;0;0;0
162203050;300;36;36;15;15;284;1;15;0;0;15;0;0;0
162203051;300;27;27;52;60;239;1;60;2;7;51;0;0;0
162203052;300;25;25;51;70;229;1;70;0;4;66;0;0;0
162204001;500;489;490;15;177;421;1;78;0;2;76;99;5;94
162204002;600;583;583;6;257;403;2;195;0;3;192;62;4;58
162204003;500;478;478;3;187;411;1;88;0;4;84;99;4;95
162204004;500;540;540;7;215;399;1;100;1;5;94;115;5;110
162204005;600;601;601;6;203;506;1;93;1;2;90;110;6;104
162204006;500;537;537;1;121;433;1;66;2;0;64;55;1;54
162204007;600;581;582;7;206;491;1;108;0;3;105;98;1;97
162204008;500;511;511;5;153;425;1;74;2;3;69;79;4;75
162204009;600;621;621;5;216;516;2;82;6;1;75;134;7;127
162204010;500;526;528;8;169;411;1;88;2;2;84;81;3;78
162204011;700;671;671;6;223;603;1;96;1;2;93;127;6;121
162204012;700;644;647;4;261;610;1;89;0;6;83;172;8;164
162204013;500;501;501;5;194;406;1;93;2;5;86;101;5;96
162204014;600;628;629;8;142;489;1;110;12;0;98;32;0;32
162204015;700;783;786;5;188;548;1;151;18;0;133;37;5;32
162204016;700;798;798;8;163;539;1;160;13;0;147;3;0;3
162204017;600;577;578;21;230;498;1;101;3;3;95;129;4;125
162204018;500;548;548;5;204;415;1;84;1;1;82;120;5;115
162204019;700;819;819;4;319;553;2;145;3;1;141;174;4;170
162204020;700;710;710;7;301;571;1;128;0;6;122;173;8;165
162204021;700;651;656;4;262;592;1;107;3;2;102;155;7;148
162204022;600;597;597;8;204;520;2;78;4;4;70;126;10;116
162204023;800;846;847;2;392;636;4;160;3;1;156;232;11;221
162204024;600;651;652;6;277;484;1;115;4;2;109;162;5;157
162204025;700;747;748;5;282;565;1;134;0;4;130;148;6;142
162204026;700;746;746;4;313;560;1;139;0;3;136;174;7;167
162204027;500;463;463;5;170;414;2;84;4;3;77;86;2;84
162204028;500;457;461;8;176;418;1;81;3;1;77;95;4;91
162204029;600;581;581;7;242;478;1;121;1;3;117;121;14;107
162204030;600;620;620;9;238;478;6;116;2;1;113;122;9;113
162204031;500;518;519;8;186;416;2;82;1;3;78;104;4;100
162204032;600;594;595;6;214;512;1;87;1;3;83;127;5;122
162204033;800;814;815;9;274;524;2;274;13;1;260;0;0;0
162204034;500;501;501;5;209;393;4;103;3;3;97;106;8;98
162204035;800;916;916;3;362;653;1;146;6;5;135;216;3;213
162204036;400;429;429;4;135;344;1;55;2;5;48;80;6;74
162204037;800;812;812;9;349;673;2;125;2;0;122;224;12;212
162204038;700;733;734;8;288;577;2;121;3;4;114;167;12;155
162204039;700;647;648;5;280;580;3;117;4;1;112;163;7;156
162204040;700;683;683;4;284;583;1;116;4;4;108;168;13;155
162204041;600;562;563;6;267;492;2;106;2;3;101;161;6;155
162204042;500;527;528;3;218;426;1;73;5;6;62;145;12;133
162204043;500;491;491;9;214;407;1;92;4;5;83;122;9;113
162204044;700;687;687;8;273;586;1;113;0;4;109;160;18;142
162204045;600;697;697;5;252;356;1;243;13;1;229;9;1;8
162204046;700;686;687;5;254;588;1;111;4;5;102;143;6;137
162204047;600;551;551;7;177;429;1;170;4;7;159;7;0;7
162204048;600;546;548;20;194;508;1;91;3;2;86;103;4;99
162204049;600;553;553;7;183;515;1;84;3;3;78;99;6;93
162204050;600;596;596;5;194;427;1;172;4;7;161;22;5;17
162204051;600;588;588;4;163;500;1;99;0;5;94;64;7;57
162204052;600;641;641;6;247;512;2;86;4;3;79;161;15;146
162204053;600;589;590;5;228;481;1;118;2;1;115;110;10;100
162204054;400;372;372;13;157;322;1;77;0;4;73;80;3;77
162204055;400;375;375;4;125;341;1;58;1;1;56;67;1;66
162204056;400;358;358;4;137;338;1;61;2;1;58;76;4;72
162204057;500;441;441;2;173;421;1;78;2;0;76;95;3;92
162204058;800;728;728;6;240;706;1;93;5;5;83;147;9;138
162204059;400;395;395;2;142;329;1;70;0;0;70;72;4;68
162204060;700;606;606;13;229;578;1;121;4;4;113;108;13;95
162204061;600;570;571;7;239;505;1;94;0;1;93;145;6;139
162204062;700;628;628;8;245;581;3;116;3;10;103;129;8;121
162204063;700;710;710;5;313;576;1;123;4;0;119;190;9;181
162204064;600;687;687;4;262;482;2;116;3;5;108;146;2;144
162204065;600;569;571;4;185;515;1;84;6;6;72;101;9;92
162204066;500;472;472;9;157;402;1;97;0;3;94;60;1;59
162204067;600;615;616;5;248;501;1;98;1;2;95;150;15;135
162204068;600;597;598;6;255;498;2;100;2;5;93;155;6;149
162204069;500;507;507;8;92;424;1;75;7;2;66;17;1;16
162204070;400;404;404;8;182;316;3;81;3;1;77;101;5;96
162204071;600;630;630;6;287;491;1;108;1;1;106;179;15;164
162204072;600;530;530;5;215;389;1;210;9;4;197;5;1;4
162204073;700;893;893;4;393;549;2;149;2;6;141;244;20;224
162204074;100;18;18;0;16;84;0;16;0;0;16;0;0;0
162204075;200;18;18;55;61;138;1;61;2;2;57;0;0;0
162205001;600;523;524;8;193;526;1;73;0;3;70;120;3;117
162205002;700;669;670;8;244;581;1;118;7;4;107;126;8;118
162205003;600;599;601;10;238;488;1;111;5;4;102;127;10;117
162205004;600;625;625;10;250;487;1;112;1;5;106;138;9;129
162205005;700;722;723;11;350;517;1;182;3;6;173;168;5;163
162205006;600;646;647;7;247;493;1;106;1;5;100;141;6;135
162205007;700;605;606;10;264;579;1;120;4;8;108;144;6;138
162205008;700;671;672;5;291;558;2;140;4;3;133;151;8;143
162205009;600;653;653;7;250;491;2;107;1;3;103;143;13;130
162205010;600;639;639;5;246;484;1;115;5;6;104;131;10;121
162205011;600;657;657;6;255;476;2;122;1;5;116;133;10;123
162205012;600;660;660;9;231;490;2;108;2;3;103;123;8;115
162205013;500;553;553;6;204;390;1;109;5;3;101;95;7;88
162205014;600;614;615;9;250;493;1;106;3;4;99;144;3;141
162205015;600;618;615;5;236;513;1;86;3;2;81;150;6;144
162205016;700;598;597;16;259;590;1;109;2;2;105;150;8;142
162205017;700;721;722;11;275;589;2;109;7;3;99;166;12;154
162205018;600;611;611;6;233;483;1;116;0;6;110;117;12;105
162205019;600;635;635;6;267;500;1;99;4;3;92;168;9;159
162205020;700;646;646;18;272;581;2;117;3;5;109;155;10;145
162205021;800;786;786;12;319;690;1;109;4;2;103;210;20;190
162205022;600;607;607;8;222;506;1;93;4;7;82;129;8;121
162205023;600;583;583;7;255;482;1;117;5;5;107;138;10;128
162205024;700;611;611;15;270;570;1;129;8;2;119;141;8;133
162205025;600;653;653;7;269;488;1;111;2;6;103;158;15;143
162205026;700;682;682;7;220;589;1;110;2;2;106;110;7;103
162205027;600;574;575;7;217;493;1;106;4;5;97;111;5;106
162205028;800;779;781;5;336;629;1;170;2;11;157;166;10;156
162205029;700;670;671;6;261;571;1;128;1;9;118;133;6;127
162205030;600;611;611;10;216;482;2;116;2;5;109;100;5;95
162205031;600;642;643;9;273;505;1;94;0;6;88;179;8;171
162205032;700;653;654;8;210;603;1;96;4;6;86;114;8;106
162205033;700;710;710;10;264;568;1;131;6;5;120;133;8;125
162205034;800;828;829;8;280;620;1;179;2;7;170;101;7;94
162205035;700;729;729;9;270;578;1;121;2;3;116;149;7;142
162205036;800;779;779;7;253;686;4;110;3;4;103;143;14;129
162205037;700;726;726;10;310;585;1;114;2;2;110;196;16;180
162205038;900;836;837;10;309;777;1;122;1;2;119;187;7;180
162205039;800;780;780;10;308;666;3;131;5;4;122;177;14;163
162205040;900;887;887;9;377;746;4;150;1;5;144;227;13;214
162205041;900;960;961;8;344;753;1;146;2;6;138;198;15;183
162205042;700;683;685;16;280;565;1;134;5;3;126;146;6;140
162205043;600;663;663;5;242;481;2;117;3;1;113;125;12;113
162205044;600;654;656;11;255;481;1;118;3;4;111;137;6;131
162205045;700;682;682;8;291;570;3;127;4;6;117;164;9;155
162205046;700;758;758;8;303;595;1;104;4;1;99;199;12;187
162205047;600;664;664;8;267;476;6;118;2;5;111;149;12;137
162205048;600;599;599;5;178;513;2;85;1;4;80;93;3;90
162205049;600;617;618;4;178;518;1;81;2;3;76;97;6;91
162205050;600;594;594;7;198;521;1;78;7;2;69;120;5;115
162205051;700;700;695;8;251;589;1;110;5;2;103;141;5;136
162205052;600;662;662;9;235;502;1;97;0;3;94;138;13;125
162205053;800;738;738;28;327;646;4;150;6;1;143;177;9;168
162205054;800;853;854;10;342;645;2;153;5;10;138;189;11;178
162205055;900;921;921;7;329;758;1;141;4;4;133;188;15;173
162205056;900;338;948;8;346;768;1;131;0;6;125;215;16;199
162205057;1000;1045;1046;10;416;851;3;146;1;4;141;270;19;251
162205058;900;905;905;4;346;782;2;116;4;1;111;230;11;219
162205059;800;791;791;8;310;675;1;124;5;4;115;186;15;171
162205060;800;801;803;5;322;639;1;160;10;3;147;162;7;155
162205061;800;799;802;9;313;615;4;181;8;5;168;132;1;131
162205062;700;732;732;2;273;574;1;125;3;2;120;148;6;142
162205063;700;761;761;4;296;566;2;132;4;8;120;164;3;161
162205064;800;840;840;7;297;658;1;141;4;6;131;156;12;144
162205065;800;789;793;3;257;675;1;124;5;6;113;133;15;118
162205066;800;833;833;7;268;674;2;124;9;9;106;144;8;136
162205067;800;770;771;13;251;701;1;98;0;0;98;153;6;147
162205068;1000;994;994;5;369;700;1;299;9;25;265;70;1;69
162205069;800;862;863;7;268;681;2;117;6;6;105;151;7;144
162205070;800;859;860;7;296;586;1;213;6;9;198;83;6;77
162205071;800;679;682;13;257;681;1;118;4;1;113;139;7;132
162205072;700;741;741;5;257;575;1;124;8;6;110;133;7;126
162205073;700;747;747;8;293;564;1;135;2;5;128;158;10;148
162205074;700;686;688;8;246;577;1;122;8;2;112;124;9;115
162205075;700;714;714;5;259;580;2;118;6;3;109;141;8;133
162205076;700;732;732;6;283;568;2;130;8;5;117;153;17;136
162205077;700;720;720;5;282;551;2;147;2;3;142;135;8;127
162205078;700;692;695;7;214;586;3;111;2;4;105;103;5;98
162205079;700;685;685;8;235;586;1;113;3;2;108;122;10;112
162205080;700;698;698;3;243;617;1;82;3;1;78;161;11;150
162205081;700;713;713;4;243;591;1;108;3;2;103;135;3;132
162205082;800;780;781;8;256;698;1;101;6;9;86;155;13;142
162205083;700;752;755;5;240;590;1;109;5;2;102;131;6;125
162205084;900;958;959;4;318;760;2;138;5;9;124;180;8;172
162205085;800;840;840;4;308;687;1;112;4;2;106;196;9;187
162205086;800;660;661;33;293;658;1;141;14;0;127;152;8;144
162205087;800;643;642;20;291;674;1;125;7;7;111;166;14;152
162205088;700;660;662;5;251;579;2;119;0;6;113;132;13;119
162205089;700;668;669;8;270;515;1;184;3;7;174;86;5;81
162205090;700;658;661;4;229;585;1;114;0;2;112;115;8;107
162205091;700;676;676;4;232;601;1;98;5;4;89;134;3;131
162205092;700;706;706;4;264;576;1;123;3;5;115;141;15;126
162205093;700;686;688;3;261;586;1;113;4;3;106;148;17;131
162205094;600;639;640;5;228;499;1;100;7;2;91;128;8;120
162205095;600;629;629;5;178;507;2;91;4;4;83;87;5;82
162205096;300;29;29;6;35;265;0;35;0;0;35;0;0;0
162205097;500;84;84;24;97;402;1;97;18;5;74;0;0;0
162205098;500;99;99;21;95;404;1;95;11;5;79;0;0;0
162206001;700;675;678;6;258;563;1;136;1;1;134;122;14;108
162206002;600;609;606;3;243;489;1;110;2;4;104;133;6;127
162206003;500;487;487;16;200;419;1;80;6;3;71;120;4;116
162206004;600;659;659;5;242;515;1;84;2;6;76;158;10;148
162206005;600;589;589;6;213;524;1;75;0;2;73;138;7;131
162206006;600;571;572;5;176;531;1;68;0;2;66;108;4;104
162206007;800;767;767;6;296;673;2;125;3;1;121;171;12;159
162206008;600;644;644;6;208;510;1;89;2;2;85;119;7;112
162206009;600;626;627;5;256;494;2;104;1;5;98;152;6;146
162206010;600;607;609;5;207;522;1;77;0;2;75;130;8;122
162206011;700;672;676;8;292;535;1;164;4;4;156;128;8;120
162206012;600;631;627;8;181;521;3;76;3;5;68;105;4;101
162206013;700;671;672;2;234;608;1;91;5;4;82;143;4;139
162206014;700;707;707;4;274;588;1;111;4;3;104;163;7;156
162206015;700;699;697;4;238;602;1;97;3;2;92;141;9;132
162206016;700;746;744;3;230;587;2;111;8;5;98;119;1;118
162206017;600;601;601;8;201;512;1;87;2;4;81;114;7;107
162206018;600;648;649;4;184;527;2;71;3;1;67;113;2;111
162206019;600;604;604;8;212;510;1;89;3;2;84;123;4;119
162206020;600;635;635;5;217;511;1;88;1;7;80;129;4;125
162206021;700;679;678;1;261;581;1;118;1;4;113;143;10;133
162206022;600;610;607;8;208;506;1;93;3;0;90;115;4;111
162206023;700;755;755;7;292;602;1;97;0;4;93;195;13;182
162206024;700;264;697;5;264;572;10;118;3;3;112;146;7;139
162206025;600;617;618;5;223;486;1;113;4;3;106;110;9;101
162206026;700;689;689;5;309;552;1;147;3;5;139;162;14;148
162206027;600;642;643;5;246;481;1;118;4;8;106;128;10;118
162206028;700;735;739;7;281;577;1;122;2;8;112;159;12;147
162206029;700;716;717;0;277;562;1;137;3;7;127;140;11;129
162206030;700;678;679;5;221;614;1;85;2;6;77;136;4;132
162206031;600;619;619;4;214;514;1;85;3;4;78;129;11;118
162206032;600;628;627;6;211;508;1;91;3;3;85;120;11;109
162206033;600;635;634;4;246;496;1;103;2;3;98;143;9;134
162206034;700;684;684;1;281;556;1;143;3;7;133;138;5;133
162206035;700;650;651;5;235;565;1;134;6;5;123;101;7;94
162206036;700;714;713;6;251;568;2;130;1;3;126;121;4;117
162206037;600;577;577;15;208;502;1;97;1;1;95;111;4;107
162206038;700;662;662;6;219;620;1;79;4;0;75;140;6;134
162206039;600;600;601;4;204;532;1;67;3;1;63;137;4;133
162206040;500;445;445;49;193;402;1;97;2;6;89;96;5;91
162206041;600;587;589;1;174;500;1;99;5;3;91;75;3;72
162206042;400;428;429;2;140;340;1;59;1;3;55;81;4;77
162206043;500;517;517;4;181;429;1;70;1;0;69;111;4;107
162206044;600;604;607;6;243;490;1;109;1;4;104;134;6;128
162206045;700;696;697;4;235;572;1;127;4;7;116;108;3;105
162206046;600;592;592;5;264;464;1;135;3;7;125;129;8;121
162206047;700;687;688;6;265;590;1;109;0;4;105;156;8;148
162206048;700;689;689;5;308;581;1;118;0;4;114;190;8;182
162206049;600;630;631;5;224;503;1;96;3;4;89;128;9;119
162206050;600;555;557;0;222;495;2;103;1;0;102;119;5;114
162206051;600;619;619;8;224;506;1;93;0;4;89;131;9;122
162206052;600;605;605;5;185;512;1;87;0;2;85;98;7;91
162206053;800;809;809;2;244;687;2;111;2;5;104;133;9;124
162206054;800;807;807;7;323;669;1;130;5;5;120;193;9;184
162206055;800;752;752;12;370;711;1;88;0;5;83;282;21;261
162206056;600;641;641;0;231;508;1;91;3;0;88;140;3;137
162206057;700;723;725;3;266;570;1;129;3;4;122;137;7;130
162206058;700;674;674;6;244;598;1;101;0;3;98;143;7;136
162206059;700;693;694;7;273;563;1;136;1;6;129;137;11;126
162206060;600;600;600;3;211;500;3;97;6;4;87;114;9;105
162206061;700;724;721;6;291;572;1;127;4;4;119;164;8;156
162206062;700;356;743;5;361;601;1;98;2;4;92;263;11;252
162206063;700;655;655;7;282;576;2;122;4;5;113;160;7;153
162206064;700;659;659;3;329;580;3;117;2;3;112;212;5;207
162206065;700;752;753;6;283;574;1;125;8;1;116;158;13;145
162206066;800;770;770;7;265;702;5;93;4;2;87;172;5;167
162206067;800;779;781;8;278;693;1;106;4;3;99;172;10;162
162206068;800;749;749;20;333;674;1;125;3;0;122;208;8;200
162206069;600;618;620;5;218;526;1;73;3;1;69;145;8;137
162206070;700;742;743;3;267;597;1;102;1;2;99;165;13;152
162206071;700;740;740;3;254;592;1;107;1;2;104;147;11;136
162206072;700;687;687;9;276;583;2;115;4;3;108;161;8;153
162206073;700;642;642;8;296;605;1;94;0;4;90;202;8;194
162206074;100;68;68;11;21;76;3;21;0;0;21;0;0;0
170100001;500;760;761;7;253;341;1;158;3;2;153;95;3;92
170100002;500;692;694;4;230;344;1;155;8;3;144;75;6;69
170100003;500;836;837;6;260;344;1;155;5;3;147;105;5;100
170100004;500;802;802;3;277;351;2;147;1;4;142;130;8;122
170100005;500;763;763;4;239;355;1;144;0;4;140;95;8;87
170100006;400;581;581;8;238;276;2;122;3;0;119;116;3;113
170100007;500;914;914;4;376;306;3;191;7;8;176;185;10;175
170100008;500;831;832;7;344;308;1;191;0;9;182;153;7;146
170100009;500;694;694;9;309;354;1;145;3;1;141;164;5;159
170100010;400;644;648;3;258;277;1;122;3;5;114;136;12;124
170100011;500;776;779;3;344;350;1;149;4;4;141;195;12;183
170100012;400;678;680;7;293;267;2;131;3;6;122;162;11;151
170100013;300;442;443;5;147;221;1;78;0;3;75;69;3;66
170100014;300;495;495;6;190;206;2;92;1;0;91;98;4;94
170100015;400;615;615;5;241;274;1;125;4;2;119;116;8;108
170100016;500;739;739;6;277;353;1;146;10;4;132;131;7;124
170100017;300;437;439;5;193;193;1;106;2;1;103;87;3;84
170100018;300;479;479;5;191;213;2;85;1;1;83;106;12;94
170100019;400;531;531;5;209;298;1;101;3;4;94;108;8;100
170100020;400;683;685;3;303;254;2;144;0;1;143;159;11;148
170100021;500;810;810;5;315;336;1;163;7;3;153;152;10;142
170100022;500;875;875;6;336;327;1;172;3;5;164;164;5;159
170100023;300;491;494;6;192;208;1;91;4;2;85;101;4;97
170100024;500;726;726;3;276;349;3;148;2;2;144;128;9;119
170100025;300;362;362;5;157;214;1;85;0;2;83;72;4;68
170100026;400;635;635;0;247;251;1;148;8;5;135;99;8;91
170100027;400;532;532;2;217;276;3;121;6;5;110;96;4;92
170100028;300;391;391;3;176;190;2;108;3;3;102;68;8;60
170100029;400;692;692;7;237;275;2;123;1;1;121;114;2;112
170100030;300;399;399;6;153;226;1;73;1;1;71;80;2;78
170100031;500;749;749;6;247;325;2;173;1;4;168;74;6;68
170100032;400;662;662;2;228;268;1;131;4;2;125;97;5;92
170100033;400;655;659;6;239;244;3;153;2;3;148;86;3;83
170100034;500;780;780;6;250;353;1;146;5;9;132;104;3;101
170100035;400;548;548;8;235;271;2;127;3;3;121;108;11;97
170100036;300;481;482;10;145;221;1;78;4;5;69;67;7;60
170100037;400;564;567;5;207;294;2;104;3;4;97;103;4;99
170100038;600;879;880;7;253;459;1;140;5;5;130;113;7;106
170100039;500;766;767;11;258;338;1;161;6;7;148;97;8;89
170100040;400;616;616;5;193;263;1;136;2;6;128;57;7;50
170100041;300;492;492;5;202;182;2;116;1;1;114;86;4;82
170100042;400;661;661;6;263;243;1;156;4;3;149;107;4;103
170100043;500;705;705;6;300;317;1;182;1;7;174;118;2;116
170100044;500;688;689;6;262;308;1;191;1;3;187;71;7;64
170100045;300;469;471;6;183;193;1;106;4;5;97;77;4;73
170100046;500;787;789;5;258;351;1;148;6;2;140;110;2;108
170100047;500;808;811;0;251;348;1;151;4;4;143;100;5;95
170100048;400;623;624;8;193;285;2;113;2;1;110;80;3;77
170100049;400;685;685;5;206;293;1;106;0;2;104;100;6;94
170100050;400;651;653;2;179;283;1;116;3;1;112;63;4;59
170100051;200;338;338;4;106;133;1;66;2;3;61;40;2;38
170100052;500;713;714;4;212;374;1;125;6;7;112;87;5;82
170100053;400;619;621;6;180;287;1;112;0;4;108;68;4;64
170100054;500;729;729;8;183;341;1;158;7;1;150;25;1;24
170100055;300;437;437;15;115;184;1;115;4;0;111;0;0;0
170100056;400;672;672;8;153;267;1;132;2;5;125;21;0;21
170100057;500;803;805;7;190;353;1;146;5;2;139;44;3;41
170100058;500;844;844;5;222;277;1;222;20;4;198;0;0;0
170100059;600;934;934;6;296;303;1;296;32;6;258;0;0;0
170100060;300;484;484;4;177;196;1;103;2;5;96;74;5;69
170100061;400;592;593;5;161;285;1;114;5;3;106;47;3;44
170100062;400;539;541;3;180;258;1;141;1;7;133;39;1;38
170100063;500;712;712;13;266;276;1;223;3;5;215;43;3;40
170100064;400;550;550;6;219;203;1;196;3;3;190;23;2;21
170100065;500;847;848;6;270;286;2;212;0;5;207;58;0;58
170100066;600;866;868;7;355;271;1;328;6;13;309;27;3;24
170100067;300;254;254;6;126;173;1;126;4;0;122;0;0;0
170100068;500;440;440;3;126;423;2;75;4;1;70;51;0;51
170100069;100;11;11;7;11;88;1;11;0;0;11;0;0;0
170100070;100;17;17;6;8;91;1;8;0;0;8;0;0;0
170100071;100;79;79;7;67;31;2;67;2;2;63;0;0;0
170100072;200;258;260;4;140;59;1;140;3;6;131;0;0;0
170100073;100;13;13;5;12;87;1;12;0;0;12;0;0;0
170100074;400;363;367;4;113;308;1;91;1;1;89;22;1;21
170100075;600;647;647;4;267;338;1;261;10;12;239;6;0;6
170100076;500;468;475;1;125;398;1;101;4;1;96;24;1;23
170100077;500;169;500;4;173;383;1;116;4;1;111;57;1;56
170100078;100;23;23;8;30;70;0;30;1;3;26;0;0;0
170100079;700;758;758;5;335;400;4;296;4;4;288;39;0;39
170100080;100;34;34;6;29;70;1;29;0;0;29;0;0;0
170100081;300;288;288;3;146;153;1;146;2;4;140;0;0;0
170100082;300;302;302;4;141;181;1;118;4;3;111;23;0;23
170100083;200;199;199;2;77;121;2;77;2;0;75;0;0;0
170100084;300;260;261;3;86;213;1;86;1;6;79;0;0;0
170100085;200;137;137;3;58;141;1;58;0;0;58;0;0;0
170100086;200;107;107;4;77;122;1;77;0;1;76;0;0;0
170100087;100;30;30;6;26;73;1;26;1;2;23;0;0;0
170100088;300;271;271;2;154;145;1;154;2;1;151;0;0;0
170100089;600;600;600;7;225;374;1;225;7;1;217;0;0;0
170100090;800;802;802;3;157;641;2;157;16;2;139;0;0;0
170100091;600;604;606;4;240;361;1;238;3;2;233;2;0;2
170100092;600;571;572;5;224;375;1;224;9;4;211;0;0;0
170100093;700;698;698;3;243;508;1;191;4;2;185;52;1;51
170100094;100;22;22;6;18;81;1;18;0;0;18;0;0;0
170100095;100;10;10;6;16;84;0;16;0;1;15;0;0;0
170100096;500;559;559;4;257;311;1;188;5;11;172;69;3;66
170100097;100;21;21;7;20;79;1;20;0;2;18;0;0;0
170100098;600;834;834;5;253;396;1;203;1;1;201;50;1;49
170100099;300;313;309;4;166;133;1;166;1;4;161;0;0;0
170100100;600;612;612;6;236;391;1;208;0;9;199;28;1;27
170100101;500;706;706;5;181;327;1;172;18;6;148;9;0;9
170100102;500;798;798;5;284;266;1;233;5;10;218;51;2;49
170100103;400;308;308;8;101;318;1;81;1;0;80;20;1;19
170100104;500;760;760;7;226;273;1;226;34;3;189;0;0;0
170100105;600;886;887;4;332;319;1;280;1;6;273;52;4;48
170100106;100;7;7;4;11;88;1;11;0;1;10;0;0;0
170100107;100;11;11;26;29;70;1;29;1;4;24;0;0;0
170100108;100;32;32;37;69;30;1;69;2;1;66;0;0;0
170100109;200;91;91;59;90;109;1;90;6;6;78;0;0;0
170700001;360;412;416;7;182;230;1;129;2;1;126;53;4;49
170700002;300;335;339;2;143;200;1;99;2;2;95;44;1;43
170700003;600;613;615;5;172;460;1;139;10;1;128;33;0;33
170700004;300;306;306;6;86;213;1;86;5;3;78;0;0;0
170700005;300;315;315;4;74;248;2;50;2;0;48;24;2;22
170700006;200;198;199;4;95;104;1;95;5;2;88;0;0;0
170700007;200;283;283;5;132;67;1;132;9;5;118;0;0;0
170700008;50;59;59;4;40;9;1;40;0;0;40;0;0;0
170700009;150;148;150;2;68;81;1;68;3;0;65;0;0;0
170700010;50;51;53;4;37;12;1;37;2;0;35;0;0;0
170700011;150;120;122;3;88;61;1;88;2;2;84;0;0;0
170700012;100;95;95;6;66;33;1;66;2;1;63;0;0;0
170700013;250;272;272;2;81;168;1;81;7;2;72;0;0;0
170700014;150;187;187;0;61;88;1;61;0;0;61;0;0;0
170700015;500;559;561;1;206;314;2;184;9;3;172;22;0;22
170700016;100;101;101;4;52;47;1;52;3;1;48;0;0;0
170700017;300;328;328;7;123;209;2;89;7;1;81;34;1;33
170700018;400;450;452;2;107;317;2;81;7;3;71;26;0;26
170700019;90;84;84;6;64;25;1;64;1;0;63;0;0;0
170700020;50;14;14;1;13;36;1;13;0;0;13;0;0;0
171200001;800;860;860;1;285;615;1;184;7;1;176;101;2;99
171200002;600;633;633;2;265;455;2;143;1;4;138;122;5;117
171200003;500;557;558;1;221;388;1;111;4;8;99;110;6;104
171200004;400;454;455;1;206;300;1;99;2;0;97;107;6;101
171200005;600;662;662;0;235;491;1;108;4;1;103;127;9;118
171200006;600;586;588;0;174;512;1;87;3;1;83;87;5;82
171200007;900;973;973;0;208;756;1;143;4;0;139;65;1;64
171200008;600;611;614;1;172;464;1;135;9;5;121;37;1;36
171200009;600;604;602;4;163;489;3;108;2;3;103;55;2;53
171200010;500;510;510;2;148;401;4;95;6;4;85;53;3;50
171200011;200;156;156;1;80;119;1;80;1;1;78;0;0;0
171200012;200;194;194;2;110;89;1;110;5;0;105;0;0;0
171200013;300;327;330;2;206;93;1;206;8;2;196;0;0;0
171200014;600;582;582;3;149;491;1;108;8;2;98;41;2;39
171200015;100;96;96;2;55;44;1;55;0;3;52;0;0;0
171200016;100;122;122;3;75;24;1;75;2;0;73;0;0;0
171200017;300;348;348;4;113;209;1;90;9;2;79;23;1;22
171200018;200;149;150;2;77;122;1;77;2;9;66;0;0;0
171200019;200;245;245;3;100;98;2;100;1;5;94;0;0;0
171200020;300;376;376;2;123;196;1;103;3;0;100;20;0;20
171300001;600;624;624;4;208;527;1;72;2;1;69;136;11;125
171300002;600;615;616;3;250;500;2;98;1;3;94;152;5;147
171300003;600;629;629;3;183;526;1;73;3;0;70;110;5;105
171300004;500;552;552;6;217;377;1;122;1;0;121;95;4;91
171300005;600;640;642;9;146;534;2;64;3;2;59;82;6;76
171300006;700;668;668;8;123;614;1;85;6;0;79;38;1;37
171300007;600;604;606;8;200;514;1;85;0;1;84;115;9;106
171300008;700;719;727;7;262;571;1;128;3;0;125;134;4;130
171300009;800;766;768;6;259;691;1;108;4;2;102;151;6;145
171300010;700;696;697;9;204;601;1;98;6;3;89;106;6;100
171300011;600;607;607;9;179;527;1;72;3;0;69;107;6;101
171300012;700;727;727;5;260;563;2;135;1;2;132;125;6;119
171300013;700;677;679;4;240;581;1;118;3;6;109;122;2;120
171300014;700;679;680;6;236;555;1;144;5;7;132;92;3;89
171300015;600;661;662;8;129;516;1;83;3;1;79;46;1;45
171300016;500;559;559;9;134;403;1;96;9;2;85;38;2;36
171300017;600;668;668;6;207;500;1;99;2;3;94;108;10;98
171300018;600;646;646;6;199;498;1;101;1;5;95;98;13;85
171300019;600;664;664;5;250;432;1;167;10;6;151;83;4;79
171300020;700;664;664;5;193;603;1;96;8;4;84;97;2;95
171300021;700;748;748;6;290;603;1;96;2;0;94;194;11;183
171300022;600;575;579;7;202;509;1;90;1;7;82;112;7;105
171300023;600;656;657;7;230;509;2;89;2;2;85;141;3;138
171300024;600;606;606;6;213;538;2;60;1;3;56;153;6;147
171300025;600;649;649;8;246;488;1;111;1;6;104;135;12;123
171300026;600;600;661;4;252;496;1;103;5;6;92;149;9;140
171300027;700;684;684;4;220;588;1;111;6;4;101;109;12;97
171300028;700;723;727;2;199;594;1;105;3;2;100;94;7;87
171300029;500;573;574;10;196;409;1;90;2;1;87;106;6;100
171300030;700;671;674;8;197;596;1;103;6;3;94;94;4;90
171300031;700;692;692;5;240;573;1;126;5;7;114;114;6;108
171300032;500;470;470;4;102;425;1;74;2;5;67;28;1;27
171300033;100;21;21;7;21;78;1;21;0;2;19;0;0;0
171300034;400;388;388;7;120;316;1;83;1;1;81;37;4;33
171300035;500;538;538;0;171;369;1;130;1;4;125;41;6;35
171300036;600;572;574;2;193;491;1;108;2;1;105;85;3;82
171300037;700;659;659;3;214;585;3;112;3;2;107;102;1;101
171300038;700;693;695;2;174;604;1;95;5;2;88;79;5;74
171300039;800;851;851;1;165;695;1;104;6;3;95;61;1;60
171300040;400;410;410;7;139;295;1;104;2;9;93;35;5;30
171300041;200;164;165;3;91;107;2;91;1;3;87;0;0;0
171300042;300;336;336;4;167;132;1;167;9;6;152;0;0;0
171300043;400;389;391;4;95;331;1;68;4;2;62;27;1;26
171300044;300;279;280;3;97;202;1;97;1;2;94;0;0;0
171300045;100;65;65;8;36;63;1;36;1;1;34;0;0;0
171300046;500;540;540;5;191;357;1;142;2;6;134;49;2;47
171300047;600;625;626;5;272;390;1;209;4;4;201;63;4;59
171300048;600;575;575;7;149;527;1;72;2;5;65;77;6;71
171300049;600;599;600;3;172;487;1;112;3;2;107;60;0;57
171300050;600;622;624;2;192;483;2;115;4;8;103;77;6;71
171300051;600;578;578;5;141;540;1;59;4;2;53;82;9;73
171300052;200;189;189;3;68;131;1;68;2;4;62;0;0;0
171300053;700;733;737;4;214;578;1;121;1;3;117;93;2;91
171300054;600;570;573;6;175;482;1;117;1;6;110;58;0;58
171300055;500;464;466;1;147;403;1;96;1;5;90;51;1;50
171300056;500;483;483;4;98;418;1;81;1;3;77;17;1;16
171300057;500;482;482;5;162;359;3;138;5;6;127;24;1;23
171300058;500;453;453;5;223;332;1;167;1;9;157;56;7;49
171300059;400;409;409;7;237;220;1;179;0;10;169;58;5;53
171300060;600;572;572;6;172;488;1;111;2;6;103;61;4;57
171300061;600;657;658;4;197;452;1;147;8;8;131;50;6;44
171300062;400;394;395;4;139;307;1;92;6;1;85;47;4;43
171300063;300;349;350;2;88;228;1;71;5;1;65;17;0;17
171300064;700;712;712;6;253;528;2;170;16;7;147;83;8;75
171300065;600;621;621;3;155;495;1;104;1;5;98;51;1;50
171300066;700;714;714;5;228;529;1;170;13;18;139;58;8;50
171300067;600;632;633;5;133;500;1;99;4;3;92;34;2;32
171300068;600;618;617;4;93;534;2;64;4;2;58;29;1;28
171300069;700;708;709;4;209;514;1;185;10;1;174;24;0;24
171300070;600;662;663;3;162;469;1;130;4;1;125;32;4;28
171300071;700;677;677;6;143;574;1;125;14;2;109;18;0;18
171300072;800;820;821;6;163;647;1;152;14;1;137;11;0;11
171300073;700;710;710;3;149;561;2;137;4;1;132;12;0;12
171300074;400;460;461;2;143;343;1;56;2;0;54;87;3;84
171300075;400;452;452;3;125;318;2;80;4;1;75;45;2;43
171300076;100;17;17;0;16;83;1;16;0;0;16;0;0;0
171300077;100;11;11;21;25;74;1;25;0;3;22;0;0;0
171300078;200;93;93;42;110;89;1;110;4;3;103;0;0;0
171500001;600;632;635;3;205;477;4;119;4;4;111;86;4;82
171500002;340;398;398;5;117;273;1;66;0;3;63;51;0;51
171500003;550;594;595;3;167;450;1;99;1;0;98;68;6;62
171500004;40;33;33;8;24;15;1;24;0;0;24;0;0;0
171500005;40;37;38;6;21;18;1;21;0;1;20;0;0;0
171500006;160;167;167;7;68;91;1;68;4;2;62;0;0;0
171500007;20;17;17;6;11;8;1;11;0;0;11;0;0;0
171500008;60;56;56;7;41;17;2;41;1;2;38;0;0;0
171500009;140;148;148;8;71;68;1;71;2;1;68;0;0;0
171500010;30;24;24;7;14;15;1;14;0;0;14;0;0;0
171500011;20;16;16;7;10;9;1;10;0;0;10;0;0;0
171700001;600;666;666;3;242;467;1;132;4;6;122;110;6;104
171700002;500;504;504;3;205;380;1;119;0;3;116;86;8;78
171700003;700;734;734;7;283;569;1;130;2;3;125;153;13;140
171700004;500;485;485;4;167;415;1;84;1;0;83;83;6;77
171700005;600;595;596;3;192;515;2;83;8;3;72;109;10;99
171700006;800;825;828;5;302;580;2;218;11;7;200;84;7;77
171700007;600;614;614;6;293;433;3;164;6;2;156;129;9;120
171700008;700;693;693;2;241;569;1;130;2;5;123;111;3;108
171700009;700;725;729;1;244;502;2;196;7;8;181;48;1;47
171700010;700;723;723;6;252;556;1;143;8;7;128;109;7;102
171700011;900;928;930;3;375;702;3;195;2;3;190;180;16;164
171700012;800;781;783;5;306;646;1;153;4;2;147;153;12;141
171700013;800;836;838;4;218;674;1;125;6;5;114;93;8;85
171700014;600;572;572;2;141;536;1;63;2;3;58;78;1;77
171700015;800;772;772;5;232;668;1;131;6;1;124;101;2;98
171700016;600;637;637;3;226;494;1;105;1;2;102;121;12;109
171700017;800;786;786;2;240;650;1;149;6;2;141;91;6;85
171700018;900;969;970;3;375;703;1;196;6;2;188;179;4;175
171700019;700;729;729;0;237;584;2;114;0;3;111;123;2;121
171700020;600;629;629;2;101;535;1;64;3;3;58;37;4;33
171700021;600;620;620;4;244;419;1;180;2;7;171;64;4;60
171700022;400;426;426;2;116;304;1;95;2;6;87;21;0;21
171700023;500;453;453;2;40;467;1;32;0;2;30;8;1;7
171700024;300;327;327;4;163;223;1;76;3;3;70;87;8;79
171700025;500;493;493;2;145;422;1;77;3;0;74;68;3;65
171700026;700;679;679;3;103;629;1;70;3;1;66;33;2;31
171700027;700;232;756;4;236;554;1;145;4;6;135;91;4;87
171700028;600;578;577;3;119;522;1;77;7;2;68;42;3;39
171700029;700;709;709;0;252;567;2;131;1;4;126;121;11;110
171700030;600;597;597;1;191;505;1;94;2;2;90;97;4;93
171700031;500;492;492;2;174;400;1;99;0;2;97;75;4;71
171700032;700;723;723;4;185;573;1;126;3;4;119;59;0;59
171700033;700;716;716;2;31;670;1;29;1;2;26;2;0;2
171700034;700;691;691;1;208;572;1;127;3;8;116;81;9;72
171700035;600;575;575;5;62;544;1;55;0;0;55;7;1;6
171700036;600;599;599;2;121;521;1;78;2;2;74;43;2;41
171700037;500;510;511;1;138;402;1;97;0;2;95;41;2;39
171700038;600;653;653;1;156;483;1;116;1;8;107;40;5;35
171700039;500;500;500;4;166;375;3;122;2;2;118;44;1;43
171700040;500;526;525;4;213;328;2;170;11;5;154;43;1;42
171700041;100;13;13;2;13;86;1;13;3;0;10;0;0;0
172300001;700;658;658;4;179;579;1;120;7;1;112;59;2;57
172300002;600;595;595;3;124;531;1;68;0;2;66;56;4;52
172300003;500;568;569;3;175;402;1;97;3;1;93;78;2;76
172300004;600;679;679;1;245;471;1;128;3;2;123;117;4;113
172300005;700;799;799;4;276;537;1;162;1;4;157;114;3;111
172300006;800;941;941;3;182;662;1;137;11;2;124;45;2;43
172300007;600;658;658;3;231;408;1;191;0;11;180;40;1;39
172300008;600;695;695;4;243;462;1;137;2;3;132;106;5;101
172300009;500;530;530;8;178;389;1;110;1;1;108;68;6;62
172300010;400;466;466;1;189;279;3;118;0;4;114;71;4;67
172300011;500;586;587;2;197;403;1;96;2;3;91;101;8;93
172300012;500;611;611;6;213;379;1;120;4;3;113;93;6;87
172300013;400;518;518;3;202;304;1;95;1;1;93;107;10;97
172300014;600;929;929;3;86;531;1;68;7;1;60;18;2;16
172300015;500;589;588;5;86;427;1;72;7;2;63;14;1;13
172300016;600;695;695;5;208;463;1;136;4;5;127;72;5;67
172300017;800;797;797;2;163;685;1;114;1;2;111;49;3;46
172300018;800;836;836;2;204;648;1;151;3;4;144;53;3;50
172300019;700;673;673;2;91;610;1;89;3;3;83;2;0;2
172300020;400;527;527;2;150;291;1;108;2;0;106;42;0;42
172300021;400;520;520;0;165;270;1;129;3;3;123;36;2;34
172300022;600;644;645;5;202;436;1;163;4;5;154;39;3;36
172300023;100;34;34;7;23;76;1;23;0;0;23;0;0;0
172300024;400;408;409;1;76;335;1;64;1;0;63;12;1;11
172300025;400;485;486;1;111;310;1;89;2;3;84;22;0;22
172300026;400;581;582;6;171;259;1;140;2;4;134;31;1;30
172300027;300;419;419;2;160;149;3;148;3;4;141;12;0;12
172300028;600;565;565;8;218;407;1;192;5;0;187;26;0;26
172300029;700;609;609;5;242;457;1;242;1;2;239;0;0;0
172300030;200;210;211;5;104;95;1;104;1;3;100;0;0;0
172300031;400;407;408;4;171;255;1;144;5;0;139;27;0;27
172300032;300;343;343;8;146;183;1;116;0;0;116;30;1;29
172300033;414;414;414;8;147;286;1;127;6;3;118;20;3;17
172300034;600;592;594;8;158;463;1;136;8;2;126;22;1;21
172300035;400;472;472;3;93;306;1;93;2;1;90;0;0;0
172300036;400;461;461;0;166;255;1;144;4;8;132;22;1;21
172300037;200;118;119;3;73;126;1;73;1;2;70;0;0;0
172300038;500;412;413;7;144;374;1;125;12;1;112;19;1;18
172300039;1000;965;965;6;167;858;1;141;12;3;126;26;0;26
172500001;800;760;760;1;222;685;1;114;4;1;109;108;8;100
172500002;800;765;765;0;202;711;1;88;4;1;83;114;7;107
172500003;600;552;552;0;144;534;2;64;2;2;60;80;7;73
172500004;400;442;442;0;117;346;1;53;3;2;48;64;5;59
172500005;1000;968;968;0;243;885;1;114;4;1;109;129;8;121
172500006;700;722;722;0;184;611;1;88;5;0;83;96;3;93
172500007;800;771;771;0;190;691;1;108;7;2;99;82;6;76
172500008;400;457;457;6;129;339;1;60;3;1;56;69;2;67
172500009;600;570;570;2;156;547;1;52;1;0;51;104;8;96
172500010;700;722;722;2;178;612;1;87;6;3;78;91;4;87
172500011;600;640;640;0;154;512;1;87;4;2;81;67;4;63
172500012;700;738;738;0;174;550;1;149;1;2;146;25;0;25
172500013;700;744;744;0;215;576;1;123;1;6;116;92;2;90
172500014;500;544;544;6;136;427;1;72;3;6;63;64;3;61
172500015;600;657;657;0;52;554;1;45;13;0;32;7;0;7
172500016;900;921;921;1;201;781;1;118;4;3;111;83;7;76
172500017;600;624;624;2;187;499;1;100;3;5;92;87;8;79
172500018;700;658;657;2;77;626;1;73;10;0;63;4;0;4
172500019;600;642;642;5;183;487;1;112;3;2;107;71;2;69
172500020;600;561;561;2;156;503;1;96;8;2;86;60;1;59
172500021;700;726;727;3;208;568;1;131;10;1;120;77;2;75
172500022;300;352;352;1;83;242;1;57;1;1;55;26;0;26
172500023;600;582;584;1;110;528;1;71;4;5;62;39;1;38
172500024;600;641;641;2;155;502;1;97;1;2;94;58;4;54
172500025;600;639;639;3;156;464;1;135;1;4;130;21;1;20
172500026;800;806;806;3;97;754;1;45;0;1;44;52;2;50
172500027;900;904;906;0;149;793;1;106;2;2;102;43;0;43
172500028;600;654;654;1;44;567;1;32;1;0;31;12;1;11
172500029;300;251;251;0;73;226;1;73;1;0;72;0;0;0
172500030;400;433;433;2;145;331;1;68;4;2;62;77;6;71
172500031;1000;1000;1001;3;133;902;1;97;8;2;87;36;1;35
172500032;700;696;696;0;193;596;1;103;3;2;98;90;5;85
172500033;800;790;790;6;239;668;1;131;4;6;121;108;7;101
172600001;600;619;619;6;302;463;1;136;2;6;128;166;4;162
172600002;600;602;602;3;233;485;1;114;4;8;102;119;5;114
172600003;600;655;655;5;291;482;2;116;3;6;107;175;6;169
172600004;100;115;115;5;82;17;1;82;0;2;80;0;0;0
172600005;700;762;762;6;244;562;1;137;3;6;128;107;8;99
172600006;500;468;468;2;154;401;1;98;1;5;92;56;5;51
172600007;600;674;674;4;207;463;1;136;4;5;127;71;4;67
172600008;700;742;742;2;272;534;2;164;3;5;156;108;6;102
172600009;500;487;487;0;166;402;1;97;1;3;93;69;4;65
172600010;500;520;520;2;166;419;1;80;1;1;78;86;6;80
172600011;600;601;601;2;186;506;4;90;3;1;86;96;3;93
172600012;400;477;477;0;142;315;2;83;0;1;82;59;1;58
172600013;700;679;679;2;197;552;1;147;13;2;132;50;0;50
172600014;600;574;574;7;208;483;2;115;0;5;110;93;10;83
172600015;600;642;642;5;282;408;1;191;2;2;187;91;5;86
172600016;400;390;390;5;167;331;2;67;1;3;63;100;3;97
172600017;100;61;61;3;40;58;2;40;0;2;38;0;0;0
172600018;500;534;534;2;185;401;1;98;1;6;91;87;8;79
172600019;600;571;571;5;224;484;1;115;1;3;111;109;6;103
172600020;100;67;67;6;51;47;2;51;0;2;49;0;0;0
172600021;400;453;453;3;135;334;1;65;1;1;63;70;8;62
172600022;400;427;427;2;126;338;1;61;6;1;54;65;8;57
172600023;600;609;609;3;180;492;2;106;1;0;105;74;4;70
172600024;600;616;616;2;246;470;1;129;2;2;125;117;3;114
172600025;700;699;699;3;239;564;1;135;5;5;125;104;5;99
172600026;500;488;487;1;173;401;1;98;5;3;90;75;7;68
172600027;100;21;21;5;18;81;1;18;0;0;18;0;0;0
172600028;600;571;571;5;227;500;2;98;3;2;93;129;15;114
172600029;500;568;568;4;216;403;2;95;3;3;89;121;5;116
172600030;500;508;508;3;232;369;1;130;7;5;118;102;1;101
172600031;900;908;909;3;447;712;3;185;4;11;170;262;10;252
172600032;300;312;313;1;121;207;1;92;2;3;87;29;0;29
172600033;800;761;761;2;254;670;1;129;2;7;120;125;10;115
172600034;500;517;517;3;209;373;4;123;1;1;121;86;2;84
172600035;600;624;615;9;232;473;1;126;3;4;119;106;8;98
172600036;600;676;676;6;79;553;2;45;3;0;42;34;1;33
172600037;500;490;492;2;179;404;1;95;3;2;90;84;2;82
172600038;100;14;14;7;11;88;1;11;0;0;11;0;0;0
172600039;100;47;47;5;31;68;1;31;1;1;29;0;0;0
172600040;600;614;614;2;155;480;1;119;5;3;111;36;3;33
172600041;400;408;408;1;82;337;1;62;3;1;58;20;3;17
172600042;700;739;739;3;187;566;1;133;2;5;126;54;1;53
172600043;600;592;592;5;265;334;3;263;8;15;240;2;0;2
172600044;300;359;359;3;84;246;1;53;1;1;51;31;1;30
172600045;400;409;409;0;98;352;1;47;2;0;45;51;0;51
172600046;400;391;391;11;115;346;1;53;4;2;47;62;5;57
172600047;600;597;597;1;80;535;7;58;7;1;50;22;0;22
172600048;400;427;427;3;117;331;2;67;2;1;64;50;4;46
172600049;500;546;546;2;147;412;1;87;4;4;79;60;5;55
172600050;400;442;442;1;118;325;3;72;1;4;67;46;1;45
172600051;600;564;564;2;192;490;1;109;3;5;101;83;3;80
172600052;500;525;525;4;181;387;1;112;4;1;107;69;3;66
172600053;500;549;549;3;51;466;1;33;4;0;29;18;1;17
172600054;600;585;585;3;96;535;1;64;1;0;63;32;1;31
172600055;600;556;556;5;191;499;1;100;5;2;93;91;4;87
172600056;600;520;520;2;90;529;1;70;3;1;66;20;2;18
172800001;700;678;681;5;202;602;1;97;3;3;91;105;6;99
172800002;700;691;688;3;172;601;7;92;6;1;85;80;3;77
172800003;700;717;718;2;125;626;1;73;7;1;65;52;3;49
172800004;700;735;736;2;162;604;1;95;3;3;89;67;1;66
172800005;700;708;708;4;130;595;1;104;1;2;101;26;2;24
172800006;600;649;651;2;188;454;1;145;7;3;135;43;1;42
172800007;500;577;577;2;154;412;1;87;2;2;83;67;0;67
172800008;500;499;499;5;114;415;1;84;2;0;82;30;1;29
172800009;200;221;216;5;102;97;1;102;4;5;93;0;0;0
172800010;300;342;343;2;92;238;1;61;1;2;58;31;1;30
172800011;400;486;485;2;89;339;1;60;3;2;55;29;1;28
172800012;600;585;593;7;230;418;1;181;9;3;169;49;1;48
172800013;800;803;802;5;210;617;1;182;19;1;162;28;1;27
172800014;800;803;810;4;235;564;1;235;13;3;219;0;0;0
172800015;400;412;414;3;125;280;1;119;3;1;115;6;0;6
172800016;400;439;441;5;148;292;1;107;2;4;101;41;0;41
172800017;800;838;839;7;176;679;1;120;6;3;111;56;3;53
172800018;600;612;614;2;137;506;2;92;2;2;88;45;5;40
172800019;700;690;690;2;222;573;1;126;3;4;119;96;2;94
172800020;600;616;616;2;206;489;3;108;0;7;101;98;7;90
172800021;50;14;14;0;12;37;1;12;0;0;12;0;0;0
172800022;50;22;22;0;22;27;1;22;0;0;22;0;0;0
173300001;700;700;700;2;229;552;1;147;7;2;138;80;7;73
173300002;600;580;581;3;202;506;1;93;6;1;86;109;4;105
173300003;500;530;530;1;184;394;5;101;4;3;94;83;3;80
173300004;400;428;428;0;135;264;1;135;2;2;131;0;0;0
173300005;400;430;430;2;159;300;1;99;1;5;93;60;6;54
173300006;550;582;582;1;257;404;1;145;1;6;138;112;5;107
173300007;900;907;908;0;120;820;1;79;10;3;66;41;2;39
173300008;400;430;432;1;176;303;1;96;0;0;96;80;4;76
173300009;100;70;70;5;32;67;1;32;5;1;26;0;0;0
173300010;300;295;295;4;127;172;1;127;5;0;122;0;0;0
173300011;500;524;524;6;124;403;1;96;1;0;95;28;1;27
173300012;300;300;300;1;108;191;1;108;7;3;98;0;0;0
173300013;300;331;331;2;109;227;1;72;4;3;65;37;3;34
173300014;200;228;228;0;77;121;2;77;4;0;73;0;0;0
173300015;300;363;363;1;90;227;6;67;6;0;61;23;2;21
173300016;250;283;283;4;95;154;1;95;1;1;93;0;0;0
173300017;400;408;408;2;101;328;2;70;2;0;68;31;1;30
173300018;200;202;202;4;92;107;1;92;2;7;83;0;0;0
173300019;200;186;186;2;72;127;1;72;1;0;71;0;0;0
173700001;670;744;744;6;256;546;1;123;3;6;114;133;9;124
173700002;750;834;834;5;295;475;1;274;2;7;265;21;1;20
173700003;720;797;797;0;258;535;1;184;4;8;172;74;7;67
173700004;600;667;668;5;243;468;1;131;7;6;118;112;3;109
173700005;600;670;670;1;212;478;1;121;2;1;118;91;5;86
173700006;460;513;513;7;177;352;1;107;4;6;97;70;3;67
173700007;670;738;738;4;199;532;1;137;5;6;126;62;4;58
173700008;730;811;813;2;237;609;1;120;3;3;114;117;6;111
173700009;420;473;473;5;149;338;1;81;4;2;75;68;4;64
173700010;120;130;130;3;45;74;1;45;0;2;43;0;0;0
173700011;230;260;260;4;66;163;1;66;4;7;55;0;0;0
173700012;300;343;343;4;149;150;1;149;3;4;142;0;0;0
173700013;150;159;159;7;76;73;1;76;1;1;74;0;0;0
173700014;640;703;707;2;216;462;1;177;2;0;175;39;0;39
173700015;60;56;56;5;28;31;1;28;1;1;26;0;0;0
173700016;680;739;743;5;192;556;1;123;3;3;117;69;3;66
173700017;40;24;24;3;24;15;1;24;2;2;20;0;0;0
173700018;500;538;553;4;176;355;1;144;8;3;133;32;2;30
173700019;230;253;253;1;78;151;1;78;5;5;68;0;0;0
173700020;180;194;195;1;75;104;1;75;1;3;71;0;0;0
173700021;70;80;81;4;28;41;1;28;0;2;26;0;0;0
173700022;174;60;60;80;140;33;1;140;2;5;133;0;0;0
173700023;120;32;32;36;68;51;1;68;1;0;67;0;0;0
173700024;70;35;35;17;52;17;1;52;3;0;49;0;0;0
173700025;16;16;16;0;16;0;0;16;0;0;16;0;0;0
173900001;600;561;562;4;195;530;1;69;2;1;66;126;6;120
173900002;700;662;662;4;203;605;1;94;3;0;91;109;7;102
173900003;700;754;754;2;247;580;1;119;1;2;116;128;6;122
173900004;1000;992;992;0;186;813;1;186;16;1;169;0;0;0
173900005;800;812;812;0;259;616;1;183;2;7;174;76;4;72
173900006;500;580;580;0;187;391;1;108;3;3;102;79;4;75
173900007;500;548;547;2;166;390;1;109;1;7;101;57;3;54
173900008;600;590;590;6;159;497;1;102;6;2;94;57;4;53
173900009;900;909;909;1;228;731;1;168;5;2;161;60;3;57
173900010;700;763;763;1;105;615;3;82;7;0;75;23;6;17
174000001;400;430;430;1;181;300;2;98;1;0;97;83;6;77
174000002;600;600;599;1;195;484;2;114;1;4;109;81;2;79
174000003;600;600;600;1;188;490;1;109;4;2;103;79;2;77
174000004;700;708;709;1;185;595;1;104;4;3;97;81;5;76
174000005;700;755;755;5;210;555;2;143;8;2;133;67;6;61
174000006;1000;1021;1021;1;219;780;1;219;19;1;199;0;0;0
174100001;800;739;742;0;279;658;1;141;5;4;132;138;7;131
174100002;1000;1023;1023;1;277;772;1;227;17;2;208;50;2;48
174100003;900;943;943;2;255;731;1;168;2;6;160;87;4;83
174100004;700;656;656;1;250;604;1;95;0;1;94;155;5;150
174100005;700;702;702;4;253;548;1;151;7;6;138;102;3;99
174100006;700;659;660;6;239;576;1;123;2;5;116;116;6;110
174100007;600;633;635;0;253;465;1;134;4;3;127;119;4;115
174100008;700;736;737;0;309;493;1;206;9;17;180;103;5;98
174100009;600;616;618;2;225;485;1;114;8;0;106;111;3;108
174100010;500;495;495;3;139;432;2;66;4;1;61;73;4;69
174100011;600;618;620;0;222;491;1;108;4;4;100;114;3;111
174100012;600;588;588;8;241;468;1;131;3;6;122;110;10;100
174100013;600;598;598;1;236;478;1;121;6;8;107;115;5;110
174100014;600;664;664;0;217;482;2;116;1;6;109;101;6;95
174100015;700;702;703;2;130;597;2;101;7;1;93;29;1;28
174100016;600;569;570;1;148;499;2;99;7;5;87;49;0;49
174100017;800;789;790;3;229;641;1;158;7;5;146;71;1;70
174100018;500;547;547;1;125;400;1;99;10;0;89;26;0;26
174100019;800;817;818;1;164;661;2;137;11;3;123;27;2;25
174100020;600;591;593;0;182;465;1;134;4;3;127;48;2;46
174100021;700;688;688;1;172;582;1;117;6;1;110;55;1;54
174100022;500;543;543;3;216;354;2;144;1;2;141;72;7;65
174100023;500;513;514;0;197;354;1;145;3;0;142;52;2;50
174100024;1000;1031;1031;2;112;896;1;103;16;0;87;9;0;9
174100025;500;539;540;3;199;327;1;172;9;4;159;27;2;25
174100026;500;571;571;3;81;420;1;79;9;1;69;2;0;2
174100027;100;15;15;0;14;85;1;14;2;0;12;0;0;0
174200001;750;734;735;1;224;617;1;132;8;2;122;92;0;92
174200002;550;568;569;5;162;445;1;104;3;2;99;58;4;54
174200003;800;867;867;0;243;638;1;161;3;4;154;82;4;78
174200004;800;869;871;3;217;643;3;154;2;2;150;63;1;62
174200005;700;776;776;2;188;577;1;122;2;1;119;66;2;64
174200006;500;551;551;4;184;416;1;83;4;2;77;101;4;97
174200007;600;685;685;4;247;444;1;155;3;6;146;92;4;88
174200008;750;812;814;2;159;661;1;88;1;1;86;71;4;67
174200009;180;171;171;2;117;62;1;117;4;4;109;0;0;0
174200010;70;53;53;6;37;32;1;37;2;4;31;0;0;0
174200011;150;113;113;4;72;77;1;72;0;0;72;0;0;0
174200012;80;68;68;2;55;24;1;55;2;1;52;0;0;0
174200013;50;36;36;4;31;18;1;31;2;1;28;0;0;0
174200014;20;14;14;0;14;5;1;14;1;0;13;0;0;0
174300001;700;692;694;1;214;561;2;137;3;7;127;77;4;73
174300002;700;736;739;0;277;567;1;132;5;6;121;145;8;137
174300003;800;836;841;0;300;639;3;158;2;8;148;142;7;135
174300004;800;836;836;0;300;637;1;162;5;11;146;138;13;125
174300005;800;784;785;0;255;654;1;145;3;10;132;110;7;103
174300006;600;574;580;0;220;487;2;111;2;7;102;109;11;98
174300007;800;752;754;0;239;674;2;124;1;5;118;115;8;107
174300008;800;843;843;2;257;666;1;133;2;2;129;124;11;113
174300009;800;803;803;0;255;669;1;130;2;5;123;125;7;118
174300010;800;815;815;1;270;669;1;130;1;8;121;140;6;134
174300011;400;444;444;1;125;315;1;84;1;2;81;41;2;39
174300012;500;503;504;5;129;412;2;86;1;3;82;43;2;41
174300013;100;13;13;0;13;86;1;13;4;0;9;0;0;0
181100001;800;880;894;3;272;541;1;258;10;0;248;14;1;13
181100002;900;898;907;6;322;609;1;290;6;1;283;32;0;32
181100003;900;908;908;5;270;677;3;220;2;2;216;50;0;50
181100004;1000;1129;1145;5;387;631;1;368;11;4;353;19;0;19
181100005;700;720;722;4;234;557;1;142;2;2;138;92;3;89
181100006;800;813;820;6;293;562;1;237;4;7;226;56;5;51
181100007;700;733;744;7;268;468;2;230;7;10;213;38;1;37
181100008;700;713;720;4;249;480;1;219;13;5;201;30;2;28
181100009;400;401;415;6;161;239;1;160;6;3;151;1;0;1
181100010;700;831;838;9;236;518;1;181;2;2;177;55;1;54
181100011;700;708;715;10;209;531;1;168;2;1;165;41;0;41
181100012;700;775;783;9;233;493;2;205;4;0;201;28;0;28
181100013;800;935;935;6;327;480;1;319;10;7;302;8;0;8
181100014;500;522;534;5;244;260;1;239;1;9;229;5;0;5
181100015;100;78;78;0;77;22;1;77;3;0;74;0;0;0
181100016;100;49;49;3;48;45;7;48;6;0;42;0;0;0
181400001;650;679;679;5;222;427;1;222;1;3;218;0;0;0
181400002;300;356;356;7;164;135;1;164;3;4;157;0;0;0
181400003;1000;1070;1075;7;381;638;1;361;17;1;343;20;0;20
181400004;750;762;764;8;235;546;1;203;5;7;191;32;0;32
181400005;1000;969;969;9;308;691;1;308;6;3;299;0;0;0
181400006;500;547;549;10;284;215;1;284;4;3;277;0;0;0
181400007;1000;1064;1065;4;340;755;1;244;11;3;230;96;7;89
181400008;1000;997;998;5;299;787;1;212;6;7;199;87;9;78
181400009;800;812;812;7;255;636;1;163;6;5;152;92;5;87
181400010;900;943;944;9;321;676;1;223;1;4;218;98;4;94
181400011;900;923;927;8;314;686;1;213;5;7;201;101;7;94
181400012;1000;1002;1007;7;289;786;1;213;11;4;198;76;7;69
181400013;1000;1042;1046;9;339;789;1;210;9;6;195;129;7;122
181400014;650;646;647;8;197;508;1;141;3;5;133;56;4;52
181400015;700;704;705;7;236;518;1;181;2;6;173;55;4;51
181400016;750;753;755;8;299;500;1;249;8;4;237;50;4;46
181400017;1000;1011;1028;5;381;618;1;381;9;5;367;0;0;0
181400018;600;650;660;8;199;400;1;199;5;2;192;0;0;0
181400019;800;816;817;6;287;512;1;287;15;2;270;0;0;0
181400020;900;938;942;7;394;504;2;394;8;2;384;0;0;0
181400021;100;55;55;4;47;52;1;47;4;1;42;0;0;0
181400022;300;355;358;6;137;162;1;137;2;3;132;0;0;0
181400023;1000;1078;1093;6;377;622;1;377;8;14;355;0;0;0
181400024;600;615;625;11;219;407;1;192;8;10;174;27;1;26
181400025;750;761;781;7;292;486;1;263;11;5;247;29;0;29
181400026;300;337;337;4;140;158;2;140;10;3;127;0;0;0
181400027;300;305;308;4;167;132;1;167;7;3;157;0;0;0
181400028;1000;963;982;7;347;663;4;333;3;2;328;14;0;14
181400029;1000;958;967;9;384;617;1;382;9;4;369;2;0;2
181400030;400;384;385;5;146;253;1;146;5;3;138;0;0;0
181400031;400;368;369;7;94;304;2;94;1;1;92;0;0;0
181400032;850;868;869;4;205;665;2;183;8;2;173;22;2;20
181400033;500;532;535;10;210;300;1;199;3;7;189;11;0;11
181400034;400;432;433;6;157;261;1;138;1;1;136;19;0;19
181400035;1100;1132;1135;8;447;652;1;447;7;4;436;0;0;0
181400036;300;316;317;9;143;156;1;143;4;1;138;0;0;0
181400037;100;26;26;4;29;71;0;29;0;0;29;0;0;0
181400038;100;41;41;8;49;51;0;49;2;0;47;0;0;0
181400039;100;30;30;7;37;63;0;37;1;0;36;0;0;0
181400040;100;17;17;6;22;78;0;22;0;1;21;0;0;0
181400041;100;26;26;33;49;50;1;49;2;1;46;0;0;0
181600001;700;829;854;6;367;367;1;332;10;9;313;35;1;34
181600002;700;810;822;4;276;449;1;250;8;1;241;26;2;24
181600003;700;808;823;7;225;485;1;214;6;7;201;11;0;11
181600004;600;676;692;8;182;429;1;170;5;3;162;12;0;12
181600005;400;361;374;4;149;252;1;147;3;2;142;2;0;2
181600006;300;373;374;5;158;148;1;151;5;4;142;7;0;7
181600007;400;470;470;5;200;201;1;198;3;2;193;2;0;2
181600008;500;575;592;4;242;257;1;242;5;6;231;0;0;0
181600009;200;241;242;3;104;95;1;104;3;2;99;0;0;0
181600010;700;739;744;4;212;539;1;160;2;2;156;52;4;48
181600011;800;880;891;5;266;610;1;189;5;8;176;77;3;74
181600012;800;918;918;7;197;668;1;131;3;6;122;66;5;61
181600013;900;933;941;2;210;759;1;140;9;3;128;70;2;68
181600014;800;867;873;3;237;629;2;169;1;4;164;68;3;65
181600015;700;708;714;3;209;557;2;141;7;1;133;68;4;64
181600016;800;781;788;4;241;636;1;163;2;0;161;78;1;77
181600017;700;725;732;5;232;543;1;156;1;3;152;76;3;73
181600018;800;970;970;6;237;594;1;205;8;2;195;32;7;25
181600019;300;338;338;3;121;191;4;105;3;4;98;16;2;14
181600020;800;866;866;7;357;467;1;332;4;2;326;25;2;23
181600021;600;638;638;8;155;448;1;151;5;0;146;4;0;4
181600022;500;509;509;9;133;366;1;133;5;0;128;0;0;0
181600023;1000;1081;1097;5;325;704;1;295;13;7;275;30;1;29
181600024;700;727;756;5;276;462;1;237;3;6;228;39;3;36
181600025;700;715;715;6;248;479;2;219;10;2;207;29;0;29
181600026;200;144;156;5;97;102;1;97;0;0;97;0;0;0
181600027;300;351;351;7;160;161;1;138;4;6;128;22;2;20
181600028;300;274;275;5;73;226;1;73;1;4;68;0;0;0
181600029;100;32;32;16;31;68;1;31;1;0;30;0;0;0
181600030;100;26;26;7;26;73;1;26;0;0;26;0;0;0
181600031;100;36;36;3;37;62;1;37;0;0;37;0;0;0
181600032;100;26;26;1;27;72;1;27;0;0;27;0;0;0
181600033;100;13;13;1;14;85;1;14;1;0;13;0;0;0
181600034;100;16;16;2;17;82;1;17;0;0;17;0;0;0
181600035;100;42;42;7;46;53;1;46;1;2;43;0;0;0
181600036;100;46;46;2;47;51;2;47;0;0;47;0;0;0
181600037;100;40;40;2;41;58;1;41;0;1;40;0;0;0
181600038;100;14;14;2;16;83;1;16;0;0;16;0;0;0
181600039;100;11;11;3;12;87;1;12;0;0;12;0;0;0
181700001;800;979;980;6;337;476;1;323;3;2;318;14;0;14
181700002;900;1455;1477;5;429;472;2;426;10;4;412;3;0;3
181700003;400;363;363;2;119;286;1;113;6;0;107;6;1;5
181700004;400;436;440;4;204;195;1;204;3;2;199;0;0;0
181700005;500;511;513;4;228;271;1;228;4;4;220;0;0;0
181700006;200;203;203;6;63;136;1;63;2;0;61;0;0;0
181700007;800;850;850;4;282;565;1;234;7;4;223;48;3;45
181700008;600;555;557;3;223;434;1;165;10;6;149;58;2;56
181700009;700;712;716;2;275;500;2;198;4;10;184;77;5;72
181700010;600;675;688;3;264;342;1;257;5;3;249;7;0;7
181700011;200;203;203;3;123;76;1;123;3;2;118;0;0;0
181700012;250;256;256;5;82;167;1;82;5;2;75;0;0;0
181700013;500;467;467;6;204;379;1;120;0;1;119;84;4;80
181700014;900;961;961;5;368;563;1;336;17;5;314;32;1;31
181700015;350;358;358;6;161;188;1;161;11;0;150;0;0;0
181700016;600;648;648;2;197;432;1;167;9;1;157;30;0;30
181700017;150;165;165;5;96;53;1;96;5;2;89;0;0;0
181700018;400;429;432;5;183;233;1;166;9;7;150;17;1;16
181700019;50;12;12;2;14;35;1;14;0;0;14;0;0;0
181700020;50;11;11;7;18;31;1;18;0;1;17;0;0;0
181700021;50;16;16;0;15;35;0;15;0;0;15;0;0;0
181700022;50;22;22;4;25;25;0;25;0;0;25;0;0;0
181700023;50;13;13;0;13;37;0;13;0;0;13;0;0;0
182600001;200;150;150;3;62;137;1;62;1;1;60;0;0;0
182600002;400;428;429;5;167;261;1;138;3;6;129;29;0;29
182600003;700;733;733;7;250;460;1;239;2;20;217;11;0;11
182600004;700;712;714;7;236;578;1;121;3;5;113;115;6;109
182600005;600;640;640;1;248;393;1;206;18;11;177;42;2;40
182600006;900;1077;1077;10;221;698;1;201;5;3;193;20;0;20
182600007;900;977;978;7;242;671;4;225;7;6;212;17;0;17
182600008;900;1047;1047;9;243;679;1;220;4;9;207;23;4;19
182600009;800;839;839;6;155;664;1;135;7;6;122;20;3;17
182600010;500;541;541;8;171;358;1;141;6;0;135;30;0;30
182600011;1000;1430;1430;6;293;782;1;217;7;1;209;76;2;74
182600012;300;261;263;9;76;223;1;76;1;2;73;0;0;0
182600013;600;654;654;9;214;436;1;163;8;2;153;51;5;46
182600014;100;87;87;8;58;41;1;58;0;3;55;0;0;0
182600015;200;183;184;4;111;87;2;111;2;5;104;0;0;0
182600016;300;252;255;3;114;185;1;114;1;6;107;0;0;0
182600017;200;115;115;6;56;142;2;56;4;2;50;0;0;0
182600018;400;416;417;7;110;292;1;107;2;2;103;3;0;3
182600019;900;1050;1054;7;232;695;1;204;6;7;191;28;0;28
182600020;800;872;873;5;177;636;2;162;6;1;155;15;1;14
182600021;1000;963;963;5;185;837;1;162;0;1;161;23;1;22
182600022;900;979;981;3;175;779;2;119;1;4;114;56;3;53
182600023;1000;1104;1107;7;133;919;1;80;5;2;73;53;2;51
182600024;400;402;404;4;184;232;1;167;9;4;154;17;1;16
182600025;300;224;224;5;132;167;1;132;0;8;124;0;0;0
182600026;100;50;50;8;29;70;1;29;1;1;27;0;0;0
182600027;800;795;795;3;387;412;1;387;10;3;374;0;0;0
182600028;800;844;847;4;224;577;1;222;1;3;218;2;0;2
182600029;900;899;901;3;356;550;1;349;31;0;318;7;1;6
182600030;800;860;863;10;279;644;1;155;3;5;147;124;6;118
182600031;900;907;909;10;270;759;2;139;4;9;126;131;10;121
182600032;1000;1084;1086;5;329;838;2;160;5;4;151;169;18;151
182600033;800;866;869;6;324;633;2;165;1;4;160;159;8;151
182600034;800;813;816;5;282;657;1;142;6;4;132;140;3;137
182600035;800;932;932;4;339;637;1;162;3;4;155;177;8;169
182600036;800;853;857;8;330;644;1;155;2;9;144;175;5;170
182600037;800;849;854;5;351;643;1;156;3;7;146;195;10;185
182600038;800;821;823;8;340;640;1;159;2;5;152;181;9;172
182600039;900;926;927;7;277;753;1;146;1;7;138;131;8;123
182600040;900;945;947;6;322;670;2;228;5;11;212;94;4;90
182600041;800;850;852;9;257;648;1;151;3;4;144;106;6;100
182600042;800;794;795;9;297;626;1;173;6;3;164;124;8;116
182600043;800;792;794;7;272;648;1;151;1;7;143;121;7;114
182600044;800;792;794;5;293;662;1;137;5;7;125;156;4;152
182600045;800;758;760;8;274;615;1;184;5;6;173;90;1;86
182600046;800;786;788;7;279;640;1;159;2;3;154;120;12;108
182600047;900;908;911;10;307;739;2;159;6;6;147;148;5;143
182600048;900;904;905;7;290;744;2;154;2;6;146;136;8;128
182600049;900;968;974;8;311;738;1;161;2;3;156;150;15;135
182600050;900;984;987;8;268;766;1;133;0;7;126;135;5;130
182600051;900;911;915;9;333;729;1;170;2;12;156;163;19;144
182600052;900;970;973;10;275;761;1;138;2;5;131;137;2;135
182600053;1000;1050;1050;8;78;945;2;53;1;4;48;25;3;22
182600054;900;966;966;10;170;797;1;102;4;1;97;68;4;64
182600055;900;890;894;8;235;778;2;120;2;7;111;115;4;111
182600056;1000;1002;1003;10;178;872;1;127;10;0;117;51;2;49
182600057;900;895;898;8;159;809;1;90;1;1;88;69;1;68
182600058;800;818;818;6;216;679;1;120;2;2;116;96;7;89
182600059;900;906;906;3;239;754;3;143;2;5;136;96;4;92
182600060;800;843;845;10;230;683;1;116;3;4;109;114;9;105
182600061;900;899;902;10;253;747;1;152;4;9;139;101;8;93
182600062;800;786;786;5;161;699;1;100;2;4;94;61;5;56
182600063;900;909;909;7;199;792;1;107;4;3;100;92;6;86
182600064;800;851;854;9;225;667;1;132;0;5;127;93;3;90
182600065;800;858;860;6;234;675;1;124;4;2;118;110;9;101
182600066;100;89;89;7;27;72;1;27;2;2;23;0;0;0
182600067;100;67;9;12;50;49;1;50;7;2;41;0;0;0
182600068;100;47;8;11;37;62;1;37;1;0;36;0;0;0
182600069;100;27;27;4;31;68;1;31;0;0;31;0;0;0
182600070;100;11;11;33;34;65;1;34;1;1;32;0;0;0
182900001;500;551;569;6;256;251;1;248;9;9;230;8;0;8
182900002;400;425;447;9;154;245;1;154;3;1;150;0;0;0
182900003;800;999;1021;6;387;417;2;381;21;2;358;6;2;4
182900004;500;512;533;9;168;335;1;164;2;1;161;4;0;4
182900005;300;347;352;3;152;151;2;147;0;1;146;5;0;5
182900006;300;273;273;3;179;120;1;179;3;0;176;0;0;0
182900007;800;961;961;6;271;533;1;266;7;0;259;5;0;5
182900008;400;436;449;4;147;281;3;116;7;0;109;31;0;31
182900009;400;426;426;7;124;275;1;124;5;0;119;0;0;0
182900010;500;679;708;8;282;252;2;246;6;2;238;36;1;35
182900011;400;389;407;11;146;263;2;135;1;1;133;11;0;11
182900012;100;56;56;6;36;63;1;36;0;1;35;0;0;0
182900013;400;395;411;6;157;247;1;152;0;0;152;5;0;5
182900014;400;368;400;8;192;232;1;167;7;2;158;25;0;25
182900015;800;1122;1191;12;377;426;1;373;2;2;369;4;0;4
182900016;800;894;924;3;327;474;1;325;4;1;320;2;0;2
182900017;30;22;22;0;20;9;1;20;0;0;20;0;0;0
182900018;40;35;35;0;35;3;2;35;0;0;35;0;0;0
182900019;50;43;43;0;42;8;0;42;2;0;40;0;0;0
182900020;30;19;19;0;19;10;1;19;0;0;19;0;0;0
182900021;20;13;13;3;16;3;1;16;0;0;16;0;0;0
182900022;40;28;28;0;28;11;1;28;0;0;28;0;0;0
182900023;30;17;17;0;15;14;1;15;0;0;15;0;0;0
182900024;40;32;32;0;31;8;1;31;3;0;28;0;0;0
182900025;120;98;98;0;98;21;1;98;5;0;93;0;0;0
183600001;500;912;937;9;251;257;1;242;2;5;235;9;1;8
183600002;400;688;692;6;210;206;1;193;3;2;188;17;0;17
183600003;500;747;758;5;190;328;2;170;6;1;163;20;1;19
183600004;200;163;163;7;64;135;1;64;4;2;58;0;0;0
183600005;400;463;476;0;165;258;1;141;0;4;137;24;0;24
183600006;500;650;671;2;234;301;1;198;9;2;187;36;1;35
183600007;500;671;698;4;271;241;1;258;8;9;241;13;0;13
183600008;500;875;899;1;280;225;1;274;4;8;262;6;0;6
183600009;500;815;829;4;356;181;1;318;10;9;299;38;0;38
183600010;100;96;96;1;94;6;0;94;0;1;93;0;0;0
183600011;100;39;39;2;41;59;0;41;0;0;41;0;0;0
190300001;600;577;578;3;183;485;2;113;2;5;106;70;4;66
190300002;600;553;553;1;219;468;1;131;6;3;122;88;9;79
190300003;700;686;686;1;188;569;2;129;7;5;117;59;3;56
190300004;100;103;103;2;27;72;1;27;0;2;25;0;0;0
190300005;200;162;162;2;92;107;1;92;3;3;86;0;0;0
190300006;700;685;686;3;122;577;1;122;5;0;117;0;0;0
190300007;500;450;450;3;101;400;1;99;5;1;93;2;0;2
190300008;400;351;352;4;164;262;1;137;7;4;126;27;1;26
190300009;700;710;711;5;188;514;1;185;7;5;173;3;0;3
190300010;500;461;461;4;225;282;1;217;8;1;208;8;0;8
190400001;300;381;383;1;107;234;2;64;3;1;60;43;1;42
190400002;600;633;634;3;184;500;1;99;8;2;89;85;3;82
190400003;600;573;574;4;129;515;1;84;0;2;82;45;1;44
190400004;800;751;756;6;260;658;2;140;3;2;135;120;6;114
190400005;800;805;815;8;274;674;1;125;5;2;118;149;4;145
190400006;900;961;964;6;115;806;1;93;18;0;75;22;1;21
190400007;900;881;881;6;251;760;1;139;4;5;130;112;6;106
190400008;600;620;623;5;194;496;1;103;3;2;98;91;1;90
190400009;500;487;487;3;153;419;1;80;5;0;75;73;5;68
190400010;600;588;591;4;195;511;1;88;0;1;87;107;1;106
190400011;500;574;577;3;164;402;1;97;2;2;93;67;3;64
190400012;200;15;15;70;73;126;1;73;2;0;71;0;0;0
190400013;200;43;4;12;49;150;1;49;8;1;40;0;0;0
190400014;200;228;228;1;99;100;1;99;5;3;91;0;0;0
190400015;200;180;180;5;89;110;1;89;3;2;84;0;0;0
190400016;100;31;31;6;28;70;2;28;0;0;28;0;0;0
190400017;700;692;695;2;238;474;1;225;10;1;214;13;0;13
190400018;500;540;540;1;206;324;1;175;6;2;167;31;0;31
190400019;300;284;284;5;114;184;2;114;5;1;108;0;0;0
190400020;400;420;420;2;133;304;1;95;2;1;92;38;3;35
190400021;200;171;172;4;60;139;1;60;2;2;56;0;0;0
190400022;300;293;293;2;94;205;1;94;2;4;88;0;0;0
190400023;300;289;289;2;103;196;1;103;2;3;98;0;0;0
190400024;500;464;465;1;178;367;1;132;10;1;121;46;0;46
190400025;200;189;195;5;38;160;2;38;4;0;34;0;0;0
190400026;100;26;26;0;25;74;1;25;0;0;25;0;0;0
190500001;600;585;586;0;241;408;1;191;8;3;180;50;3;47
190500002;700;662;667;7;355;487;1;212;11;2;199;143;4;139
190500003;800;757;760;3;334;519;1;280;19;1;260;54;4;50
190500004;700;629;629;4;188;551;2;147;5;1;141;41;1;40
190500005;800;809;816;5;222;593;1;206;9;2;195;16;0;16
190500006;1000;941;950;6;285;795;1;204;5;2;197;81;7;74
190500007;500;533;544;5;243;306;1;193;6;2;185;50;0;50
190500008;500;476;483;3;198;336;1;163;2;2;159;35;1;34
190500009;500;532;536;5;192;385;1;114;5;0;109;78;3;75
190500010;700;702;733;3;301;412;2;286;10;4;272;15;0;15
190500011;500;516;516;5;209;325;1;174;10;0;164;35;0;35
190500012;600;564;576;3;185;430;2;168;8;1;159;17;3;14
190500013;400;400;400;3;172;250;1;149;6;1;142;23;0;23
190500014;300;277;277;2;126;173;1;126;5;3;118;0;0;0
190500015;200;178;178;1;73;126;1;73;1;1;71;0;0;0
190500016;600;583;584;6;246;372;1;227;21;2;204;19;0;19
190500017;300;323;323;4;129;213;1;86;4;3;79;43;0;43
190500018;600;616;631;5;221;418;2;180;7;1;172;41;2;39
190500019;600;608;620;4;169;451;1;148;5;2;141;21;0;21
190500020;700;674;674;7;236;499;1;200;5;3;192;36;1;35
190500021;700;658;658;10;253;450;1;249;5;6;238;4;0;4
190500022;100;84;84;1;85;14;1;85;0;0;85;0;0;0
190500023;100;87;87;0;85;14;1;85;2;0;83;0;0;0
190800001;600;599;600;6;197;473;1;126;1;4;121;71;5;66
190800002;500;510;513;9;166;375;1;124;0;1;123;42;4;38
190800003;800;742;743;1;216;662;1;137;2;8;127;79;9;70
190800004;800;791;792;2;277;556;1;243;13;2;228;34;3;31
190800005;900;845;845;4;156;759;1;140;8;0;132;16;0;16
190800006;900;944;946;6;158;761;1;138;11;4;123;20;0;20
190800007;500;517;519;5;198;332;1;167;4;5;158;31;1;30
190800008;700;690;691;5;180;547;1;152;3;4;145;28;1;27
190800009;300;280;282;4;136;163;1;136;1;2;133;0;0;0
190800010;500;506;506;5;212;296;2;202;9;2;191;10;0;10
190800011;100;140;140;5;52;47;1;52;2;2;48;0;0;0
190800012;200;168;169;5;83;116;1;83;3;0;80;0;0;0
190800013;300;343;344;4;114;192;1;107;4;2;101;7;3;4
190800014;300;350;350;2;117;209;1;90;3;0;87;26;1;25
190800015;100;51;51;8;38;61;1;38;0;1;37;0;0;0
191300001;100;96;97;6;69;30;1;69;0;6;63;0;0;0
191300002;600;604;604;4;200;475;1;124;4;0;120;76;2;74
191300003;300;227;227;5;134;165;1;134;2;5;127;0;0;0
191300004;200;142;142;4;83;116;1;83;0;4;79;0;0;0
191300005;100;89;89;4;61;38;1;61;0;0;61;0;0;0
191300006;600;599;602;2;219;478;1;121;3;3;115;98;4;94
191300007;400;443;443;6;176;293;1;106;5;1;100;70;4;66
191300008;400;459;459;4;189;275;1;124;3;3;118;65;2;63
191300009;600;696;697;4;151;468;1;131;4;2;125;20;1;19
191300010;400;465;467;4;126;274;1;125;2;2;121;1;0;1
191300011;500;461;462;4;185;374;1;125;4;3;118;60;3;57
191300012;400;353;353;2;164;299;2;99;0;4;95;65;5;60
191300013;800;840;840;7;260;565;1;234;9;2;223;26;1;25
191300014;300;344;345;3;151;212;1;87;6;1;80;64;2;62
191300015;500;498;498;5;191;375;1;124;9;4;111;67;3;64
191300016;100;92;92;3;75;24;1;75;1;1;73;0;0;0
191300017;600;649;649;1;175;442;1;157;3;3;151;18;0;18
191300018;100;67;67;2;42;57;1;42;1;1;40;0;0;0
192700001;500;852;854;10;383;373;2;125;1;7;117;258;12;246
192700002;500;943;937;8;400;344;1;155;10;8;137;245;16;229
192700003;500;736;739;11;363;313;1;186;1;5;180;177;7;170
192700004;500;380;830;9;346;351;1;148;6;5;137;198;10;188
192700005;500;911;912;10;367;374;1;125;3;5;117;242;9;233
192700006;500;887;888;10;350;367;1;132;2;3;127;218;6;212
192700007;500;697;700;9;280;374;1;125;3;3;119;155;3;152
192700008;500;764;764;7;250;406;1;93;2;2;89;157;11;146
192700009;500;606;609;9;222;399;1;100;1;4;95;122;1;121
192700010;500;728;727;7;277;383;1;116;3;5;108;161;5;156
192700011;500;728;729;8;283;375;1;124;2;1;121;159;8;151
192700012;500;775;781;8;322;329;1;170;2;11;157;152;6;146
192700013;500;885;891;5;356;352;1;147;8;8;131;209;8;201
192700014;500;768;766;7;330;353;1;146;0;2;144;184;6;178
192700015;500;793;799;6;343;387;1;112;2;8;102;231;13;218
192700016;500;694;697;7;264;396;1;103;4;6;93;161;3;158
192700017;500;792;795;8;304;391;1;108;2;2;104;196;11;185
192700018;500;689;693;7;277;425;1;74;2;1;71;203;16;187
192700019;500;857;856;9;356;398;1;101;4;2;95;255;14;241
192700020;500;864;864;8;336;365;1;134;3;4;127;202;11;191
192700021;500;631;638;7;269;423;1;76;3;1;72;193;10;183
192700022;500;739;741;9;328;373;1;126;3;5;118;202;5;197
192700023;500;612;612;8;253;403;1;96;1;4;91;157;10;147
192700024;500;786;786;10;365;359;1;140;4;2;134;225;10;215
192700025;500;730;733;7;281;385;1;114;3;7;104;166;9;157
192700026;500;795;796;7;344;365;1;134;6;4;124;210;8;202
192700027;500;739;743;7;267;387;1;112;4;5;103;155;8;147
192700028;500;700;700;8;277;368;1;131;0;4;127;146;3;143
192700029;500;751;754;11;254;386;1;113;4;0;109;141;4;137
192700030;200;170;170;4;35;164;1;35;1;2;32;0;0;0
192700031;500;726;729;12;269;404;1;95;0;2;93;174;12;162
192700032;500;827;829;7;327;356;2;142;5;1;136;185;8;177
192700033;500;703;703;7;269;389;1;110;3;2;105;159;7;152
192700034;500;584;584;8;219;427;1;72;2;2;68;147;1;146
192700035;500;735;738;9;286;353;1;146;6;5;135;140;4;136
192700036;500;841;838;9;320;362;1;137;1;7;129;183;5;178
192700037;500;793;795;8;275;381;1;118;3;0;115;157;5;152
192700038;500;664;664;10;205;387;1;112;1;2;109;93;5;88
192700039;500;589;590;9;226;402;1;97;3;2;92;129;8;121
192700040;500;647;650;5;232;398;1;101;1;2;98;131;7;124
192700041;500;720;721;7;275;395;1;104;7;4;93;171;15;156
192700042;500;675;680;5;263;398;1;101;3;2;96;162;1;161
192700043;500;763;764;7;283;381;1;118;3;6;109;165;9;156
192700044;500;797;798;7;313;376;1;123;5;7;111;190;14;176
192700045;500;696;701;5;235;419;1;80;1;2;77;155;6;149
192700046;500;768;769;7;196;402;1;97;2;1;94;96;4;92
192700047;500;816;816;9;299;283;1;216;6;12;198;83;2;81
192700048;500;804;805;5;257;386;1;113;3;2;108;142;5;137
192700049;500;782;782;8;247;384;1;115;3;3;109;132;7;125
192700050;500;794;796;8;178;413;2;85;3;3;79;93;5;88
192700051;500;825;826;7;156;407;1;92;5;1;86;64;1;63
192700052;500;922;912;8;56;463;1;36;4;1;31;20;0;20
192700053;500;891;894;5;98;440;1;59;4;0;55;39;0;39
192700054;500;806;807;6;194;374;1;125;6;0;119;69;1;68
192700055;500;737;741;6;175;409;1;90;6;1;83;85;2;83
192700056;500;685;688;5;212;400;5;95;4;2;89;117;9;108
192700057;500;758;758;5;219;402;1;97;1;1;95;122;10;112
192700058;500;777;784;4;199;430;1;69;0;1;68;130;3;127
192700059;500;652;657;2;142;435;2;63;3;0;60;79;0;79
192700060;500;774;774;9;275;404;1;95;4;2;89;180;10;170
192700061;500;799;799;5;227;388;1;111;3;3;105;116;6;110
192700062;500;821;822;3;249;369;1;130;7;7;116;119;8;111
192700063;500;755;758;6;232;388;1;111;5;5;101;121;7;114
192700064;500;788;788;7;257;394;1;105;9;3;93;152;8;144
192700065;500;741;743;1;213;420;1;79;0;3;76;134;5;129
192700066;500;772;775;6;245;376;1;123;7;3;113;122;3;119
192700067;500;701;701;2;191;385;1;114;6;6;102;77;6;71
192700068;500;777;781;7;226;408;1;91;5;3;83;135;10;125
192700069;500;686;689;6;203;383;1;116;5;1;110;87;2;85
192700070;500;820;824;9;265;397;1;102;3;0;99;163;6;157
192700071;500;707;708;7;249;383;1;116;4;4;108;133;2;131
192700072;500;764;764;6;169;430;1;69;1;2;66;100;4;96
192700073;500;552;553;5;210;402;1;97;0;4;93;113;7;106
192700074;500;757;759;7;221;380;1;119;5;5;109;102;6;96
192700075;500;768;773;2;195;403;1;96;2;6;88;99;6;93
192700076;500;795;797;4;165;417;1;82;4;0;78;83;6;77
192700077;500;736;736;10;206;407;1;92;3;2;87;114;11;103
192700078;500;815;815;3;237;392;1;107;0;3;104;130;6;124
192700079;500;641;643;8;184;407;1;92;3;3;86;92;3;89
192700080;500;766;770;8;215;400;1;99;0;4;95;116;5;111
192700081;500;733;735;8;251;374;1;125;4;4;117;126;9;117
192700082;500;793;795;9;239;406;1;93;1;3;89;146;7;139
192700083;500;820;822;5;224;404;1;95;2;2;91;129;12;117
192700084;500;769;774;4;220;389;1;110;10;1;99;110;5;105
192700085;500;795;797;6;227;398;1;101;2;3;96;126;12;114
192700086;500;834;837;3;232;409;1;90;4;2;84;142;6;136
192700087;500;722;724;5;188;399;1;100;1;6;93;88;6;82
192700088;500;597;600;4;152;441;1;58;0;2;56;94;5;89
192700089;500;634;636;5;186;413;1;86;1;4;81;100;9;91
192700090;500;762;765;6;178;400;1;99;6;7;86;79;5;74
192700091;500;761;762;3;192;406;2;92;3;5;84;100;4;96
192700092;500;689;689;2;161;428;1;71;2;2;67;90;3;86
192700093;500;730;727;9;138;411;1;88;9;4;75;50;2;48
192700094;500;642;645;6;138;427;1;72;1;4;67;66;1;65
192700095;500;586;586;6;119;432;1;67;2;5;60;52;2;50
192700096;500;741;741;6;123;434;1;65;2;0;63;58;1;57
192700097;500;743;747;6;217;376;1;123;2;6;115;94;6;88
192700098;500;794;796;6;185;400;1;99;3;3;93;86;4;82
192700099;500;747;745;8;192;419;1;80;2;5;73;112;2;110
192700100;500;779;774;9;224;375;1;124;2;0;122;100;2;98
192700101;500;601;600;7;179;419;1;80;4;2;74;99;3;96
192700102;500;713;713;6;247;368;1;131;8;3;120;116;6;110
192700103;500;759;761;10;267;384;2;114;4;4;106;151;10;142
192700104;500;771;770;6;222;376;1;123;3;7;113;99;3;96
192700105;500;661;667;6;225;411;1;88;0;4;84;137;8;129
192700106;500;658;659;8;235;386;1;113;3;4;106;122;7;115
192700107;500;731;733;7;224;383;2;115;5;3;107;109;3;106
192700108;500;860;859;6;309;371;1;128;4;9;115;181;10;171
192700109;500;209;669;9;218;398;1;101;0;4;97;117;4;113
192700110;500;693;692;8;214;371;1;128;3;4;121;86;5;81
192700111;500;710;712;4;212;412;1;87;3;0;84;125;4;121
192700112;500;749;755;9;219;407;1;92;2;1;89;127;10;117
192700113;500;770;773;6;225;368;1;131;2;1;128;93;3;90
192700114;500;745;747;8;266;402;1;97;2;2;93;169;4;165
192700115;500;631;632;8;215;395;1;104;4;3;97;111;4;107
192700116;500;653;657;6;249;402;1;97;6;3;88;152;11;141
192700117;500;645;648;7;229;400;1;99;2;2;95;130;7;123
192700118;500;594;597;3;229;396;1;103;3;6;94;126;9;117
192700119;554;554;554;5;182;488;2;64;1;1;62;118;0;118
192700120;500;637;639;7;253;401;1;98;4;2;92;155;7;148
192700121;500;742;742;9;282;330;1;169;3;5;161;113;9;104
192700122;500;525;526;9;187;312;1;187;6;9;172;0;0;0
192700123;500;578;580;5;196;430;1;69;2;1;66;127;13;114
192700124;500;677;677;4;226;404;1;95;6;4;85;131;12;119
192700125;500;741;745;8;222;417;1;82;5;5;72;140;5;135
192700126;500;587;587;9;200;397;1;102;7;2;93;98;3;95
192700127;500;745;745;6;250;407;1;92;2;3;87;158;8;150
192700128;500;473;473;5;152;446;2;52;2;2;48;100;7;93
192700129;500;655;657;6;265;250;1;249;1;8;240;16;1;15
192700130;500;534;537;6;191;308;1;191;3;10;178;0;0;0
192700131;500;648;649;6;220;396;1;103;2;4;97;117;2;115
192700132;500;536;537;6;167;416;1;83;2;1;80;84;2;82
192700133;500;566;568;5;170;449;1;50;0;2;48;120;3;117
192700134;500;501;503;6;169;421;1;78;2;4;72;91;3;88
192700135;500;706;706;8;218;405;1;94;4;2;88;124;7;117
192700136;500;680;680;6;200;405;1;94;1;8;85;106;5;101
192700137;500;698;702;6;202;415;2;83;0;3;80;119;10;109
192700138;500;661;661;7;171;405;2;93;4;4;85;78;3;75
192700139;500;650;652;7;159;429;1;70;2;3;65;89;4;85
192700140;500;698;698;9;169;330;1;169;2;3;164;0;0;0
192700141;500;687;688;8;257;399;1;100;5;1;94;157;7;150
192700142;500;779;781;8;305;371;3;126;4;5;117;179;8;171
192700143;500;711;721;9;267;384;1;115;4;4;107;152;8;144
192700144;500;722;727;7;281;371;1;128;2;6;120;153;6;147
192700145;500;598;598;8;203;426;2;72;2;3;67;131;6;125
192700146;500;705;706;4;286;228;1;271;3;8;260;15;1;14
192700147;500;676;678;4;270;243;2;255;7;7;241;15;0;15
192700148;500;760;761;7;319;200;1;299;4;11;284;20;0;20
192700149;500;602;600;10;230;387;1;112;0;3;109;118;3;115
192700150;500;641;643;6;236;416;1;83;2;3;78;153;4;149
192700151;500;639;639;5;271;400;1;99;0;2;97;172;6;166
192700152;500;621;622;7;220;393;1;106;2;4;100;114;6;108
192700153;500;729;728;9;300;362;1;137;3;9;125;163;8;155
192700154;500;511;512;9;209;407;1;92;3;5;84;117;7;110
192700155;500;708;708;7;298;379;2;119;1;6;112;179;7;172
192700156;500;702;703;7;256;384;1;115;4;6;105;141;5;136
192700157;500;760;765;10;305;379;1;120;5;5;110;185;13;172
192700158;500;565;569;10;211;416;1;83;3;3;77;128;8;120
192700159;500;374;375;16;162;443;1;56;0;3;53;106;4;102
192700160;500;676;677;8;237;398;1;101;7;1;93;136;7;129
192700161;500;639;639;7;230;390;1;109;2;2;105;121;9;112
192700162;500;683;683;5;252;391;1;108;0;8;100;144;9;135
192700163;500;686;687;6;255;251;2;247;5;9;233;8;0;8
192700164;500;679;683;4;232;271;1;228;2;10;216;4;1;3
192700165;500;495;508;8;171;436;1;63;1;0;62;108;4;104
192700166;500;689;689;7;295;335;1;164;3;4;157;131;8;123
192700167;500;678;679;7;263;378;3;119;6;3;110;144;9;135
192700168;500;709;713;8;225;404;1;95;3;2;90;130;3;127
192700169;500;540;538;9;187;408;1;91;0;1;90;96;4;92
192700170;500;620;622;9;216;410;1;89;0;2;87;127;4;123
192700171;500;631;627;9;189;372;2;126;9;5;112;63;0;63
192700172;500;533;537;3;100;433;2;65;4;1;60;35;2;33
192700173;500;352;350;5;48;473;1;26;2;0;24;22;0;22
192700174;500;741;695;5;146;426;1;73;2;0;71;73;1;72
192700175;500;574;576;6;178;398;1;101;2;3;96;77;6;71
192700176;500;646;650;4;197;428;0;72;5;2;65;124;7;117
192700177;500;541;540;6;125;459;1;40;0;0;40;85;3;82
192700178;500;606;610;6;206;402;1;97;8;1;88;109;6;103
192700179;500;609;609;3;185;408;2;90;8;0;82;95;6;89
192700180;200;124;123;6;50;148;2;50;2;3;45;0;0;0
192700181;300;289;285;7;86;212;2;86;3;3;80;0;0;0
192700182;500;631;632;6;217;400;1;99;0;0;99;118;6;112
192700183;500;497;497;2;188;393;1;106;2;2;102;82;2;80
192700184;500;425;423;1;129;425;1;74;0;0;74;55;1;54
192700185;500;636;634;5;144;389;1;110;1;2;107;34;0;34
192700186;200;204;204;5;119;80;1;119;3;4;112;0;0;0
192700187;500;893;896;1;250;249;1;250;14;9;227;0;0;0
192700188;500;767;770;4;268;231;1;268;11;6;251;0;0;0
192700189;500;623;623;3;190;394;1;105;4;0;101;85;1;84
192700190;500;796;796;3;222;384;1;115;5;2;108;107;3;104
192700191;500;660;663;2;237;366;1;133;4;5;124;104;8;96
192700192;500;502;503;1;151;405;1;94;0;4;90;57;3;54
192700193;500;526;528;6;164;400;1;99;4;1;94;65;0;65
192700194;500;589;596;3;198;387;1;112;5;3;104;86;7;79
192700195;500;556;556;4;160;393;1;106;5;0;101;54;8;46
192700196;500;448;452;4;137;391;1;108;10;2;96;29;0;29
192700197;500;482;484;5;138;399;1;100;4;4;92;38;0;38
192700198;500;520;520;2;173;409;1;90;1;6;83;81;1;80
192700199;500;528;528;3;213;357;1;142;1;4;137;71;0;71
192700200;500;449;455;6;108;411;1;88;4;0;84;20;1;19
192700201;500;640;640;4;198;339;1;160;6;1;153;38;2;36
192700202;500;787;788;2;163;381;1;118;4;2;112;45;1;44
192700203;500;874;874;5;123;409;1;90;4;3;83;33;0;33
192700204;500;594;594;4;99;411;2;87;3;2;82;12;1;11
192700205;500;590;591;4;221;387;1;112;3;4;105;109;6;103
192700206;500;518;518;0;166;399;2;99;4;3;92;67;0;67
192700207;300;344;344;4;131;180;1;119;2;1;116;12;0;12
192700208;100;34;42;12;24;75;1;24;0;1;23;0;0;0
192700209;100;96;45;15;46;53;1;46;12;3;31;0;0;0
192700210;200;185;83;10;100;99;1;100;14;2;84;0;0;0
192700211;100;45;45;5;45;55;0;45;0;1;44;0;0;0
192700212;100;45;45;6;46;54;0;46;9;0;37;0;0;0
192700213;100;25;25;7;30;70;0;30;0;1;29;0;0;0
192700214;200;81;81;24;88;111;1;88;13;5;70;0;0;0
192700215;300;112;112;77;171;128;1;171;7;6;158;0;0;0
192700216;300;36;36;89;114;185;1;114;3;9;102;0;0;0
192700217;100;28;28;12;31;68;1;31;1;1;29;0;0;0
193300001;700;718;718;5;233;524;3;173;6;10;157;60;6;54
193300002;1000;993;995;6;251;817;1;182;4;4;174;69;2;67
193300003;800;724;725;3;157;673;1;126;11;2;113;31;2;29
193300004;700;696;696;2;146;553;1;146;7;0;139;0;0;0
193300005;700;667;667;4;222;558;2;140;4;2;134;82;3;79
193300006;800;800;800;1;236;592;1;207;10;1;196;29;0;29
193300007;500;498;498;5;220;293;1;206;8;3;195;14;1;13
193300008;700;692;692;3;284;429;1;270;3;3;264;14;0;14
193300009;700;717;719;7;234;498;1;201;9;3;189;33;2;31
193300010;900;886;887;4;210;692;1;207;17;0;190;3;0;3
193300011;800;818;819;4;306;505;1;294;17;4;273;12;1;11
193300012;300;335;338;1;150;202;1;97;3;8;86;53;2;51
193300013;300;261;261;3;137;162;1;137;7;3;127;0;0;0
193300014;300;371;371;3;150;194;1;105;2;4;99;45;2;43
193300015;400;424;425;3;174;270;1;129;4;3;122;45;3;42
193300016;300;327;327;6;130;188;1;111;6;2;103;19;1;18
193300017;100;44;44;5;37;62;1;37;1;0;36;0;0;0
193700001;500;564;565;0;243;306;1;193;7;2;184;50;3;47
193700002;500;735;736;3;191;353;1;146;10;3;133;45;4;41
193700003;500;318;318;0;112;408;1;91;4;2;85;21;2;19
193700004;500;627;632;0;306;249;1;250;10;2;238;56;1;55
193700005;800;708;712;2;357;494;1;305;15;1;289;50;3;47
193700006;500;270;270;4;128;363;9;128;8;1;119;0;0;0
193700007;200;131;132;0;74;125;1;74;5;2;67;0;0;0
193700008;100;65;66;7;39;60;1;39;1;1;37;0;0;0
193700009;500;578;581;3;204;310;2;188;8;0;180;16;0;16
193700010;300;211;211;3;81;218;1;81;2;1;78;0;0;0
193700011;100;9;9;0;9;91;0;9;1;0;8;0;0;0
200100201;400;495;514;1;251;207;1;192;9;6;177;59;0;59
200100202;400;448;488;3;209;190;1;209;3;10;196;0;0;0
200100203;300;249;271;4;112;187;1;112;2;4;106;0;0;0
200100204;300;348;353;4;141;177;1;122;8;0;114;19;2;17
200100205;400;380;381;4;150;256;1;143;12;0;131;7;0;7
200100206;100;35;39;3;26;73;1;26;2;0;24;0;0;0
200100207;100;31;32;6;28;70;2;28;1;0;27;0;0;0
200100208;100;42;43;7;31;68;1;31;0;0;31;0;0;0
200100209;300;348;350;3;128;178;1;121;5;0;116;7;0;7
200100210;100;41;41;1;39;60;1;39;1;0;38;0;0;0
200100211;100;46;46;1;44;55;1;44;5;1;38;0;0;0
200700301;700;747;757;2;272;474;2;224;3;2;219;48;2;46
200700302;700;769;794;2;279;467;1;232;4;5;223;47;5;42
200700303;200;160;166;7;97;102;1;97;0;1;96;0;0;0
200700304;600;597;603;6;250;352;3;245;8;2;235;5;0;5
200700305;400;366;371;6;190;222;2;176;1;4;171;14;0;14
200700306;500;544;560;8;245;259;1;240;9;7;224;5;0;5
200700307;300;318;318;5;111;200;1;99;3;0;96;12;0;12
200700308;400;360;360;5;160;254;1;145;4;1;140;15;0;15
200700309;300;334;334;4;126;205;1;94;1;2;91;32;0;32
200700310;400;405;415;6;192;216;2;182;6;2;174;10;0;10
200700311;600;674;674;6;301;308;1;291;9;4;278;10;0;10
200700312;400;430;443;6;175;242;1;157;5;1;151;18;0;18
200700313;500;566;575;10;293;237;3;260;9;5;246;33;1;32
200700314;400;402;408;4;183;230;1;169;2;6;161;14;0;14
200700315;200;194;194;7;85;114;1;85;2;6;77;0;0;0
200700316;500;557;586;7;245;262;1;237;3;0;234;8;0;8
200700317;200;155;157;5;67;132;1;67;2;3;62;0;0;0
200700318;500;571;571;4;289;216;1;283;3;0;280;6;0;6
200700319;100;60;60;7;37;62;1;37;2;0;35;0;0;0
200700320;400;351;366;5;171;246;1;153;2;1;150;18;0;18
200700321;100;123;124;6;55;44;1;55;2;0;53;0;0;0
200700322;300;316;323;5;169;139;1;160;3;1;156;9;0;9
200700323;800;830;834;6;203;648;1;151;8;0;143;52;3;49
200700324;800;764;780;4;298;537;1;262;11;4;247;36;4;32
200700325;300;350;351;1;160;149;2;149;1;2;146;11;0;11
200700326;200;134;134;1;133;65;2;133;1;0;132;0;0;0
200700327;200;119;119;3;118;81;1;118;0;0;118;0;0;0
201000401;600;692;695;5;259;414;2;184;1;4;179;75;2;73
201000402;300;381;383;7;166;182;1;117;2;1;114;49;1;48
201000403;900;1000;1004;3;310;675;1;224;6;4;214;86;6;80
201000404;700;724;727;6;281;526;2;172;5;1;166;109;8;101
201000405;600;634;639;4;238;430;1;169;2;5;162;69;2;67
201000406;1000;1171;1173;0;319;724;1;275;7;6;262;44;2;42
201000407;700;748;748;2;271;496;1;203;0;3;200;68;0;68
201000408;900;1000;1007;4;388;535;2;363;19;3;341;25;0;25
201000409;1000;1096;1096;8;399;635;2;363;12;3;348;36;1;35
201000410;900;919;921;5;413;486;1;413;5;2;406;0;0;0
201000411;500;526;527;8;223;290;1;209;7;2;200;14;0;14
201000412;100;16;16;38;48;51;1;48;1;1;46;0;0;0
201000413;900;888;891;6;336;563;1;336;4;5;327;0;0;0
201000414;700;707;707;6;295;404;1;295;3;4;288;0;0;0
201000415;400;382;382;7;157;261;1;138;2;3;133;19;3;16
201000416;300;269;269;5;125;174;1;125;4;0;121;0;0;0
201000417;600;659;661;7;170;443;1;156;4;3;149;14;0;14
201000418;800;737;737;11;279;549;1;250;1;2;247;29;0;29
201000419;700;712;712;6;251;454;1;245;2;1;242;6;0;6
201000420;100;39;39;6;30;69;1;30;0;0;30;0;0;0
201000421;500;509;511;5;208;313;1;186;4;4;178;22;4;18
201000422;300;299;300;5;124;175;1;124;2;0;122;0;0;0
201000423;1100;1184;1190;7;454;647;2;451;18;1;432;3;0;3
201000424;800;755;756;6;258;584;1;215;4;2;209;43;0;43
201000425;800;820;824;7;310;491;1;308;16;2;290;2;0;2
201000426;200;184;184;4;70;128;2;70;2;0;68;0;0;0
201000427;700;756;757;8;322;419;3;278;7;0;271;44;0;44
201000428;600;647;649;11;300;348;1;251;4;2;245;49;0;49
201000429;900;968;968;6;349;557;4;339;11;1;327;10;0;10
201000430;700;723;723;5;250;449;1;250;3;3;244;0;0;0
201000431;600;648;649;5;239;360;1;239;9;0;230;0;0;0
201000432;600;642;642;6;286;316;1;283;7;5;271;3;1;2
201000433;900;904;904;5;360;548;1;351;10;5;336;9;0;9
201000434;400;457;458;4;157;242;1;157;5;1;151;0;0;0
201000435;900;944;948;8;265;646;1;253;5;2;246;12;0;12
201000436;300;371;375;3;145;181;2;117;1;0;116;28;1;27
201000437;1000;1016;1016;3;366;638;1;361;6;8;347;5;0;5
201000438;800;818;821;3;325;500;1;299;9;3;287;26;3;23
201000439;600;671;671;4;257;372;1;227;6;8;213;30;1;29
201000440;800;813;813;6;211;600;1;199;0;0;199;12;1;11
201000441;600;644;645;8;178;420;2;178;5;0;173;0;0;0
201000442;1000;1039;1039;10;406;591;3;406;7;4;395;0;0;0
201000443;200;64;64;0;62;137;1;62;0;1;61;0;0;0
201500501;100;70;70;5;35;64;1;35;1;0;34;0;0;0
201500502;600;547;548;5;184;414;2;184;6;2;176;0;0;0
201500503;600;587;587;5;267;336;2;262;12;3;247;5;0;5
201500504;200;149;149;7;69;130;1;69;4;1;64;0;0;0
201500505;120;104;106;7;51;68;1;51;0;0;51;0;0;0
201500506;400;424;425;5;179;220;1;179;5;1;173;0;0;0
201500507;500;540;545;3;230;357;1;142;4;9;129;88;5;83
201500508;100;61;61;5;37;62;1;37;0;0;37;0;0;0
201500509;200;180;180;5;100;99;1;100;2;0;98;0;0;0
201500510;350;330;332;5;60;289;1;60;2;1;57;0;0;0
201500511;100;67;67;6;43;55;2;43;2;1;40;0;0;0
201500512;600;590;597;7;162;467;1;132;10;1;121;30;0;30
201500513;600;631;633;3;226;391;1;208;11;0;197;18;1;17
201500514;30;11;11;1;12;18;0;12;0;0;12;0;0;0
203100101;400;480;485;6;169;323;1;76;3;3;70;93;2;91
203100102;400;437;440;4;211;275;1;124;5;3;116;87;2;85
203100103;400;504;504;8;205;302;1;97;1;6;90;108;2;106
203100104;500;551;551;7;234;358;1;141;2;1;138;93;4;89
203100105;400;445;446;6;164;301;2;97;4;1;92;67;3;64
203100106;400;432;431;1;164;332;1;67;1;3;63;97;6;91
203100107;400;412;412;6;174;307;1;92;3;6;83;82;7;75
203100108;600;628;629;1;227;485;1;114;1;3;110;113;6;107
203100109;400;469;470;0;183;295;1;104;7;2;95;79;2;77
203100110;600;595;597;6;220;449;1;150;6;5;139;70;1;69
203100111;600;594;598;9;225;476;2;122;5;0;117;103;4;99
203100112;700;695;697;8;225;555;2;143;2;3;138;82;6;76
203100113;500;487;487;6;162;418;1;81;0;1;80;81;8;73
203100114;500;555;556;2;202;397;1;102;4;3;95;100;4;96
203100115;800;831;837;7;321;680;1;119;7;6;106;202;16;186
203100116;500;492;496;5;187;391;1;108;3;7;98;79;1;78
203100117;600;614;618;8;189;491;1;108;4;3;101;81;2;79
203100118;800;838;842;8;274;645;1;154;4;8;142;120;5;115
203100119;600;643;643;10;258;484;1;115;1;7;107;143;3;140
203100120;500;493;493;6;163;420;1;79;4;4;71;84;3;81
203100121;400;456;456;7;146;318;1;81;3;3;75;65;6;59
203100122;500;514;515;7;148;419;1;80;1;1;78;68;3;65
203100123;800;922;926;7;207;656;1;143;5;6;132;64;0;64
203100124;500;544;545;8;175;420;1;79;4;3;72;96;5;91
203100125;500;495;496;5;147;432;1;67;2;3;62;80;2;78
203100126;500;568;569;4;199;396;1;103;1;2;100;96;5;91
203100127;600;653;653;6;219;479;1;120;2;3;115;99;5;94
203100128;500;476;478;3;175;411;1;88;1;4;83;87;5;82
203100129;600;619;620;6;239;476;1;123;8;0;115;116;11;105
203100130;600;646;646;8;246;452;1;147;5;5;137;99;2;97
203100131;600;669;670;9;267;455;1;144;3;6;135;123;10;113
203100132;800;786;790;10;287;660;1;139;6;3;130;148;16;132
203100133;800;814;817;8;313;645;1;154;5;4;145;159;8;151
203100134;400;437;438;5;171;298;1;101;5;3;93;70;2;68
203100135;500;509;513;7;137;394;6;100;5;1;94;37;2;35
203100136;500;522;522;8;151;423;3;74;6;0;68;77;4;73
203100137;600;658;663;9;138;501;2;97;13;1;83;41;1;40
203100138;700;714;714;8;240;559;1;140;7;2;131;100;1;99
203100139;600;683;686;9;158;460;1;139;13;0;126;19;0;19
203100140;600;598;598;6;117;504;2;94;8;0;86;23;0;23
203100141;600;602;602;8;183;496;2;102;4;1;97;81;2;79
203100142;400;469;470;5;120;320;1;79;4;1;74;41;3;38
203100143;700;708;711;8;274;542;2;156;3;6;147;118;7;111
203100144;800;792;794;7;347;634;2;164;7;1;156;183;9;174
203100145;800;807;809;7;291;666;1;133;4;2;127;158;5;153
203100146;800;798;801;2;277;652;1;147;1;3;143;130;8;122
203100147;700;679;681;5;281;548;1;151;2;4;145;130;4;126
203100148;400;447;447;4;160;324;1;75;2;0;73;85;0;85
203100149;500;531;532;6;206;410;1;89;3;2;84;117;5;112
203100150;400;477;477;5;178;221;1;178;2;7;169;0;0;0
203100151;600;656;656;7;262;481;1;118;1;4;113;144;13;131
203100152;400;456;456;5;184;306;2;92;5;2;85;92;5;87
203100153;500;565;566;5;201;399;1;100;2;2;96;101;5;96
203100154;600;604;607;10;154;500;1;99;2;2;95;55;2;53
203100155;600;673;673;10;252;489;5;106;4;6;96;146;5;141
203100156;100;15;15;38;47;52;1;47;1;4;42;0;0;0
203100157;100;142;13;12;92;7;1;92;17;1;74;0;0;0
203100158;400;450;459;4;166;296;1;103;5;7;91;63;5;58
203100159;500;504;506;3;183;378;1;121;6;3;112;62;1;61
203100160;600;610;623;4;192;465;1;134;1;2;131;58;3;55
203100161;500;506;506;3;127;406;2;92;2;1;89;35;1;34
203100162;500;517;517;3;154;405;1;94;3;5;86;60;1;59
203100163;600;654;657;7;173;492;1;107;3;2;102;66;2;64
203100164;600;691;695;3;247;462;1;137;4;5;128;110;4;106
203100165;400;470;475;3;176;294;1;105;1;4;100;71;4;67
203100166;400;432;433;4;175;297;1;102;7;0;95;73;6;67
203100167;400;448;448;5;164;300;1;99;2;3;94;65;3;62
203100168;100;104;92;4;60;39;1;60;7;0;53;0;0;0
203100169;300;347;351;1;183;162;1;137;3;3;131;46;1;45
203100170;100;58;58;6;52;47;1;52;0;1;51;0;0;0
203100171;400;485;485;4;144;273;1;126;5;1;120;18;1;17
203100172;500;502;504;3;153;354;1;145;1;0;144;8;0;8
203100173;100;63;65;5;41;57;2;41;3;2;36;0;0;0
203100174;200;151;151;5;86;113;1;86;2;7;77;0;0;0
203100175;100;38;38;5;38;61;1;38;1;1;36;0;0;0
203100176;500;541;541;4;275;229;1;270;5;0;265;5;1;4
203100177;500;601;604;5;244;336;3;161;3;10;148;83;4;79
203100178;500;637;640;2;237;367;1;132;2;5;125;105;2;103
203100179;400;481;476;5;201;275;1;124;1;6;117;77;7;70
203100180;500;546;546;9;216;336;1;163;7;6;150;53;1;52
203100181;600;616;616;8;112;489;1;110;10;2;98;2;0;2
203100182;500;504;506;7;172;395;1;104;0;1;103;68;2;66
203100183;100;74;74;5;52;47;1;52;3;3;46;0;0;0
203100184;100;34;35;7;30;66;4;30;2;2;26;0;0;0
203100185;100;77;77;4;52;47;1;52;0;1;51;0;0;0
203100186;500;535;535;2;195;341;1;158;1;2;155;37;3;34
203100187;500;504;506;4;211;312;1;187;7;2;178;24;3;21
203100188;100;41;41;5;36;63;1;36;2;0;34;0;0;0
203100189;300;277;277;5;149;150;1;149;4;6;139;0;0;0
203100190;200;153;161;4;110;88;2;110;3;1;106;0;0;0
203100191;400;436;446;4;173;272;1;127;5;4;118;46;2;44
203100192;100;25;25;6;20;79;1;20;0;1;19;0;0;0
203100193;100;37;37;0;36;64;0;36;2;0;34;0;0;0
203100194;100;27;27;0;26;73;1;26;0;3;23;0;0;0
203200601;600;625;627;4;205;444;8;148;7;1;140;57;2;55
203200602;500;471;475;7;167;366;1;133;2;4;127;34;0;34
203200603;200;196;197;5;73;126;1;73;2;3;68;0;0;0
203200604;300;307;312;6;139;188;1;111;6;4;101;28;4;24
203200605;100;45;45;6;37;62;1;37;1;0;36;0;0;0
203200606;600;576;586;9;236;384;2;214;6;3;205;22;0;22
203200607;700;725;725;7;311;424;1;275;5;4;266;36;0;36
203200608;700;801;801;8;324;394;1;305;7;2;296;19;0;19
203200609;500;549;576;9;302;244;1;255;14;3;238;47;0;47
203200610;100;69;69;7;36;63;1;36;2;0;34;0;0;0
203200611;100;75;75;6;44;55;1;44;0;1;43;0;0;0
203200612;400;365;366;4;103;327;1;72;3;2;67;31;0;31
203200613;100;60;60;5;28;71;1;28;0;0;28;0;0;0
203200614;100;50;50;1;49;50;1;49;4;0;45;0;0;0
203400701;500;520;524;10;186;352;3;145;5;3;137;41;3;38
203400702;700;715;718;8;265;530;1;169;7;1;161;96;3;93
203400703;900;899;913;7;274;666;3;231;13;5;213;43;1;42
203400704;800;837;843;6;275;610;1;189;5;6;178;86;6;80
203400705;800;770;772;4;235;653;1;146;5;7;134;89;5;84
203400706;800;839;841;7;303;628;1;171;5;6;160;132;10;122
203400707;800;734;734;5;230;649;1;150;4;1;145;80;3;77
203400708;800;790;790;6;236;653;2;145;8;2;135;91;5;86
203400709;800;813;813;6;278;630;1;169;11;1;157;109;7;102
203400710;1000;1013;1013;8;298;754;1;245;10;1;234;53;0;53
203400711;400;415;419;2;172;257;1;142;3;1;138;30;0;30
203400712;500;513;517;7;183;352;3;145;10;1;134;38;2;36
203400713;900;904;909;4;284;622;1;277;11;4;262;7;0;7
203400714;100;31;31;7;22;77;1;22;0;0;22;0;0;0
203400715;600;563;564;2;164;435;1;164;5;1;158;0;0;0
203400716;300;257;257;5;126;173;1;126;3;2;121;0;0;0
203400717;300;282;282;3;111;188;1;111;3;2;106;0;0;0
203400718;300;374;374;2;164;187;1;112;5;3;104;52;1;51
203400719;400;424;424;3;200;212;3;185;5;2;178;15;0;15
203400720;200;216;218;10;76;123;1;76;1;0;75;0;0;0
203400721;100;60;61;8;41;58;1;41;1;0;40;0;0;0
203400722;400;466;466;4;211;196;1;203;6;1;196;8;0;8
203400723;700;748;749;5;402;310;1;389;26;6;357;13;0;13
203400724;400;375;380;6;163;238;1;161;5;2;154;2;0;2
203400725;100;27;27;7;16;83;1;16;0;0;16;0;0;0
203400726;100;36;36;7;28;70;2;28;0;0;28;0;0;0
203400727;100;17;17;19;22;76;2;22;0;0;22;0;0;0
203400728;100;50;50;0;49;50;1;49;0;0;49;0;0;0
211100001;200;105;105;5;64;135;1;64;4;0;60;0;0;0
211100003;800;845;845;5;160;663;5;132;4;0;128;28;0;28
211100004;900;919;921;3;230;669;1;230;38;2;190;0;0;0
211100005;900;891;894;6;166;733;1;166;28;0;138;0;0;0
211100006;800;805;806;5;157;642;1;157;27;1;129;0;0;0
211100007;100;17;17;6;10;89;1;10;0;1;9;0;0;0
211100008;300;300;293;7;95;204;1;95;2;5;88;0;0;0
211100010;300;375;376;7;119;203;1;96;3;3;90;23;0;23
211100011;600;672;672;1;182;498;1;101;2;2;97;81;3;78
211100012;700;726;727;8;219;558;1;141;6;2;133;78;3;75
211100013;800;798;798;8;242;634;1;165;10;6;149;77;1;76
211100014;900;904;906;2;203;746;1;153;16;1;136;50;1;49
211100015;700;737;737;0;181;576;1;123;4;2;117;58;1;57
211100016;900;911;911;1;202;701;1;198;22;4;172;4;0;4
211100017;700;743;743;5;240;459;1;240;8;1;231;0;0;0
211100018;200;108;108;9;60;139;1;60;1;3;56;0;0;0
211100019;700;678;679;4;206;522;11;167;10;5;152;39;2;37
211100020;200;192;192;6;95;104;1;95;4;3;88;0;0;0
211100021;300;261;261;6;96;203;1;96;7;1;88;0;0;0
211100022;300;318;318;10;107;192;1;107;4;0;103;0;0;0
211100023;400;412;412;1;111;292;2;106;8;0;98;5;0;5
211100025;600;639;639;8;177;433;1;166;12;2;152;11;0;11
211100026;400;414;414;8;123;281;1;118;6;2;110;5;0;5
211100027;900;958;958;6;387;556;1;343;19;3;321;44;2;42
211100028;300;210;210;7;54;245;1;54;2;0;52;0;0;0
211100029;900;937;937;7;245;682;1;217;8;1;208;28;0;28
211100030;1000;1048;1048;5;268;768;1;231;11;3;217;37;1;36
211100031;900;984;985;4;230;685;1;214;16;3;195;16;0;16
211100032;900;970;971;5;256;659;1;240;8;2;230;16;0;16
211100033;900;932;932;4;284;621;2;277;13;4;260;7;1;6
211600001;400;410;412;2;142;350;1;49;1;2;46;93;3;90
211600002;700;769;769;7;268;576;3;121;2;6;113;147;5;142
211600003;700;722;723;0;229;611;1;88;1;3;84;141;5;136
211600004;700;814;816;5;299;559;2;139;3;5;131;160;8;152
211600005;600;645;648;1;195;516;1;83;1;4;78;112;2;110
211600006;600;644;647;11;186;519;1;80;3;2;75;106;6;100
211600007;500;499;500;7;115;441;1;58;1;0;57;57;5;52
211600008;600;700;701;6;102;548;1;51;1;1;49;51;1;50
211600009;600;671;761;5;44;555;1;44;0;0;44;0;0;0
211600010;700;963;963;8;41;666;1;33;3;0;30;8;0;8
211600011;700;1040;1040;8;71;633;1;66;10;0;56;5;0;5
211600012;600;734;735;5;37;562;1;37;6;0;31;0;0;0
211600013;500;600;600;6;27;499;1;0;0;0;0;27;1;26
211600014;700;909;909;6;47;699;1;0;0;0;0;47;0;47
211600015;700;942;942;5;64;641;1;58;12;0;46;5;0;5
211600016;700;945;945;4;59;640;1;59;1;0;58;0;0;0
211600017;500;568;570;8;125;422;1;77;3;0;74;48;2;46
211600018;600;661;664;6;210;501;1;98;4;2;92;112;7;105
211600019;400;371;372;6;114;357;1;42;1;1;40;72;1;71
211600020;400;386;386;4;113;358;1;41;1;0;40;72;4;68
211600021;500;611;613;5;218;400;1;99;1;5;93;119;7;112
211600022;500;510;512;0;160;424;1;75;2;0;73;85;4;81
211600023;500;643;643;3;190;407;1;92;0;0;92;98;5;93
211600024;500;524;524;5;184;408;1;91;1;0;90;93;5;88
211600025;700;790;790;3;236;603;1;96;4;3;89;140;3;137
211600026;500;558;559;5;201;410;1;89;2;0;87;112;7;105
211600027;600;705;706;7;242;498;1;101;2;2;97;141;6;135
211600028;600;708;710;9;258;467;1;132;3;7;122;126;4;122
211600029;500;558;558;8;173;413;2;85;2;0;83;88;2;86
211600030;700;671;672;6;175;605;1;94;5;4;85;81;3;78
211600031;700;740;742;5;237;555;1;144;10;6;128;93;4;89
211600032;500;454;457;6;161;394;2;104;6;1;97;57;3;54
211600033;300;262;263;8;107;192;1;107;12;2;93;0;0;0
211600034;700;654;656;9;181;558;1;141;12;0;129;40;1;39
211600035;100;50;50;13;61;38;1;61;2;1;58;0;0;0
211600036;600;703;703;0;151;448;1;151;13;0;138;0;0;0
211600037;600;594;597;11;125;511;1;88;6;0;82;37;0;37
211600038;700;658;659;4;214;526;1;173;5;2;166;41;5;36
211600039;200;160;160;7;99;100;1;99;8;0;91;0;0;0
211600040;300;323;325;5;194;105;1;194;8;1;185;0;0;0
211600041;200;95;95;6;46;153;1;46;1;3;42;0;0;0
211600042;400;409;409;5;81;333;1;66;4;0;62;15;1;14
211600043;700;643;645;6;191;552;1;147;10;2;135;44;0;44
211600044;400;346;346;3;165;298;1;101;5;4;92;64;3;61
211600045;300;297;297;4;70;229;1;70;2;1;67;0;0;0
211600046;300;228;228;7;71;228;1;71;2;4;65;0;0;0
211600047;200;193;193;5;84;115;1;84;3;3;78;0;0;0
211600048;200;89;90;7;58;139;3;58;1;0;57;0;0;0
211600049;400;329;331;5;104;331;1;68;2;5;61;36;2;34
211600050;200;110;110;7;62;137;1;62;0;3;59;0;0;0
211600051;200;131;131;6;70;129;1;70;3;5;62;0;0;0
211600052;500;455;460;2;178;333;2;165;1;0;164;13;0;13
211600053;200;99;100;3;54;145;1;54;1;2;51;0;0;0
211600054;300;208;208;4;89;210;1;89;2;3;84;0;0;0
211600055;300;222;225;6;80;218;2;80;1;3;76;0;0;0
211600056;300;277;277;4;138;161;1;138;6;1;131;0;0;0
211600057;500;476;478;6;133;411;1;88;4;1;83;45;4;41
211600058;400;359;360;5;85;314;1;85;5;3;77;0;0;0
211600059;300;244;244;3;73;226;1;73;1;2;70;0;0;0
211600060;600;578;578;5;158;502;1;97;5;4;88;61;1;60
211600061;300;300;300;3;107;192;1;107;6;2;99;0;0;0
211600062;300;222;222;1;127;172;1;127;5;2;120;0;0;0
211600063;300;270;270;4;98;201;1;98;3;1;94;0;0;0
212000001;400;527;531;5;177;328;1;71;2;1;68;106;7;99
212000002;600;764;768;5;216;494;2;104;7;1;96;112;4;108
212000003;500;568;568;7;164;421;1;78;2;3;73;86;6;80
212000004;500;633;634;6;209;404;1;95;0;4;91;114;2;112
212000005;500;618;619;7;191;420;1;79;2;1;76;112;5;107
212000006;700;811;815;6;222;592;1;107;3;6;98;115;7;108
212000007;500;636;639;1;187;389;1;110;0;2;108;77;3;74
212000008;500;623;625;6;183;395;2;103;5;2;96;80;6;74
212000009;500;666;668;6;185;395;1;104;5;2;97;81;4;77
212000010;400;437;439;5;107;337;1;62;0;0;62;45;0;45
212000011;400;496;498;4;142;326;1;73;3;1;69;69;7;62
212000012;500;670;672;5;166;416;1;83;2;5;76;83;3;80
212000013;300;395;398;6;104;249;1;50;1;1;48;54;7;47
212000014;400;519;522;7;156;319;1;80;3;2;75;76;3;73
212000015;300;366;366;6;107;250;1;49;2;4;43;58;2;56
212000016;400;555;555;9;145;323;1;76;3;1;72;69;4;65
212000017;600;716;716;7;271;459;1;140;2;4;134;131;4;127
212000018;400;532;532;8;196;303;1;96;7;1;88;100;6;94
212000019;300;435;436;7;118;217;1;82;3;0;79;36;2;34
212000020;500;692;693;8;152;362;1;137;16;6;115;15;2;13
212000021;700;921;921;8;117;596;1;103;8;1;94;14;0;14
212000022;500;654;655;9;160;406;1;93;9;0;84;67;4;63
212000023;500;680;681;6;160;404;2;94;3;6;85;66;3;63
212000024;500;591;592;4;207;411;1;88;2;1;85;119;9;110
212000025;400;505;507;8;185;344;1;55;2;1;52;130;4;126
212000026;600;698;701;8;274;504;1;95;4;0;91;179;7;172
212000027;400;508;509;7;170;340;1;59;2;1;56;111;5;106
212000028;400;481;482;6;165;326;1;73;2;1;70;92;5;87
212000029;700;874;874;6;356;549;7;144;7;5;132;212;8;204
212000030;500;603;602;2;209;420;1;79;5;0;74;130;4;126
212000031;500;643;645;8;265;409;2;89;1;0;88;176;7;169
212000032;500;615;616;7;227;427;1;72;1;1;70;155;5;150
212000033;700;917;918;4;350;605;1;94;6;1;87;256;8;248
212000034;400;525;525;8;242;316;1;83;5;0;78;159;6;153
212000035;400;471;474;7;189;336;1;63;2;0;61;126;4;122
212000036;600;704;704;8;299;479;1;120;2;0;118;179;13;166
212000037;400;504;504;9;205;305;1;94;1;1;92;111;4;107
212000038;400;480;480;4;173;343;1;56;0;1;55;117;12;105
212000039;500;565;567;6;232;394;1;105;2;0;103;127;6;121
212000040;500;550;552;3;223;424;1;75;3;2;70;148;11;137
212000041;500;572;572;7;211;407;1;92;2;2;88;119;2;117
212000042;400;520;521;7;116;316;1;83;4;3;76;33;1;32
212000043;500;612;613;7;181;417;1;82;4;0;78;99;9;90
212000044;400;424;424;6;160;343;1;56;4;2;50;104;5;99
212000045;400;522;522;6;156;344;1;55;5;1;49;101;8;93
212000046;400;430;432;4;145;329;1;70;0;5;65;75;6;69
212000047;600;722;725;7;252;486;1;113;6;4;103;139;4;135
212000048;400;535;536;4;139;326;1;73;0;2;71;66;1;65
212000049;500;638;639;7;176;412;1;87;6;1;80;89;4;85
212000050;600;768;769;7;184;510;2;88;1;1;86;96;3;93
212000051;500;639;640;7;195;391;1;108;7;0;101;87;1;86
212000052;400;461;461;5;149;332;1;67;0;2;65;82;3;79
212000053;600;717;719;7;291;480;1;119;5;2;112;172;4;168
212000054;400;519;520;7;207;303;2;95;1;3;91;112;6;106
212000055;500;569;572;3;172;418;1;81;4;0;77;91;5;86
212000056;600;714;715;8;179;521;1;78;1;1;76;101;2;99
212000057;800;996;996;6;263;664;2;134;6;2;126;129;4;125
212000058;500;647;647;7;176;419;1;80;1;6;73;95;5;90
212000059;700;798;800;4;210;488;2;210;3;8;199;0;0;0
212000060;600;675;677;9;193;520;2;78;1;3;74;115;7;108
212000061;500;627;631;9;195;414;1;85;0;3;82;110;5;105
212000062;600;679;684;8;197;543;1;56;3;0;53;141;5;136
212000063;700;785;787;6;223;610;1;89;1;7;81;134;9;125
212000064;600;708;712;8;208;488;1;111;5;3;103;97;3;94
212000065;500;542;547;9;121;448;1;51;1;3;47;70;1;69
212000066;600;723;743;4;174;511;1;88;1;1;86;86;3;83
212000067;500;664;665;5;164;410;2;88;7;5;76;76;3;73
212000068;700;797;798;2;230;580;1;119;4;4;111;111;3;108
212000069;600;682;683;4;172;507;1;92;6;0;86;80;8;72
212000070;600;692;693;3;159;531;1;68;3;2;63;91;6;85
212000071;600;663;664;3;214;480;3;117;4;1;112;97;2;95
212000072;500;574;576;6;176;406;1;93;3;5;85;83;4;79
212000073;500;599;602;5;155;431;1;68;3;0;65;87;4;83
212000074;400;486;488;4;134;327;1;72;5;1;66;62;5;57
212000075;500;569;570;3;159;424;1;75;2;3;70;84;4;80
212000076;600;712;713;4;165;518;1;81;3;0;78;84;3;81
212000077;700;788;791;5;251;572;2;126;0;6;120;125;5;120
212000078;500;644;644;8;173;420;1;79;2;2;75;94;3;91
212000079;600;730;732;7;239;501;1;98;2;4;92;141;7;134
212000080;500;569;572;3;127;442;1;57;0;3;54;70;4;66
212000081;500;563;565;4;168;435;2;63;1;0;62;105;7;98
212000082;500;545;548;8;168;433;1;66;1;0;65;102;7;95
212000083;400;436;438;7;132;344;1;55;3;0;52;77;5;72
212000084;400;515;518;4;126;329;1;70;1;1;68;56;5;51
212000085;800;927;930;6;236;688;1;111;2;1;108;125;5;120
212000086;500;590;590;9;132;445;2;53;3;1;49;79;2;77
212000087;600;698;699;8;192;503;1;96;4;2;90;96;7;89
212000088;600;745;750;7;175;520;2;78;2;8;68;97;4;93
212000089;600;725;728;5;150;535;1;64;2;1;61;86;4;82
212000090;700;789;789;7;211;603;2;95;0;0;95;116;4;112
212000091;500;606;609;7;193;409;1;90;1;3;86;103;5;98
212000092;600;686;686;6;202;502;2;96;3;0;93;106;4;102
212000093;400;513;516;4;139;329;1;70;0;3;67;69;3;66
212000094;300;384;386;4;124;240;1;59;3;0;56;65;0;65
212000095;400;464;468;4;143;256;2;142;1;7;134;1;0;1
212000096;400;451;455;4;160;336;1;63;0;4;59;97;2;95
212000097;500;601;604;9;212;400;2;98;3;8;87;114;4;110
212000098;300;420;420;6;135;240;1;59;1;1;57;76;4;72
212000099;500;583;583;8;181;443;1;56;1;3;52;125;11;114
212000100;500;607;607;5;200;399;2;99;6;4;89;101;8;93
212000101;600;677;679;9;235;507;1;92;1;4;87;143;9;134
212000102;600;691;693;3;227;410;2;188;3;8;177;39;1;38
212000103;500;619;622;6;175;427;2;71;1;3;67;104;4;100
212000104;300;409;410;6;83;254;1;45;3;0;42;38;3;35
212000105;400;449;449;6;115;343;1;56;6;2;48;59;3;56
212000106;300;371;373;9;105;242;2;56;5;1;50;49;2;47
212000107;300;428;428;5;121;253;1;46;1;2;43;75;2;73
212000108;600;753;753;4;224;488;1;111;2;0;109;113;4;109
212000109;500;585;585;6;188;425;1;74;1;1;72;114;4;110
212000110;500;584;586;7;182;424;1;75;4;6;65;107;3;104
212000111;400;498;500;9;136;322;2;76;3;2;71;60;2;58
212000112;400;508;499;9;110;335;1;64;3;2;59;46;0;46
212000113;800;1038;1038;8;42;779;2;19;5;0;14;23;0;23
212000114;800;989;990;8;44;755;1;44;7;2;35;0;0;0
212000115;800;983;983;10;34;772;2;26;8;0;18;8;0;8
212000116;900;1110;1110;10;84;845;2;53;3;0;50;31;2;29
212000117;900;1133;1133;10;67;841;2;57;10;0;47;10;0;10
212000118;900;1081;1081;8;67;826;7;67;4;0;63;0;0;0
212000119;1100;1393;1398;7;77;1038;1;61;7;1;53;16;0;16
212000120;1100;1368;1370;7;71;1028;1;71;6;3;62;0;0;0
212000121;500;568;572;5;150;433;1;66;3;2;61;83;4;79
212000122;600;783;788;8;245;473;2;125;6;3;116;120;4;116
212000123;700;934;934;4;156;607;1;92;9;0;83;64;2;62
212000124;600;714;716;4;158;518;1;81;5;1;75;77;4;73
212000125;600;765;768;4;222;468;1;131;5;2;124;91;5;86
212000126;400;543;545;7;106;329;1;70;7;0;63;36;1;35
212000127;700;851;853;6;190;510;1;189;12;5;172;1;0;1
212000128;800;910;912;3;142;661;1;138;22;1;115;4;0;4
212000129;200;106;106;8;65;134;1;65;0;4;61;0;0;0
212000130;100;25;25;9;21;78;1;21;0;3;18;0;0;0
212000131;400;396;397;1;215;227;1;172;7;0;165;43;0;43
212000132;100;79;79;7;51;48;1;51;0;0;51;0;0;0
212000133;200;184;184;2;51;147;2;51;4;0;47;0;0;0
212000134;200;122;122;7;51;148;1;51;1;0;50;0;0;0
212000136;500;531;531;7;152;377;2;121;5;4;112;31;1;30
212000137;700;852;852;5;186;549;1;150;7;1;142;36;1;35
212000138;100;78;78;7;23;76;1;23;0;0;23;0;0;0
212000139;400;402;402;3;124;318;1;81;2;4;75;43;2;41
212000140;400;415;417;2;140;292;1;107;1;2;104;33;0;33
212000141;900;1115;1016;6;500;427;1;472;19;4;449;28;3;25
212000142;300;248;250;7;145;154;1;145;3;5;137;0;0;0
212000143;200;118;120;7;61;138;1;61;3;0;58;0;0;0
212000144;300;366;366;6;131;226;1;73;3;1;69;58;3;55
212000145;400;462;464;1;148;289;1;110;13;2;95;38;0;38
212000146;700;752;752;3;371;383;3;314;35;3;276;57;1;56
212000147;400;464;464;3;153;281;1;118;3;0;115;35;1;34
212000148;200;119;123;5;87;112;1;87;0;1;86;0;0;0
212000149;300;239;239;9;139;159;2;139;9;3;127;0;0;0
212000150;200;153;153;2;70;129;1;70;2;1;67;0;0;0
212000151;700;911;911;8;157;588;1;111;8;0;103;46;0;46
212000152;500;596;599;5;205;335;1;164;11;1;152;41;1;40
212000153;400;506;506;7;202;259;1;140;5;6;129;62;4;58
212000154;300;231;231;5;96;203;1;96;1;1;94;0;0;0
212000155;300;251;251;3;133;165;2;133;2;3;128;0;0;0
212000156;400;513;513;4;210;251;2;147;10;3;134;63;1;62
212000157;200;113;113;3;48;151;1;48;2;0;46;0;0;0
212000158;100;40;41;9;25;74;1;25;0;0;25;0;0;0
212000159;300;235;237;6;108;191;1;108;5;2;101;0;0;0
212000160;400;234;540;1;235;210;1;189;7;6;176;46;2;44
212000161;300;379;380;3;200;144;2;154;3;4;147;46;2;44
212000162;500;505;505;4;175;377;1;122;6;6;110;53;2;51
212000163;400;296;298;6;103;296;1;103;0;1;102;0;0;0
212000164;400;489;489;5;157;271;1;128;1;2;125;29;1;28
212000165;900;980;980;5;249;691;1;208;28;2;178;41;0;41
212000166;700;791;791;8;281;514;2;184;15;4;165;97;9;88
212000167;500;640;647;5;329;197;1;302;10;4;288;27;3;24
212000168;700;848;849;4;293;439;1;260;30;0;230;33;0;33
212000169;600;713;714;5;174;450;1;149;5;3;141;25;2;23
212000170;900;964;968;8;535;442;1;457;64;0;393;78;1;77
212000171;400;464;467;8;168;283;1;116;4;1;111;52;1;51
212000172;600;664;665;0;356;297;1;302;25;1;276;54;1;53
212000173;500;641;647;0;261;274;3;223;9;1;213;38;1;37
212000174;700;898;899;5;214;492;2;206;15;0;191;8;0;8
212000175;600;739;739;6;174;469;1;130;12;0;118;44;1;43
212000176;500;662;664;3;189;363;1;136;5;1;130;53;0;53
212000177;500;523;524;3;176;365;1;134;6;0;128;42;1;41
212000178;300;293;293;6;115;184;1;115;2;1;112;0;0;0
212000179;500;598;598;6;226;307;1;192;12;3;177;34;1;33
212000180;400;444;444;4;222;241;1;158;11;1;146;64;1;63
212000181;400;318;319;6;169;230;1;169;16;2;151;0;0;0
212000182;400;460;460;7;100;318;1;81;2;0;79;19;0;19
212000183;100;48;48;8;56;44;0;56;0;0;56;0;0;0
212000184;200;105;105;11;51;148;1;51;4;1;46;0;0;0
212000185;100;15;15;65;69;30;1;69;5;4;60;0;0;0
212000186;100;36;36;18;26;73;1;26;1;1;24;0;0;0
212000187;100;39;39;27;55;44;1;55;4;2;49;0;0;0
212400001;500;531;532;6;163;404;1;95;1;3;91;68;8;60
212400002;700;690;692;7;219;551;1;148;2;5;141;71;5;66
212400003;600;590;591;4;190;471;1;128;3;3;122;62;5;57
212400004;600;670;670;4;212;465;2;133;3;4;126;79;3;76
212400005;700;834;835;4;184;513;3;184;16;2;166;0;0;0
212400006;700;825;825;10;202;495;3;202;26;2;174;0;0;0
212400007;500;644;645;4;217;328;2;170;10;4;156;47;2;45
212400008;500;468;468;4;158;362;1;137;5;3;129;21;1;20
212400009;600;628;629;4;177;461;2;137;6;3;128;40;4;36
212400010;800;848;850;5;262;553;2;245;28;7;210;17;0;17
212400011;800;850;853;5;275;584;1;215;8;8;199;60;3;57
212400012;600;644;644;0;164;441;2;157;20;8;129;7;1;6
212400013;700;729;730;0;202;523;1;176;34;2;140;26;1;25
212400014;900;901;903;3;299;663;1;236;16;7;213;63;3;60
212400015;100;125;128;5;60;39;1;60;2;0;58;0;0;0
212400016;100;70;70;8;60;39;1;60;1;1;58;0;0;0
212400018;400;393;394;9;114;309;2;89;3;3;83;25;1;24
212400019;400;393;393;6;135;276;1;123;7;6;110;12;0;12
212400020;900;922;921;7;390;520;5;375;6;1;368;15;0;15
220200001;500;525;525;7;272;320;1;179;0;5;174;93;3;90
220200002;300;232;232;0;106;193;1;106;5;0;101;0;0;0
220200003;400;419;424;3;169;285;1;114;1;5;108;55;2;53
220200004;200;200;200;2;108;91;1;108;2;0;106;0;0;0
220200005;400;349;351;2;170;257;1;142;5;0;137;28;0;28
220200006;100;17;18;7;17;82;1;17;2;0;15;0;0;0
220200007;200;185;185;1;73;126;1;73;1;1;71;0;0;0
220200008;200;155;155;1;72;127;1;72;2;2;68;0;0;0
220200009;100;46;47;6;32;66;2;32;4;1;27;0;0;0
220200010;100;42;42;7;27;72;1;27;0;0;27;0;0;0
220200011;400;434;434;4;174;236;1;163;8;1;154;11;2;9
220200012;300;216;219;3;137;162;1;137;1;4;132;0;0;0
220200013;100;26;26;7;15;84;1;15;0;0;15;0;0;0
220200014;300;239;241;2;109;190;1;109;0;0;109;0;0;0
220200015;100;70;71;4;39;60;1;39;0;0;39;0;0;0
220200016;100;19;19;0;19;80;1;19;1;0;18;0;0;0
220200017;100;63;63;38;74;25;1;74;0;3;71;0;0;0
220500001;800;715;743;1;291;553;2;245;2;6;237;46;1;45
220500002;800;752;767;0;327;514;1;285;2;4;279;42;4;38
220500003;800;756;770;2;338;514;1;285;9;4;272;53;4;49
220500004;200;114;116;4;75;124;1;75;0;0;75;0;0;0
220500005;400;344;353;3;169;273;1;126;1;0;125;43;1;42
220500006;300;249;269;1;145;154;1;145;2;0;143;0;0;0
220500007;100;69;74;1;45;54;1;45;1;1;43;0;0;0
220500008;100;54;54;0;54;46;0;54;0;0;54;0;0;0
220500009;100;30;30;0;30;69;1;30;0;0;30;0;0;0
220900001;800;779;780;6;271;601;2;197;11;6;180;74;2;72
220900002;500;509;510;6;171;394;1;105;7;5;93;66;5;61
220900003;600;583;583;8;200;482;1;117;6;2;109;83;5;78
220900004;800;771;772;4;246;630;1;169;9;5;155;77;4;73
220900005;400;428;429;7;138;305;1;94;3;2;89;44;5;39
220900006;500;481;482;6;170;390;1;109;3;2;104;61;1;60
220900007;900;917;920;3;300;679;1;220;9;7;204;80;3;77
220900008;500;476;476;3;182;369;1;130;3;2;125;52;4;48
220900009;600;582;583;3;254;382;1;217;4;3;210;37;1;36
220900010;300;286;287;1;139;159;2;139;3;2;134;0;0;0
220900011;300;339;339;3;136;181;1;118;2;1;115;18;0;18
220900012;800;774;774;0;354;450;1;349;17;3;329;5;0;5
220900013;800;771;772;1;429;392;1;407;12;11;384;22;1;21
220900014;500;525;526;1;222;333;1;166;2;2;162;56;0;56
220900015;100;71;71;0;36;63;1;36;0;2;34;0;0;0
220900016;100;59;59;1;31;68;1;31;0;0;31;0;0;0
220900017;500;536;536;3;220;305;1;194;6;9;179;26;1;25
220900018;300;207;208;2;112;187;1;112;0;6;106;0;0;0
220900019;500;472;472;2;153;368;1;131;5;1;125;22;0;22
220900020;300;220;220;2;69;230;1;69;2;0;67;0;0;0
220900021;300;247;247;1;95;204;1;95;1;1;93;0;0;0
220900022;100;36;36;6;30;69;1;30;1;1;28;0;0;0
220900023;100;11;11;20;26;73;1;26;2;1;23;0;0;0
220900024;200;98;98;27;97;102;1;97;1;4;92;0;0;0
221000001;600;564;564;3;315;336;1;263;3;0;260;52;0;52
221000002;800;818;824;5;482;362;1;437;3;4;430;45;2;43
221000003;500;533;539;7;346;184;1;315;11;3;301;31;1;30
221000004;600;674;639;5;316;416;1;183;3;1;179;133;5;128
221000005;700;725;728;2;307;495;1;204;6;2;196;103;1;102
221000006;700;698;698;3;289;480;1;219;3;1;215;70;1;69
221000007;500;483;468;4;257;303;1;196;7;3;186;61;2;59
221000008;700;714;718;4;301;489;1;210;5;1;204;91;1;90
221000009;300;243;240;0;132;167;1;132;3;2;127;0;0;0
221000010;600;590;600;2;252;411;1;188;0;2;186;64;2;62
221000011;600;555;558;0;220;434;1;165;3;1;161;55;3;52
221000012;700;739;690;2;343;415;3;282;12;5;265;61;1;60
221000013;100;39;39;0;39;61;0;39;0;1;38;0;0;0
221100001;800;835;835;0;288;596;1;203;7;13;183;85;7;78
221100002;500;470;472;5;177;376;2;122;1;5;116;55;5;50
221100003;500;452;452;3;161;399;1;100;4;3;93;59;1;58
221100004;700;725;728;4;326;450;1;249;9;14;226;77;6;71
221100005;800;796;796;6;297;577;1;222;2;5;215;75;6;69
221100006;500;511;511;1;200;352;1;147;3;2;142;53;3;50
221100007;800;767;767;2;290;590;2;208;5;12;191;82;4;78
221100008;800;267;760;1;268;606;3;191;2;4;185;77;4;73
221100009;900;867;868;0;317;690;1;209;8;9;192;108;10;98
221100010;300;233;234;7;111;188;1;111;5;2;104;0;0;0
221100011;400;399;399;6;151;288;1;111;4;4;103;40;3;37
221100012;300;317;317;6;105;220;1;79;2;3;74;26;2;24
221100013;100;28;29;8;24;75;1;24;0;0;24;0;0;0
221100014;900;854;854;3;193;725;1;174;5;3;166;19;2;17
221100015;100;92;92;5;29;70;1;29;2;0;27;0;0;0
221100016;100;51;51;7;33;66;1;33;1;0;32;0;0;0
221100017;100;87;88;8;52;46;2;52;3;0;49;0;0;0
221100018;100;36;36;5;25;74;1;25;0;1;24;0;0;0
221100019;800;743;743;6;309;579;2;219;9;7;203;90;7;83
221100020;600;623;623;6;241;430;1;169;6;6;157;72;2;70
221100021;600;553;553;5;231;424;1;175;7;4;164;56;4;52
221600001;600;882;884;8;387;212;1;387;2;18;367;0;0;0
221600002;400;515;515;4;239;244;1;155;1;9;145;84;5;79
221600003;400;575;578;1;235;228;1;171;2;6;163;64;4;60
221600004;300;357;372;5;183;161;1;138;4;13;121;45;2;43
221600005;300;406;406;5;172;192;1;107;2;3;102;65;3;62
221600006;500;640;643;5;277;351;1;148;3;5;140;129;3;126
221600007;500;760;760;5;306;291;1;208;5;14;189;98;5;93
221600008;200;200;200;1;101;98;1;101;2;5;94;0;0;0
221600009;200;329;329;5;142;115;1;84;0;3;81;58;4;54
221600010;300;267;268;8;118;181;1;118;3;5;110;0;0;0
221600011;200;148;153;5;119;80;1;119;2;7;110;0;0;0
221600012;200;120;120;4;77;121;2;77;2;7;68;0;0;0
221600013;200;162;167;3;127;72;1;127;9;9;109;0;0;0
221600014;100;68;70;6;48;49;3;48;0;3;45;0;0;0
221600015;200;176;178;5;103;96;1;103;6;6;91;0;0;0
221600016;300;217;220;6;130;169;1;130;3;9;118;0;0;0
221600017;200;177;177;4;105;94;1;105;3;4;98;0;0;0
221600018;500;737;743;10;392;268;2;230;2;9;219;162;12;150
221600019;200;169;172;3;102;97;1;102;1;1;100;0;0;0
221600020;300;239;239;5;164;134;2;164;1;7;156;0;0;0
221600021;200;325;331;5;184;48;2;150;0;3;147;34;2;32
221600022;200;103;103;3;51;148;1;51;0;1;50;0;0;0
221600023;300;283;283;3;165;134;1;165;5;5;155;0;0;0
221600024;200;158;160;0;97;102;1;97;2;3;92;0;0;0
221600025;100;57;59;5;43;57;0;43;0;0;43;0;0;0
221600026;300;385;391;4;156;169;1;130;1;3;126;26;0;26
221600027;300;443;456;5;194;182;1;117;2;0;115;77;3;74
221600028;100;96;96;5;56;43;1;56;0;3;53;0;0;0
221600029;100;90;90;3;52;47;1;52;2;0;50;0;0;0
221600030;300;353;353;6;199;140;2;158;3;5;150;41;3;38
221600031;300;213;213;4;133;166;1;133;2;2;129;0;0;0
221600032;200;149;149;4;111;88;1;111;3;3;105;0;0;0
221600033;100;51;51;5;38;61;1;38;1;0;37;0;0;0
221600034;100;91;91;2;54;45;1;54;1;0;53;0;0;0
221600035;100;77;77;0;77;22;1;77;0;0;77;0;0;0
221600036;100;29;29;14;37;62;1;37;0;2;35;0;0;0
221800001;600;566;567;3;224;445;1;154;2;4;148;70;0;70
221800002;600;612;614;5;246;406;1;193;8;3;182;53;1;52
221800003;700;642;643;6;219;543;1;156;8;1;147;61;0;61
221800004;500;509;512;3;164;372;1;127;4;0;123;37;0;37
221800005;500;509;510;3;159;372;1;127;4;0;123;32;0;32
221800006;600;589;589;5;240;423;2;175;4;1;170;65;1;64
221800007;100;38;38;6;28;71;1;28;1;0;27;0;0;0
221800008;100;89;90;5;51;47;2;51;2;1;48;0;0;0
221800009;100;93;93;5;55;44;1;55;0;0;55;0;0;0
221800010;100;64;64;7;34;65;1;34;1;0;33;0;0;0
221800011;200;123;123;7;52;146;2;52;2;0;50;0;0;0
221800012;100;96;96;6;68;31;1;68;0;0;68;0;0;0
221800013;100;92;92;4;58;41;1;58;3;0;55;0;0;0
221800014;200;176;176;4;72;127;1;72;3;0;69;0;0;0
221800015;100;56;56;6;39;60;1;39;0;0;39;0;0;0
221800016;300;271;271;5;94;205;1;94;3;0;91;0;0;0
221800017;200;153;153;6;78;121;1;78;2;4;72;0;0;0
221800018;200;173;173;5;92;107;1;92;1;0;91;0;0;0
221800019;200;137;137;4;69;130;1;69;2;0;67;0;0;0
221800020;100;53;53;5;35;64;1;35;0;0;35;0;0;0
221800021;100;46;46;5;39;60;1;39;0;0;39;0;0;0
221800022;100;32;32;7;26;73;1;26;1;0;25;0;0;0
222700001;600;540;548;6;331;373;1;226;6;2;218;105;5;100
222700002;700;686;694;4;313;490;1;209;1;8;200;104;2;102
222700003;400;388;391;3;172;279;2;119;4;9;106;53;5;48
222700004;500;451;452;3;194;355;1;144;2;3;139;50;4;45
222700005;400;433;436;3;220;259;1;140;2;3;135;80;5;75
222700006;700;679;684;2;309;472;2;226;0;4;222;83;5;78
222700007;300;219;219;5;136;163;1;136;0;3;133;0;0;0
222700008;300;289;291;4;151;145;4;151;5;4;142;0;0;0
222700009;300;264;265;5;174;125;1;174;3;7;164;0;0;0
222700010;200;131;131;5;82;115;3;82;2;3;77;0;0;0
222700011;900;936;936;2;426;586;1;313;7;21;285;113;11;102
222700012;800;807;816;2;367;533;2;265;13;10;242;102;10;92
222700013;600;546;557;6;280;414;1;185;5;5;175;95;2;93
222700014;200;125;127;4;63;135;2;63;2;0;61;0;0;0
222700015;100;63;63;6;47;52;1;47;6;0;41;0;0;0
222700016;100;21;21;6;24;75;1;24;1;1;22;0;0;0
222700017;200;188;188;6;109;90;1;109;2;10;97;0;0;0
222700018;200;154;158;5;90;109;1;90;4;5;81;0;0;0
222700019;100;40;40;7;26;73;1;26;0;0;26;0;0;0
222700020;200;192;192;6;154;45;1;154;2;4;148;0;0;0
222700021;200;120;120;7;90;110;0;90;0;2;88;0;0;0
222700022;300;280;286;6;172;127;1;172;2;11;159;0;0;0
222700023;400;342;348;3;180;281;1;118;3;6;109;62;7;55
222700024;200;167;168;4;91;108;1;91;1;3;87;0;0;0
222700025;200;132;135;6;93;106;1;93;4;6;83;0;0;0
222700026;100;87;87;0;86;14;0;86;2;1;83;0;0;0
223100001;500;805;805;5;282;324;1;175;2;4;169;107;8;99
223100002;400;611;611;6;201;289;1;110;0;6;104;91;5;86
223100003;600;907;907;9;321;446;1;153;2;4;147;168;10;158
223100004;200;119;119;6;57;142;1;57;1;4;52;0;0;0
223100005;500;699;700;10;248;368;1;131;1;3;127;117;4;113
223100006;400;613;613;9;245;283;2;115;0;3;112;130;8;122
223100007;300;437;437;8;193;222;1;77;2;3;72;116;5;111
223100008;400;581;581;7;236;293;1;106;1;7;98;130;8;122
223100009;300;507;508;10;235;178;2;120;3;5;112;115;9;106
223100010;400;610;611;9;226;272;1;127;4;6;117;99;1;98
223100011;600;863;864;8;265;425;1;174;10;4;160;91;2;89
223100012;400;536;537;10;247;257;2;141;0;10;131;106;6;100
223100013;300;494;494;10;217;201;1;98;5;1;92;119;6;113
223100014;600;865;865;7;331;427;1;172;0;5;167;159;7;152
223100015;400;622;622;5;236;258;1;141;4;9;128;95;11;84
223100016;400;665;665;10;274;226;1;173;5;4;164;101;2;99
223100017;500;703;703;7;270;314;1;185;7;3;175;85;3;82
223100018;500;744;747;7;297;335;1;164;3;11;150;133;4;129
223100019;400;226;671;9;235;248;1;151;2;5;144;84;7;77
223100020;400;618;620;12;253;286;1;113;3;5;105;140;11;129
223100021;500;779;779;9;296;337;1;162;5;5;152;134;6;128
223100022;500;680;680;9;263;362;1;137;2;4;131;126;8;118
223100023;600;896;898;7;288;446;1;153;5;6;142;135;6;129
223100024;500;791;793;8;294;329;1;170;4;15;151;124;6;118
223100025;400;619;623;9;248;280;1;119;2;4;113;129;6;123
223100026;400;605;608;7;244;287;1;112;0;3;109;132;15;117
223100027;400;683;684;9;272;262;2;136;1;6;129;136;10;126
223100028;500;693;693;9;249;360;2;138;2;6;130;111;9;102
223100029;300;520;522;8;219;190;1;109;1;4;104;110;6;104
223100030;400;627;628;5;242;275;1;124;2;8;114;118;5;113
223100031;400;532;534;8;184;286;1;113;6;1;106;71;6;65
223100032;400;660;663;6;200;277;2;121;2;4;115;79;2;76
223100033;450;672;672;5;224;275;1;174;4;10;160;50;3;47
223100034;400;552;552;6;189;271;3;126;1;6;119;63;1;62
223100035;300;498;498;6;216;154;1;145;13;3;129;71;10;61
223100036;200;302;304;6;68;164;1;35;1;1;33;33;1;32
223100037;400;648;648;7;220;293;1;106;1;5;100;114;7;107
223100038;200;368;368;6;129;111;1;88;2;4;82;41;3;38
223100039;300;517;517;520;213;190;0;110;14;8;88;103;6;97
223100040;400;624;627;9;266;304;2;94;3;3;88;172;4;168
223100041;300;272;272;4;128;171;1;128;3;8;117;0;0;0
223100042;100;96;96;5;64;35;1;64;0;5;59;0;0;0
223100043;100;90;90;8;53;46;1;53;0;0;53;0;0;0
223100044;100;89;90;5;55;45;0;55;0;1;54;0;0;0
223100045;100;100;100;5;44;55;1;44;1;1;42;0;0;0
223100046;300;462;463;3;176;123;1;176;1;10;165;0;0;0
223100047;300;458;459;2;175;213;1;86;2;3;81;89;5;84
223100048;300;250;250;2;133;166;1;133;2;6;125;0;0;0
223100049;300;298;299;2;84;215;1;84;1;2;81;0;0;0
223100050;100;73;74;4;41;58;1;41;1;2;38;0;0;0
223100051;200;160;160;2;85;114;1;85;2;2;81;0;0;0
223100052;100;64;64;4;38;61;1;38;0;1;37;0;0;0
223100053;200;170;170;3;96;103;1;96;5;0;91;0;0;0
223100054;100;95;95;5;45;54;1;45;4;1;40;0;0;0
223100055;100;92;92;4;52;47;1;52;2;2;48;0;0;0
223100056;200;165;165;2;81;118;1;81;3;6;72;0;0;0
223100057;100;64;64;4;38;61;1;38;0;0;38;0;0;0
223100058;100;97;97;5;64;35;1;64;0;2;62;0;0;0
223100059;400;567;567;3;247;209;1;190;7;8;175;57;1;56
223100060;100;75;75;5;51;48;1;51;1;0;50;0;0;0
223100061;100;96;96;3;47;52;1;47;2;5;40;0;0;0
223100062;100;72;72;4;31;67;2;31;1;3;27;0;0;0
223100063;100;86;86;7;34;65;1;34;2;0;32;0;0;0
223100064;100;40;40;5;17;82;1;17;0;0;17;0;0;0
223100065;100;32;32;4;19;80;1;19;0;1;18;0;0;0
223100066;100;86;89;7;41;58;1;41;2;1;38;0;0;0
223100067;200;177;177;6;84;115;1;84;1;3;80;0;0;0
223100068;100;47;47;7;27;72;1;27;0;0;27;0;0;0
223100069;400;657;660;3;233;274;1;125;7;1;117;108;1;107
223100070;500;789;789;8;273;296;1;203;9;5;189;70;5;65
223100071;100;56;56;6;20;79;1;20;0;0;20;0;0;0
223100072;100;33;33;8;20;79;1;20;1;0;19;0;0;0
223100073;100;39;39;6;27;72;1;27;0;0;27;0;0;0
223100074;100;19;20;5;14;85;1;14;0;0;14;0;0;0
223100075;100;75;75;7;33;66;1;33;2;0;31;0;0;0
223100076;200;129;129;6;75;124;1;75;2;3;70;0;0;0
223100077;200;109;109;6;58;141;1;58;0;2;56;0;0;0
223100078;300;277;277;4;105;194;1;105;0;2;103;0;0;0
223100079;100;4;23;7;11;88;1;11;0;0;11;0;0;0
223100080;300;271;271;5;133;166;1;133;0;4;129;0;0;0
223100081;100;44;44;3;30;69;1;30;0;0;30;0;0;0
223100082;100;37;37;7;20;79;1;20;0;0;20;0;0;0
223100083;100;38;38;6;30;69;1;30;0;3;27;0;0;0
223100084;200;134;134;5;45;154;1;45;3;3;39;0;0;0
223100085;100;37;37;8;27;72;1;27;1;0;26;0;0;0
223100086;100;45;45;6;32;66;2;32;1;1;30;0;0;0
223100087;200;366;366;5;175;78;1;121;1;8;112;54;2;52
223100088;100;58;58;7;29;70;1;29;5;1;23;0;0;0
223100089;100;18;18;39;55;44;1;55;1;1;53;0;0;0
223800001;800;822;823;5;317;584;1;215;1;11;203;102;12;90
223800002;700;718;718;1;257;551;2;147;3;1;143;110;5;105
223800003;700;736;736;4;274;550;1;149;2;3;144;125;4;121
223800004;600;630;630;1;220;463;1;136;5;4;127;84;4;80
223800005;700;694;694;1;226;578;1;121;3;2;116;105;5;100
223800006;500;513;513;2;180;360;1;139;1;2;136;41;3;38
223800007;400;415;415;6;133;295;1;104;7;0;97;29;0;29
223800008;100;75;75;4;42;57;1;42;1;2;39;0;0;0
223800009;300;304;304;5;118;180;2;118;3;4;111;0;0;0
223800010;100;84;84;6;34;65;1;34;0;0;34;0;0;0
223800011;200;103;103;3;63;136;1;63;3;1;59;0;0;0
223800012;200;128;129;3;45;154;1;45;1;2;42;0;0;0
223800013;300;285;281;4;157;142;1;157;5;4;148;0;0;0
223800014;100;32;32;7;20;79;1;20;1;0;19;0;0;0
223800015;100;33;33;7;26;73;1;26;0;0;26;0;0;0
223800016;100;23;23;8;18;81;1;18;0;1;17;0;0;0
234602001;500;727;727;10;326;376;1;123;2;5;116;203;7;196
234602002;500;862;862;12;407;355;1;144;2;3;139;263;14;249
234602003;500;768;768;8;341;382;1;117;0;3;114;224;15;209
234602004;500;694;695;31;394;366;1;133;2;4;127;261;10;251
234602005;500;706;706;8;351;382;2;116;3;5;108;235;7;228
234602006;500;580;582;7;264;434;1;65;2;1;62;199;7;192
234602007;500;683;683;10;287;404;1;95;5;3;87;192;5;187
234602008;500;845;845;8;357;141;2;357;3;18;336;0;0;0
234602009;500;832;833;8;370;364;1;135;3;4;128;235;10;225
234602010;500;766;767;11;316;396;1;103;3;2;98;213;10;203
234602011;500;809;809;7;340;399;1;100;2;2;96;240;7;233
234602012;500;730;730;8;315;400;1;99;2;3;94;216;18;198
234602013;500;821;821;8;441;353;1;146;5;7;134;295;17;278
234602014;500;749;750;6;382;374;2;124;8;2;114;258;8;250
234602015;500;703;703;8;353;396;1;103;1;6;96;236;8;236
234602016;500;775;775;6;403;359;1;140;3;4;133;263;0;263
234602017;500;803;803;7;387;369;3;128;3;2;123;259;4;255
234602018;500;909;909;13;478;337;3;160;1;5;154;318;9;309
234602019;500;769;769;31;386;350;1;149;1;3;145;237;18;219
234602020;500;914;914;11;454;355;3;142;2;6;134;312;10;302
234602021;500;712;712;49;398;337;2;161;3;4;154;237;14;223
234602022;500;736;738;5;382;366;1;133;3;8;122;249;11;238
234602023;500;803;803;8;360;378;1;121;0;2;119;239;10;229
234602024;500;723;723;3;317;393;1;106;2;1;103;211;11;200
234602025;500;769;769;5;321;392;1;107;1;3;103;214;12;202
234602026;500;826;827;6;394;363;2;135;2;3;130;259;17;242
234602027;500;852;851;9;377;350;1;149;6;3;140;228;9;219
234602028;500;787;787;6;343;388;1;111;0;5;106;232;13;219
234602029;500;983;984;5;459;376;1;123;3;1;119;336;14;322
234602030;500;920;920;28;447;379;1;120;8;4;108;327;8;319
234602031;500;866;866;11;410;363;1;136;4;12;120;274;13;261
234602032;500;898;898;18;406;366;3;131;2;4;125;275;12;263
234602033;500;738;738;8;326;361;1;138;9;3;126;188;8;180
234602034;500;822;822;9;362;367;1;132;1;3;128;230;15;215
234602035;500;791;791;23;337;386;1;113;0;3;110;224;10;214
234602036;500;743;743;8;352;371;1;128;3;5;120;224;14;210
234602037;500;721;722;8;305;387;2;111;3;3;105;194;9;185
234602038;500;746;746;13;332;403;3;94;3;0;91;238;20;218
234602039;500;805;805;4;328;284;1;215;8;6;201;113;5;108
234602040;500;742;742;7;307;402;1;97;1;3;93;210;4;206
234602041;500;907;908;7;358;389;1;110;2;2;106;248;8;240
234602042;500;728;730;8;337;364;1;135;4;4;127;202;6;196
234602043;500;927;929;10;503;342;1;157;0;4;153;346;11;335
234602044;500;684;686;9;297;395;1;104;2;2;100;193;18;175
234602045;500;793;794;8;373;364;2;134;3;8;123;239;10;229
234602046;500;756;757;12;356;371;1;128;3;6;119;228;10;218
234602047;500;741;741;7;312;384;1;115;7;4;104;197;4;193
234602048;500;861;861;6;449;317;2;181;2;9;170;268;10;258
234602049;500;882;883;7;413;342;7;151;3;7;141;262;13;249
234602050;500;745;746;6;276;254;2;244;3;12;229;32;0;32
234602051;500;694;697;15;322;400;1;99;4;4;91;223;14;209
234602052;500;711;711;9;303;380;1;119;4;2;113;184;10;174
234602053;500;562;563;6;263;412;0;88;2;3;83;175;12;163
234602054;500;649;649;7;294;382;2;116;4;1;111;178;12;166
234602055;500;971;971;20;470;361;5;134;9;6;119;336;14;322
234602056;500;907;907;9;413;330;3;167;2;5;160;246;7;239
234602057;500;783;783;6;369;378;4;118;2;1;115;251;9;242
234602058;500;736;737;6;302;388;2;110;3;4;103;192;16;176
234602059;500;797;797;5;381;336;1;163;3;1;159;218;10;208
234602060;500;776;776;9;356;350;1;149;2;7;140;207;10;197
234602061;500;818;818;8;380;378;2;120;1;1;118;260;10;250
234602062;500;967;967;4;404;348;1;151;2;5;144;253;6;247
234602063;500;813;813;3;354;363;1;136;3;3;130;218;11;207
234602064;500;767;771;6;286;404;2;94;1;6;87;192;8;184
234602065;500;849;849;5;367;375;1;124;1;5;118;243;7;236
234602066;500;801;801;11;370;349;0;151;4;2;145;219;8;211
234602067;500;806;806;5;371;381;1;118;0;4;114;253;11;242
234602068;500;721;723;8;324;381;2;117;2;1;114;207;8;199
234602069;500;890;891;7;436;341;6;153;3;7;143;283;6;277
234602070;500;701;704;12;340;377;2;121;3;2;116;219;9;210
234602071;500;719;720;7;300;390;1;109;0;0;109;191;4;187
234602072;500;829;838;7;389;349;2;149;0;2;147;240;14;226
234602073;500;952;952;5;490;384;4;112;1;3;108;378;23;355
234602074;500;827;830;5;369;360;6;134;2;7;125;235;15;220
234602075;500;838;839;7;422;353;3;144;0;10;134;278;9;269
234602076;500;838;839;7;353;396;1;103;0;4;99;250;10;240
234602077;500;778;778;5;342;379;1;120;4;5;111;222;13;209
234602078;500;603;604;7;236;406;2;92;3;4;85;144;5;139
234602079;500;757;757;5;322;379;1;120;2;5;113;202;8;194
234602080;500;943;943;8;452;345;1;154;1;3;150;298;20;278
234602081;500;775;775;8;333;350;1;149;1;6;142;184;0;184
234602082;500;743;743;10;317;414;1;85;4;4;77;232;12;220
234602083;500;764;767;9;327;396;1;103;2;4;97;224;14;210
234602084;500;811;811;7;384;385;1;114;1;3;110;270;10;260
234602085;500;893;894;12;443;362;2;136;0;4;132;307;13;294
234602086;500;640;640;6;240;426;1;73;1;1;71;167;7;160
234602087;500;746;747;4;326;400;2;98;1;2;95;228;6;222
234602088;500;824;827;6;383;264;2;234;2;12;220;149;4;145
234602089;500;727;727;7;314;395;1;104;6;4;94;210;7;203
234602090;500;934;934;10;416;381;1;118;1;4;113;298;16;282
234602091;500;768;768;7;328;395;1;104;2;8;94;224;7;217
234602092;500;847;849;7;431;371;1;128;4;7;117;303;17;286
234602093;500;43;43;253;263;236;1;263;6;17;240;0;0;0
234602094;200;102;102;44;89;110;1;89;5;7;77;0;0;0
234602095;100;45;45;11;56;43;1;56;1;1;54;0;0;0
234608001;500;621;624;8;311;403;2;95;1;3;91;216;7;209
234608002;500;514;514;6;226;434;1;65;3;2;60;161;3;158
234608003;500;668;670;10;338;374;1;125;3;4;118;213;5;208
234608004;500;915;916;7;492;48;3;449;3;5;441;43;1;42
234608005;500;735;737;11;412;389;1;110;4;2;104;302;12;290
234608006;500;774;774;10;434;400;1;99;0;1;98;335;13;322
234608007;500;888;888;7;449;370;3;127;1;0;126;322;25;297
234608008;500;758;760;4;349;382;1;117;3;8;106;232;16;216
234608009;500;687;687;7;381;382;1;117;2;2;113;264;17;247
234608010;500;637;637;5;303;411;2;87;4;1;82;216;7;209
234608011;500;638;639;11;332;405;1;94;3;3;88;238;10;228
234608012;500;674;674;10;300;415;2;83;5;1;77;217;13;204
234608013;500;678;678;8;254;419;1;80;2;2;76;174;3;171
234608014;500;581;582;6;269;429;1;70;1;1;68;199;10;189
234608015;500;525;527;15;202;430;1;69;2;2;65;133;7;126
234608016;500;758;761;15;263;405;0;95;4;4;87;168;8;160
234608017;500;515;515;10;278;438;1;61;3;3;55;217;9;208
234608018;500;734;734;4;320;418;1;81;0;1;80;239;13;226
234608019;500;748;748;7;294;401;1;98;3;1;94;196;8;188
234608020;500;608;608;10;233;412;1;87;1;2;84;146;5;141
234608021;500;591;591;4;261;426;2;72;1;1;70;189;3;186
234608022;500;661;661;3;217;431;2;67;1;0;66;150;4;146
234608023;500;719;720;6;259;388;1;111;2;4;105;148;4;144
234608024;500;681;681;9;270;391;2;107;3;2;102;163;12;151
234608025;500;515;517;27;193;436;1;63;0;2;61;130;8;122
234608026;500;477;479;9;239;421;1;78;0;2;76;161;9;152
234608027;500;844;844;5;421;355;1;144;2;3;139;277;11;266
234608028;500;644;646;6;314;404;2;94;2;3;89;220;10;210
234608029;500;633;633;6;298;415;1;84;1;2;81;214;14;200
234608030;500;625;625;5;262;416;1;83;6;1;76;179;7;172
234608031;500;460;460;16;170;453;1;46;2;1;43;124;7;117
234608032;500;545;545;8;174;443;1;56;1;1;54;118;3;115
234608033;500;667;667;12;305;409;1;90;1;1;88;215;8;207
234608034;500;593;593;10;260;427;1;72;1;4;67;188;5;183
234608035;500;815;815;10;337;377;4;119;3;1;115;218;11;207
234608036;500;572;572;13;261;400;3;97;3;5;89;164;4;160
234608037;500;741;743;6;311;391;1;108;1;3;104;203;8;195
234608038;500;970;973;6;413;375;2;123;6;8;109;290;14;276
234608039;500;750;751;9;370;395;1;104;6;3;95;266;18;248
234608040;500;759;750;8;372;384;2;114;0;1;113;258;8;250
234608041;500;654;654;13;331;402;1;97;1;5;91;234;11;223
234608042;500;814;817;7;421;313;1;186;2;7;177;235;9;226
234608043;500;745;745;7;209;427;3;70;1;0;69;139;7;132
234608044;500;715;714;7;362;359;1;140;1;7;132;222;14;208
234608045;500;518;519;22;281;414;1;85;3;4;78;196;10;186
234608046;200;37;37;109;124;74;2;124;4;5;115;0;0;0
234608047;200;71;71;21;60;139;1;60;1;6;53;0;0;0
234608048;500;217;217;48;238;258;4;238;22;23;193;0;0;0
234608049;100;21;21;6;27;72;1;27;0;1;26;0;0;0
234609001;500;713;716;15;363;386;6;108;2;2;104;255;14;241
234609002;500;611;611;13;287;414;1;85;2;2;81;202;9;193
234609003;500;614;614;8;301;414;2;84;4;1;79;217;4;213
234609004;500;547;547;9;272;419;1;80;0;1;79;192;12;180
234609005;500;662;662;20;364;393;1;106;1;4;101;258;11;247
234609006;500;658;658;11;315;390;1;109;1;1;107;206;15;191
234609007;500;657;657;8;304;408;1;91;1;1;89;213;12;201
234609008;500;690;690;16;359;360;1;139;8;0;131;220;11;209
234609009;500;718;718;17;397;369;3;128;1;4;123;269;12;257
234609010;500;682;684;12;358;400;1;99;3;4;92;259;6;253
234609011;500;606;607;8;287;405;2;93;1;4;88;194;5;189
234609012;500;663;663;9;357;382;3;115;2;2;111;242;4;238
234609013;500;704;704;13;381;406;1;93;0;0;93;288;9;279
234609014;500;709;709;6;350;392;1;107;3;2;102;243;9;234
234609015;500;551;553;5;259;429;3;68;1;1;66;191;6;185
234609016;500;717;717;10;396;341;2;157;2;6;149;239;8;231
234609017;500;708;708;9;317;417;1;82;0;3;79;235;5;230
234609018;500;702;702;12;344;387;2;111;2;2;107;233;14;219
234609019;500;543;543;15;268;421;1;78;4;6;68;190;4;186
234609020;500;546;546;6;257;423;1;76;2;4;70;181;6;175
234609021;500;558;559;6;284;409;3;88;0;8;80;196;7;189
234609022;500;584;584;12;303;397;2;101;3;4;94;202;9;193
234609023;500;672;672;10;355;405;1;94;4;3;87;261;8;253
234609024;500;691;691;11;327;398;1;101;3;6;92;226;7;219
234609025;500;626;626;9;309;406;1;93;3;2;88;216;8;208
234609026;500;642;642;22;339;414;1;85;2;2;81;254;12;242
234609027;500;652;653;10;316;405;1;94;0;2;92;222;13;209
234609028;500;767;767;4;384;384;1;115;2;1;112;269;13;256
234609029;500;743;743;6;366;399;1;100;1;2;97;266;9;257
234609030;500;558;558;7;267;428;1;71;1;2;68;196;7;189
234609031;500;612;613;6;301;427;1;72;0;1;71;229;1;228
234609032;500;567;567;5;250;440;1;59;5;0;54;191;8;183
234609033;500;455;455;4;203;427;1;72;1;2;69;131;6;125
234609034;500;696;698;7;342;406;1;93;0;1;92;249;6;243
234609035;500;550;550;11;281;412;1;87;1;1;85;194;7;187
234609036;500;624;624;9;287;414;1;85;2;3;80;202;11;191
234609037;500;454;455;11;242;442;2;56;0;0;56;186;9;177
234609038;500;546;546;12;304;414;3;83;1;4;78;221;11;210
234609039;500;555;556;8;256;410;1;89;3;2;84;167;5;162
234609040;500;609;611;5;292;302;1;197;1;5;191;95;4;91
234609041;500;685;685;19;382;381;2;117;1;4;112;265;6;259
234609042;500;596;596;16;310;427;2;71;4;4;63;239;8;231
234609043;500;481;481;7;244;416;1;83;3;1;79;161;5;156
234609044;500;707;707;7;360;391;1;108;0;3;105;252;9;243
234609045;500;717;717;25;385;379;2;119;3;5;111;266;12;254
234609046;500;727;727;25;366;391;1;108;3;2;103;258;9;249
234609047;500;538;538;11;273;408;1;91;2;0;89;182;6;176
234609048;500;623;625;9;274;417;2;81;0;0;81;193;5;188
234609049;500;647;652;7;294;399;2;99;1;2;96;195;6;189
234609050;500;640;640;8;315;373;2;125;5;3;117;190;9;181
234609051;500;643;643;6;331;391;1;108;0;5;103;223;11;212
234609052;500;471;471;18;227;417;1;82;0;3;79;145;11;134
234609053;500;661;661;8;312;405;2;93;1;1;91;219;11;208
234609054;500;680;681;6;297;391;2;107;1;7;99;190;12;178
234609055;500;603;603;12;297;406;1;93;2;2;89;204;12;192
234609056;500;631;631;12;348;405;3;92;3;2;87;256;10;246
234609057;500;531;531;11;239;432;1;67;1;6;60;172;8;164
234609058;500;635;635;9;347;430;1;69;0;1;68;278;10;268
234609059;500;570;570;7;300;443;3;54;1;4;49;246;11;235
234609060;600;825;825;10;498;527;1;72;0;7;65;426;19;407
234609061;700;904;904;7;449;595;1;104;1;0;103;345;16;329
234609062;500;705;706;7;384;414;1;85;3;0;82;299;18;281
234609063;500;746;746;10;401;414;2;84;1;7;76;317;14;303
234609064;700;910;910;6;415;637;1;62;0;0;62;353;14;339
234609065;700;968;969;10;483;612;1;87;0;4;83;396;23;373
234609066;700;909;911;10;410;621;1;78;1;4;73;332;20;312
234609067;500;566;566;5;247;405;1;94;0;4;90;153;4;149
234609068;500;774;774;6;375;382;1;117;2;7;108;258;8;250
234609069;500;632;633;6;321;401;1;98;3;3;92;223;9;214
234609070;500;524;524;6;253;424;1;75;0;1;74;178;8;170
234609071;500;542;542;6;276;401;1;98;1;3;94;178;8;170
234609072;500;696;696;7;351;410;1;89;1;0;88;262;6;256
234609073;500;572;572;7;289;433;2;65;1;0;64;224;13;211
234609074;500;696;696;12;322;433;2;65;1;1;63;257;16;241
234609075;700;941;941;10;536;604;0;96;1;3;92;440;24;416
234609076;600;406;831;6;412;522;1;77;0;6;71;335;13;322
234609077;700;906;906;6;436;636;1;63;0;5;58;373;10;363
234609078;500;508;508;10;231;426;1;73;0;0;73;158;2;156
234609079;500;360;360;8;187;456;1;43;0;0;43;144;3;141
234609080;500;744;744;14;452;416;1;83;5;1;77;369;12;357
234609081;500;491;491;181;199;300;1;199;1;21;177;0;0;0
234609082;500;19;19;32;44;455;1;44;0;4;40;0;0;0
234610001;500;487;487;46;248;402;4;94;3;0;91;154;8;146
234610002;500;446;446;12;187;441;1;58;1;1;56;129;3;126
234610003;500;664;666;6;255;415;1;84;1;0;83;171;8;163
234610004;500;482;483;7;172;457;1;42;0;1;41;130;4;126
234610005;500;457;457;7;175;466;1;33;1;1;31;142;2;140
234610006;500;464;464;6;202;426;1;73;0;2;71;129;4;125
234610007;500;566;566;6;205;447;1;52;2;2;48;153;6;147
234610008;500;567;568;7;218;398;1;101;6;2;93;117;6;111
234610009;500;394;394;6;165;445;1;54;2;2;50;111;6;105
234610010;500;546;546;7;226;431;1;68;1;4;63;158;5;153
234610011;500;378;379;6;172;451;1;48;1;0;47;125;3;122
234610012;500;366;367;8;161;452;1;47;0;4;43;114;3;111
234610013;500;578;579;12;257;414;1;85;4;2;79;172;3;169
234610014;500;513;514;6;193;448;1;51;0;4;47;142;8;134
234610015;500;386;386;7;154;438;2;60;0;0;60;94;3;91
234610016;500;518;520;13;253;434;1;65;1;2;62;188;10;178
234610017;500;476;478;4;195;423;3;74;3;4;67;121;9;112
234610018;500;595;595;8;247;409;3;88;2;0;86;159;9;150
234610019;500;762;763;7;300;418;2;80;3;1;76;220;4;216
234610020;500;529;529;5;230;435;1;64;1;2;61;166;6;160
234610021;500;446;447;5;185;434;2;64;3;1;60;121;1;120
234610022;500;581;582;3;244;418;0;82;2;1;79;162;4;158
234610023;500;605;606;22;303;398;1;101;2;1;98;202;10;192
234610024;500;651;651;11;287;400;2;98;2;2;94;189;9;180
234610025;500;565;566;7;254;423;1;76;0;1;75;178;2;176
234610026;500;498;498;4;221;430;1;69;1;3;65;152;7;145
234610027;500;656;656;16;288;371;2;127;2;3;122;161;6;155
234610028;500;735;735;5;371;383;1;116;7;4;105;255;17;238
234610029;500;518;518;8;249;419;1;80;2;3;75;169;8;161
234610030;500;625;625;6;321;385;2;113;2;1;110;208;12;196
234610031;500;459;459;5;210;448;1;51;2;2;47;159;11;148
234610032;500;593;593;8;298;399;1;100;3;3;94;198;5;193
234610033;500;661;662;10;320;397;1;102;1;2;99;218;6;212
234610034;500;726;726;11;348;405;2;93;2;2;89;255;14;241
234610035;500;617;618;5;307;387;1;112;8;3;101;195;11;184
234610036;500;750;750;5;375;395;1;104;4;6;94;271;13;258
234610037;500;505;505;6;242;433;1;66;1;1;64;176;7;169
234610038;500;592;593;7;294;384;3;113;3;6;104;181;8;173
234610039;500;631;632;6;270;405;2;93;4;3;86;177;11;166
234610040;500;674;674;6;352;394;3;103;2;4;97;249;7;242
234610041;500;514;515;8;266;370;2;128;2;5;121;138;9;129
234610042;500;484;484;7;242;412;3;85;5;3;77;157;4;153
234610043;500;680;683;5;344;371;6;123;1;4;118;221;10;211
234610044;500;731;731;12;409;357;1;142;3;3;136;267;19;248
234610045;500;729;731;6;368;404;1;95;4;1;90;273;11;262
234610046;500;697;699;10;361;377;1;122;3;6;113;239;6;233
234610047;500;459;460;9;214;433;1;66;0;3;63;148;6;142
234610048;500;592;592;11;280;397;1;102;4;8;90;178;8;170
234610049;500;499;499;10;250;410;1;89;1;0;88;161;18;143
234610050;500;675;676;7;337;378;4;118;3;3;112;219;14;205
234610051;500;648;648;5;327;390;2;108;0;3;105;219;7;212
234610052;500;539;541;7;267;423;1;76;1;2;73;191;8;183
234610053;500;823;823;20;468;358;1;141;4;4;133;327;12;315
234610054;500;720;720;10;350;405;2;93;2;5;86;257;15;242
234610055;500;765;767;9;348;374;1;125;0;5;120;223;7;216
234610056;500;809;809;9;347;370;3;127;6;6;115;220;8;212
234610057;500;879;879;11;433;274;3;223;2;11;210;210;8;202
234610058;500;663;663;8;242;422;2;76;2;4;70;166;11;155
234610059;500;768;768;6;337;373;5;122;0;3;119;215;11;204
234610060;500;759;763;7;347;392;4;104;3;2;99;243;7;236
234610061;500;583;583;7;226;423;2;75;1;0;74;151;5;146
234610062;500;587;587;12;278;410;3;87;3;1;83;191;16;175
234610063;500;657;658;6;327;368;2;130;7;5;118;197;2;195
234610064;500;534;534;8;245;401;1;98;0;3;95;147;6;141
234610065;500;517;517;9;228;271;3;226;2;10;214;2;0;2
234610066;500;420;420;6;250;436;1;63;1;1;61;187;4;183
234610067;500;564;565;9;232;422;3;75;1;3;71;157;5;152
234610068;500;594;594;17;260;421;1;78;1;0;77;182;7;175
234610069;500;604;605;7;282;399;1;100;4;5;91;182;12;170
234610070;500;589;589;10;281;419;1;80;0;4;76;201;8;193
234610071;500;738;739;6;353;404;4;92;1;4;87;261;13;248
234610072;500;642;642;8;319;368;1;131;0;2;129;188;10;178
234610073;500;583;583;8;273;416;2;82;0;3;79;191;6;185
234610074;500;748;748;6;317;405;1;94;4;6;84;223;15;208
234610075;500;551;551;5;296;388;1;111;1;1;109;185;6;179
234610076;500;782;782;7;308;192;1;307;7;12;288;1;0;1
234610077;500;889;889;2;305;384;5;111;4;4;103;194;11;183
234610078;500;609;609;22;275;367;1;132;1;6;125;142;13;129
234610079;500;545;545;10;237;416;2;82;3;5;74;155;5;150
234610080;500;538;539;12;262;407;1;92;2;4;86;170;2;168
234610081;500;536;536;6;237;400;2;98;4;6;88;139;6;133
234610082;500;660;660;8;330;408;1;91;3;1;87;239;10;229
234610083;500;637;637;6;354;395;1;104;1;3;100;250;13;237
234610084;500;458;459;6;202;433;1;66;1;4;61;136;11;125
234610085;500;779;779;9;379;394;2;104;1;3;100;275;13;262
234610086;500;732;732;9;321;408;1;91;1;2;88;230;13;217
234610087;500;493;493;5;234;430;6;64;3;4;57;170;6;164
234610088;500;750;750;7;357;396;4;100;1;4;95;257;11;246
234610089;500;468;468;6;175;434;3;63;2;6;55;112;5;107
234610090;500;547;547;5;250;425;1;74;0;1;73;176;11;165
234610091;500;836;836;4;395;385;0;115;1;3;111;280;10;270
234610092;500;834;834;11;433;403;1;96;1;4;91;337;10;327
234610093;500;650;650;6;359;438;1;61;3;1;57;298;11;287
234610094;500;825;826;8;388;411;1;88;0;2;86;300;13;287
234610095;500;499;499;3;195;436;1;63;3;3;57;132;5;127
234610096;500;719;721;5;340;429;1;70;2;1;67;270;7;263
234610097;500;765;767;4;417;435;1;64;0;1;63;353;10;343
234610098;500;646;646;7;302;432;1;67;0;4;63;235;3;232
234610099;500;923;924;5;415;401;1;98;3;3;92;317;9;308
234610100;500;987;987;7;415;387;1;112;4;5;103;303;16;287
234610101;500;996;996;8;499;374;3;123;3;3;117;376;9;367
234610102;500;660;660;7;327;432;1;67;0;2;65;260;11;249
234610103;500;981;981;9;413;331;1;168;4;7;157;245;10;235
234610104;100;34;34;28;39;60;1;39;1;0;38;0;0;0
234610105;100;14;14;10;23;76;1;23;0;5;18;0;0;0
234610106;100;82;82;31;48;50;2;48;2;4;42;0;0;0
234610107;100;28;28;68;73;26;1;73;2;4;67;0;0;0
234610109;300;128;128;53;66;233;1;66;2;8;56;0;0;0
234610111;200;62;62;32;39;158;3;39;0;3;36;0;0;0
234610112;500;486;486;67;87;411;2;87;2;6;79;0;0;0
234610113;1000;634;634;168;228;769;3;228;12;10;206;0;0;0
234610115;200;14;14;91;92;107;1;92;4;5;83;0;0;0
234610116;100;20;20;22;23;76;1;23;0;2;21;0;0;0
234610117;100;11;11;14;23;76;1;23;0;1;22;0;0;0
234610118;100;41;41;9;47;51;2;47;4;1;42;0;0;0
234615001;500;645;645;78;336;359;1;140;1;4;135;196;16;180
234615002;500;675;675;8;292;406;1;93;3;2;88;199;14;185
234615003;500;813;814;12;404;414;1;85;0;1;84;319;16;303
234615004;500;726;728;9;295;389;2;109;1;2;106;186;11;175
234615005;500;621;621;8;272;418;1;81;2;3;76;191;6;185
234615006;500;666;668;5;253;253;4;243;13;11;219;10;0;10
234615007;500;513;513;5;208;409;2;89;3;5;81;119;8;111
234615008;500;786;786;6;351;400;1;99;1;2;96;252;19;233
234615009;500;826;826;7;407;377;2;121;5;5;111;286;16;270
234615010;500;764;764;9;354;379;1;120;0;4;116;234;12;222
234615011;500;815;816;7;322;395;1;104;2;3;99;218;13;205
234615012;500;763;763;7;351;366;5;129;4;5;120;222;10;212
234615013;500;859;854;7;469;129;0;371;3;25;343;98;2;96
234615014;500;658;658;7;252;426;3;71;3;6;62;181;6;175
234615015;500;597;598;12;281;399;3;98;0;2;96;183;9;174
234615016;500;653;653;12;251;417;1;82;3;4;75;169;6;163
234615017;500;754;755;15;319;378;1;121;3;1;117;198;8;190
234615018;500;700;703;6;309;394;1;105;0;10;95;204;6;198
234615019;500;641;641;2;282;400;4;96;3;1;92;186;7;179
234615020;500;609;609;5;312;394;1;105;1;5;99;207;8;199
234615021;500;834;834;8;450;372;2;126;2;5;119;324;13;311
234615022;500;698;699;8;324;414;1;85;5;2;78;239;17;222
234615023;500;860;862;4;418;373;1;126;5;2;119;292;11;281
234615024;500;741;741;7;305;404;2;94;3;4;87;211;12;199
234615025;500;761;762;7;333;375;1;124;4;5;115;209;7;202
234615026;500;870;871;7;369;385;2;113;0;0;113;256;14;242
234615027;500;559;560;11;245;414;1;85;2;3;80;160;1;159
234615028;500;566;566;13;251;420;1;79;0;1;78;172;8;164
234615029;500;625;625;6;321;404;1;95;0;3;92;226;10;216
234615030;500;553;554;10;260;396;1;103;1;3;99;157;15;142
234615031;500;783;786;5;367;378;1;121;0;7;114;246;14;232
234615032;500;605;608;8;256;402;2;96;4;2;90;160;13;147
234615033;500;587;587;7;232;419;1;80;2;7;71;152;10;142
234615034;500;705;707;6;347;342;2;156;3;6;147;191;8;183
234615035;500;621;621;7;292;386;1;113;7;4;102;179;5;174
234615036;500;564;564;6;168;442;1;57;0;2;55;111;5;106
234615037;500;818;819;4;373;385;1;114;0;2;112;259;17;242
234615038;500;927;929;8;370;352;1;147;3;2;142;223;14;209
234615039;500;750;750;7;388;403;1;96;1;4;91;292;12;280
234615040;500;733;734;5;311;409;1;90;1;2;87;221;12;209
234615041;500;831;833;5;419;351;2;147;2;6;139;272;13;259
234615042;500;799;799;6;412;368;1;131;1;3;127;281;14;267
234615043;500;714;714;7;298;390;1;109;0;1;108;189;12;177
234615044;500;602;602;17;321;409;1;90;1;4;85;231;10;221
234615045;500;822;824;13;347;364;1;135;3;1;131;212;17;195
234615046;500;929;930;6;451;363;2;135;3;2;130;316;14;302
234615047;500;851;851;8;488;439;1;60;1;2;57;428;25;403
234615048;500;890;892;3;392;367;1;132;2;5;125;260;27;233
234615049;500;867;867;36;413;319;3;178;7;7;164;235;8;227
234615050;500;805;805;5;363;367;3;130;2;6;122;233;8;225
234615051;500;785;786;5;337;352;1;147;8;4;135;190;7;183
234615052;500;981;981;7;494;340;1;159;0;2;157;335;11;324
234615053;500;856;857;8;381;310;64;126;3;3;120;255;16;239
234615054;500;821;823;5;348;374;2;124;2;2;120;224;11;213
234615055;500;783;783;8;368;376;1;123;1;4;118;245;4;241
234615056;500;876;876;5;377;360;1;139;4;5;130;238;9;229
234615057;500;680;680;6;285;376;1;123;0;2;121;162;7;155
234615058;500;918;918;5;458;356;4;140;0;5;135;318;14;304
234615059;500;697;697;7;324;404;1;95;0;4;91;229;16;213
234615060;500;739;739;7;287;408;2;90;2;1;87;197;14;183
234615061;500;788;789;4;420;400;1;99;5;3;91;321;10;311
234615062;500;670;673;7;277;415;2;83;2;3;78;194;11;183
234615063;500;534;534;29;249;425;1;74;1;3;70;175;7;168
234615064;500;632;632;6;276;381;2;117;4;4;109;159;8;151
234615065;500;671;673;6;291;380;1;119;2;2;115;172;6;166
234615066;500;650;652;9;260;402;1;97;0;8;89;163;4;159
234615067;500;712;712;4;286;376;1;123;2;4;117;163;12;151
234615068;500;631;631;4;268;409;1;90;2;2;86;178;10;168
234615069;500;772;772;3;363;359;1;140;11;4;125;223;22;201
234615070;500;755;755;3;318;393;1;106;2;5;99;212;14;198
234615071;500;761;761;6;394;382;3;115;2;8;105;279;11;268
234615072;500;800;800;4;361;361;2;137;3;2;132;224;10;214
234615073;500;620;622;5;221;413;1;86;0;5;81;135;5;130
234615074;500;557;559;6;224;415;1;84;1;5;78;140;5;135
234615075;500;564;567;7;215;427;1;72;3;3;66;143;12;131
234615076;500;744;745;7;257;406;1;93;0;3;90;164;5;159
234615077;500;768;770;7;291;391;1;108;2;3;103;183;8;175
234615078;500;627;631;10;236;413;1;86;3;2;81;150;13;137
234615079;500;649;649;6;241;410;1;89;0;5;84;152;11;141
234615080;500;606;607;11;241;414;1;85;3;2;80;156;6;150
234615081;500;626;628;2;225;415;1;84;1;3;80;141;5;136
234615082;500;888;888;8;444;242;1;257;0;9;248;187;2;185
234615083;500;771;772;5;304;383;4;113;3;8;102;191;8;183
234615084;500;680;683;3;269;410;2;88;3;2;83;181;12;169
234615085;500;719;719;5;314;368;2;130;0;4;126;184;11;173
234615086;500;877;877;7;396;355;1;144;3;3;138;252;16;236
234615087;500;702;703;6;321;379;2;119;0;1;118;202;8;194
234615088;500;395;811;6;401;384;2;114;5;3;106;287;21;266
234615089;500;610;611;5;225;411;1;88;3;1;84;137;7;130
234615090;500;741;741;15;366;392;1;107;4;6;97;259;13;246
234615091;500;637;637;5;291;412;2;86;4;1;81;205;7;198
234615092;500;760;761;7;349;400;1;99;3;3;93;250;19;231
234615093;500;641;641;5;230;432;3;65;0;3;62;165;7;158
234615094;500;518;520;53;268;400;2;98;5;1;92;170;6;164
234615095;500;750;750;7;317;363;1;136;4;3;129;181;15;166
234615096;500;578;578;5;282;407;1;92;2;3;87;190;9;181
234615097;500;701;701;7;270;402;2;96;4;4;88;174;6;168
234615098;500;886;888;4;474;354;1;145;2;4;139;329;22;307
234615099;500;751;751;6;304;408;1;91;5;1;85;213;4;209
234615100;500;906;907;8;407;247;1;252;4;10;238;155;10;145
234615101;500;851;852;7;401;396;1;103;1;2;100;298;20;278
234615102;500;904;905;9;434;359;1;140;1;5;134;294;22;272
234615103;500;676;677;5;253;438;1;61;2;2;57;192;7;185
234615104;500;637;639;5;191;425;1;74;4;1;69;117;5;112
234615105;500;747;750;4;256;409;1;90;2;5;83;166;11;155
234615106;500;685;685;7;262;395;3;102;1;0;101;160;7;153
234615107;500;606;606;7;190;441;1;58;1;2;55;132;14;118
234615108;500;538;538;6;183;430;1;69;0;2;67;114;2;112
234615109;500;622;622;6;217;409;1;90;2;6;82;127;8;119
234615110;500;892;892;3;409;286;1;213;5;5;203;196;5;191
234615111;500;739;741;5;277;421;2;77;3;2;72;200;7;193
234615112;500;872;872;6;368;398;3;99;0;5;94;269;5;264
234615113;500;944;945;5;370;428;2;70;1;3;66;300;16;284
234615114;500;821;821;6;260;382;2;116;1;4;111;144;10;134
234615115;500;739;742;4;253;413;1;86;1;1;84;167;7;160
234615116;500;989;990;6;454;383;1;116;0;0;116;338;26;312
234615117;500;943;944;4;409;402;1;97;2;3;92;312;12;300
234615118;500;574;577;6;232;422;1;77;2;2;73;155;6;149
234615119;500;760;760;6;285;391;1;108;1;1;106;177;11;166
234615120;500;794;795;7;324;389;1;110;1;2;107;214;14;200
234615121;500;751;751;5;266;384;1;115;2;7;106;151;4;147
234615122;500;928;929;6;322;351;5;144;2;12;130;178;12;166
234615123;500;869;870;4;346;308;3;189;5;2;182;157;12;145
234615124;500;733;735;4;225;406;1;93;1;6;86;132;3;129
234615125;500;200;600;4;204;411;1;88;2;3;83;116;8;108
234615126;200;69;69;119;134;65;1;134;6;4;124;0;0;0
234615127;100;45;45;8;53;47;0;53;0;0;53;0;0;0
234616001;500;624;624;24;302;405;3;92;3;3;86;210;20;190
234616002;500;472;472;240;496;341;2;157;5;12;140;339;30;309
234616003;500;549;549;142;456;417;1;82;1;12;69;374;28;346
234616004;500;755;755;114;522;371;1;128;0;0;128;394;38;356
234616005;500;619;620;250;596;361;5;134;2;9;123;462;37;425
234616006;500;653;653;213;524;406;3;91;2;11;78;433;36;397
234616007;500;797;797;97;486;384;1;115;2;9;104;371;19;352
234616008;500;554;554;72;392;398;1;101;1;4;96;291;19;272
234616009;500;820;820;112;498;378;1;121;1;10;110;377;31;346
234616010;500;448;448;17;234;424;1;75;1;1;73;159;6;153
234616011;300;325;325;11;145;227;1;72;3;1;68;73;6;67
234616012;500;541;541;5;220;429;1;70;3;1;66;150;8;142
234616013;500;518;519;9;226;416;1;83;0;4;79;143;12;131
234616014;500;454;454;7;189;441;2;57;0;1;56;132;9;123
234616015;500;349;349;27;189;418;1;81;0;5;76;108;8;100
234616016;500;613;613;6;283;397;2;101;6;4;91;182;10;172
234616017;500;500;500;24;220;429;1;70;1;5;64;150;8;142
234616018;500;733;733;10;384;392;3;105;5;4;96;279;10;269
234616019;500;651;651;10;373;400;1;99;0;4;95;274;14;260
234616020;500;450;450;7;192;432;1;67;0;0;67;125;6;119
234616021;700;852;852;1;471;257;3;440;4;14;422;31;0;31
234616022;600;512;513;7;256;543;3;54;0;1;53;202;16;186
234616023;500;730;730;6;292;413;2;85;2;3;80;207;8;199
234616024;500;392;393;6;187;446;1;53;0;2;51;134;6;128
234616025;500;476;478;7;219;428;1;71;1;4;66;148;7;141
234616026;500;519;519;8;197;439;1;60;3;3;54;137;3;134
234616027;500;611;611;6;223;422;1;77;1;5;71;146;4;142
234616028;500;475;475;5;236;390;1;109;4;5;100;127;4;123
234616029;500;542;542;6;284;407;1;92;4;3;85;192;8;184
234616030;500;437;438;9;177;445;1;54;2;5;47;123;6;117
234616031;500;464;464;8;215;413;1;86;2;4;80;129;4;125
234616032;500;442;443;34;259;404;4;92;4;1;87;167;11;156
234616033;500;372;372;7;187;447;1;52;2;1;49;135;9;126
234616034;500;587;587;4;267;405;1;94;1;6;87;173;12;161
234616035;500;461;462;7;216;410;1;89;1;1;87;127;5;122
234616036;500;357;357;7;154;440;1;59;0;0;59;95;7;88
234616037;500;347;348;8;181;460;2;38;0;4;34;143;11;132
234616038;500;429;430;7;207;296;7;197;0;8;189;10;1;9
234616039;500;490;490;7;202;434;4;62;3;1;58;140;12;128
234616040;500;595;594;6;240;419;1;80;0;2;78;160;7;153
234616041;500;414;416;7;195;429;1;70;0;3;67;125;7;118
234616042;500;603;604;6;268;392;1;107;3;1;103;161;6;155
234616043;500;438;438;10;198;438;4;58;3;2;53;140;2;138
234616044;500;457;457;6;174;444;3;53;1;2;50;121;6;115
234616045;500;632;632;7;271;411;1;88;0;0;88;183;11;172
234616046;1000;882;882;18;532;891;5;104;2;7;95;428;24;404
234616047;500;721;721;20;383;409;1;90;1;3;86;293;10;283
234616048;500;679;679;85;444;406;3;91;2;2;87;353;20;333
234616049;500;544;546;222;459;135;5;360;2;34;324;99;9;90
234616050;500;747;747;107;481;407;1;92;2;14;76;389;19;370
234616051;500;663;663;60;455;409;2;89;1;5;83;366;21;345
234616052;500;677;677;26;420;402;4;94;1;3;90;326;16;310
234616053;500;862;862;36;476;399;2;99;3;1;95;377;15;362
234616054;300;203;37;12;105;194;1;105;2;8;95;0;0;0
234616055;500;602;602;27;351;448;1;51;1;1;49;300;15;285
234616056;500;756;756;17;403;436;1;63;1;1;61;340;22;318
234616058;100;14;14;58;60;39;1;60;1;3;56;0;0;0
234617001;600;907;907;5;352;448;2;150;5;7;138;202;7;195
234617002;600;929;929;6;445;459;3;138;1;3;134;307;16;291
234617003;600;993;993;6;465;471;1;128;2;6;120;337;18;319
234617004;600;991;991;5;410;468;1;131;3;6;122;279;12;267
234617005;600;975;976;4;470;458;10;132;2;3;127;338;12;326
234617006;600;886;886;9;514;486;1;113;3;3;107;401;16;385
234617007;600;1031;1031;3;465;443;1;156;2;4;150;309;7;302
234617008;600;987;988;4;469;456;1;143;3;3;137;326;6;320
234617009;600;913;915;12;427;383;2;215;4;9;202;212;10;202
234617010;600;910;910;8;418;442;2;156;5;6;145;262;24;238
234617011;600;897;897;4;409;455;2;143;2;4;137;267;8;259
234617012;600;860;860;5;346;253;1;346;3;19;324;0;0;0
234617013;600;1023;1023;4;464;472;2;126;3;4;119;338;23;315
234617014;400;576;576;3;212;270;1;129;3;1;125;83;8;75
234617015;300;373;373;2;155;206;1;93;1;3;89;62;0;62
234617016;500;775;775;2;276;384;1;115;4;3;108;161;9;152
234617017;500;839;840;5;334;361;1;138;3;10;125;196;16;180
234617018;500;764;765;6;235;369;1;130;4;3;123;104;9;95
234617019;400;637;637;4;203;294;2;104;5;1;98;99;6;93
234617020;600;911;911;11;411;415;1;184;3;4;177;227;14;213
234617021;500;742;743;10;374;380;1;119;2;4;113;255;11;244
234617022;500;720;720;5;329;384;1;115;4;6;105;214;7;207
234617023;400;676;676;3;326;285;1;114;4;6;104;212;7;205
234617024;600;922;924;9;444;455;3;142;1;0;141;302;14;288
234617025;600;941;943;3;455;415;1;184;2;4;178;271;13;258
234617026;400;604;604;6;278;304;1;95;2;4;89;183;13;170
234617027;600;1042;1044;6;441;447;2;151;4;4;143;290;11;279
234617028;600;946;948;6;437;486;1;113;1;4;108;324;15;309
234617029;500;748;749;4;329;395;2;103;2;3;98;226;6;220
234617030;500;841;841;6;347;331;1;168;3;3;162;179;12;167
234617031;400;616;616;8;271;294;1;105;1;3;101;166;8;158
234617032;500;840;841;6;293;371;1;128;3;7;118;165;9;156
234617033;300;510;510;3;181;235;1;64;1;2;61;117;7;110
234617034;600;972;972;5;481;405;5;190;0;9;181;291;17;274
234617035;500;827;827;7;357;354;1;145;0;0;145;212;15;197
234617036;500;695;696;4;349;372;2;126;9;4;113;223;8;215
234617037;600;964;964;6;440;400;1;199;4;5;190;241;11;230
234617038;500;742;743;7;308;409;1;90;2;7;81;218;9;209
234617039;500;746;746;4;344;356;2;142;5;0;137;202;12;190
234617040;600;961;963;5;442;229;5;366;6;12;348;76;2;74
234617041;500;772;772;7;215;380;4;116;18;7;91;99;7;92
234617042;500;773;773;4;258;381;4;115;4;5;106;143;6;137
234617043;600;957;958;6;447;474;1;125;3;2;120;322;16;306
234617044;600;977;978;12;495;468;1;131;1;2;128;364;8;356
234617045;500;846;847;10;435;400;2;98;3;5;90;337;12;325
234617046;600;984;985;13;478;451;4;145;2;4;139;333;12;321
234617047;500;853;853;10;431;342;1;157;2;0;155;274;8;266
234617048;600;943;943;8;522;473;1;126;2;2;122;396;15;381
234617049;500;703;703;12;355;411;1;88;2;0;86;267;7;260
234617050;500;809;809;6;392;393;1;106;0;3;103;286;11;275
234617051;600;906;906;7;433;463;3;134;4;1;129;299;16;283
234617052;600;924;925;8;420;440;2;158;4;6;148;262;12;250
234617053;600;1013;1013;7;505;427;5;168;8;7;153;337;14;323
234617054;500;855;856;6;370;369;7;124;1;7;116;246;11;235
234617055;600;903;904;5;401;463;1;136;2;4;130;265;10;255
234617056;500;824;824;9;400;370;4;126;3;4;119;274;14;260
234617057;300;395;396;10;213;220;1;79;0;2;77;134;3;131
234617058;400;661;661;7;274;304;1;95;2;2;91;179;8;171
234617059;400;539;540;8;230;318;1;81;0;4;77;149;6;143
234617060;400;597;599;7;265;303;6;91;3;4;84;174;11;163
234617061;500;809;810;7;368;400;1;99;0;0;99;269;8;261
234617062;500;845;845;6;399;345;1;154;3;6;145;245;12;233
234617063;500;667;668;18;288;402;2;96;1;8;87;192;7;185
234617064;500;716;716;6;330;417;1;82;1;4;77;248;10;238
234617065;500;776;776;7;346;378;2;120;0;0;120;226;12;214
234617066;400;649;650;6;201;306;1;93;5;1;87;108;6;102
234617067;500;798;800;6;372;353;3;144;2;5;137;228;4;224
234617068;600;935;935;7;475;514;6;80;0;2;78;395;23;371
234617069;600;973;973;5;487;478;2;120;0;1;119;367;18;349
234617070;600;878;878;10;423;467;3;130;1;4;125;293;10;283
234617071;600;1028;1028;8;492;473;1;126;1;4;121;366;14;352
234617072;600;891;891;5;447;503;6;91;3;4;84;356;13;343
234617073;500;770;772;5;324;359;1;140;1;1;138;184;13;171
234617074;300;448;448;9;216;226;1;73;6;1;66;143;5;138
234617075;300;508;508;6;249;234;2;64;0;3;61;185;13;172
234617076;200;42;42;98;106;93;1;106;2;8;96;0;0;0
234617077;100;24;24;7;29;71;0;29;1;1;27;0;0;0
234623001;500;639;639;5;200;416;1;83;6;5;72;117;8;109
234623002;400;483;483;5;162;336;1;63;4;5;54;99;7;92
234623003;700;845;845;2;275;577;4;119;3;6;110;156;10;146
234623004;600;747;750;3;254;487;3;110;4;1;105;144;10;133
234623005;600;734;736;6;236;500;1;99;4;1;94;137;7;130
234623006;600;792;792;5;292;445;1;154;8;6;140;138;5;133
234623007;500;613;613;5;136;430;1;69;7;6;56;67;1;66
234623008;500;608;609;7;197;393;1;106;4;2;100;91;7;84
234623009;600;706;706;0;285;472;3;125;5;4;116;160;12;148
234623010;800;1056;1057;3;482;590;1;209;4;10;195;273;16;257
234623011;500;659;659;3;236;372;1;127;2;5;120;109;6;103
234623012;500;659;659;4;270;374;1;125;2;5;118;145;9;135
234623013;500;685;685;4;306;193;2;305;8;6;291;1;0;1
234623014;500;602;602;4;247;410;2;88;1;3;84;159;7;152
234623015;500;744;744;5;296;382;1;117;2;5;110;179;9;170
234623016;600;570;571;3;243;475;1;124;0;7;117;119;3;116
234623017;700;880;880;2;343;566;1;133;4;2;127;210;11;199
234623018;800;944;944;10;389;599;2;199;4;7;188;190;6;184
234623019;600;782;783;6;281;502;1;97;6;0;91;184;9;175
234623020;500;688;688;6;275;387;2;111;4;5;102;164;6;158
234623021;700;892;892;5;402;486;1;213;8;13;192;189;13;176
234623022;500;647;649;4;266;394;2;104;2;4;98;162;10;152
234623023;400;490;490;4;177;302;1;97;2;2;93;80;10;70
234623024;400;495;495;5;188;292;1;107;6;7;94;81;10;71
234623025;500;661;661;5;255;375;1;124;3;8;113;131;12;119
234623026;700;885;886;2;380;464;2;234;12;14;208;146;6;129
234623027;700;956;956;4;440;501;3;196;5;5;186;244;11;233
234623028;700;956;956;6;465;482;3;215;5;4;206;250;11;239
234623029;700;969;969;4;497;524;1;175;4;6;165;322;9;313
234623030;500;757;758;1;309;314;2;184;5;8;171;125;7;118
234623031;400;551;552;2;182;313;1;86;4;1;81;96;8;88
234623032;100;65;65;8;39;60;1;39;0;2;37;0;0;0
244601001;500;657;657;63;244;433;1;66;0;5;61;178;10;168
244601002;500;708;708;15;330;389;1;110;1;8;101;220;6;214
244601003;500;718;718;13;288;379;2;119;1;4;114;169;6;163
244601004;500;702;702;25;297;440;1;59;1;2;56;238;10;228
244601005;500;780;781;6;331;402;2;96;2;2;92;235;11;224
244601006;500;655;655;17;310;419;1;80;1;5;74;230;8;222
244601007;500;774;774;7;336;371;2;127;1;2;124;209;4;205
244601008;500;632;633;7;257;403;1;96;2;2;92;161;7;154
244601009;500;822;822;15;373;387;2;111;1;1;109;262;14;248
244601010;500;776;776;6;327;386;1;113;4;1;108;214;4;210
244601011;500;798;799;20;356;386;1;113;5;4;104;243;6;237
244601012;500;752;752;8;321;342;2;156;4;4;148;165;8;157
244601013;500;857;857;13;346;387;4;109;8;2;99;237;11;226
244601014;500;786;786;11;357;381;2;117;1;6;110;240;7;233
244601015;500;525;525;6;255;404;4;92;3;2;87;163;10;153
244601016;500;693;693;7;301;409;2;89;1;5;83;212;8;204
244601017;500;502;502;14;229;414;2;84;4;0;80;145;3;142
244601018;500;714;714;9;325;387;1;112;2;6;104;213;4;209
244601019;500;733;733;14;343;400;2;98;3;2;93;245;10;235
244601020;500;678;678;6;279;413;1;86;1;1;84;193;4;189
244601021;500;764;764;14;352;411;1;88;1;3;84;264;15;249
244601022;500;804;804;11;370;387;1;112;1;0;111;258;3;255
244601023;500;639;639;8;274;410;1;89;0;2;87;185;2;183
244601024;500;674;674;11;320;410;2;88;0;0;88;232;6;226
244601025;500;608;610;23;266;418;3;79;1;2;76;187;4;183
244601026;500;728;728;7;318;392;6;102;6;1;95;216;4;212
244601027;500;639;638;7;258;425;1;74;0;2;72;184;2;182
244601028;500;832;834;5;275;410;3;87;2;5;80;188;8;180
244601029;500;916;916;7;395;386;3;111;1;1;109;284;10;274
244601030;500;684;684;7;304;396;5;99;3;2;94;205;7;198
244601031;500;549;549;9;253;417;2;81;1;6;74;172;3;169
244601032;500;787;787;11;392;398;3;99;2;2;95;293;16;277
244601033;500;707;707;8;351;418;1;81;1;1;79;270;12;258
244601034;500;677;677;9;289;413;3;84;1;5;78;205;9;196
244601035;500;712;712;14;346;397;2;101;1;2;98;245;8;237
244601036;500;822;822;10;364;393;1;106;0;5;101;258;12;246
244601037;500;868;868;6;439;348;1;151;4;7;140;288;13;275
244601038;500;853;853;5;408;434;1;65;1;1;63;343;11;332
244601039;500;845;846;6;395;359;2;139;2;3;134;256;9;247
244601040;500;698;698;14;371;371;2;127;0;1;126;244;19;225
244601041;500;877;878;8;443;368;1;131;2;6;123;312;13;299
244601042;500;714;714;8;347;421;1;78;0;3;75;269;8;261
244601043;100;23;23;44;47;52;1;47;0;6;41;0;0;0
244601044;200;21;21;36;48;150;2;48;1;5;42;0;0;0
244601045;200;86240;86240;28;80;168;1;31;1;1;29;49;3;46
244601046;100;28;28;2;29;71;0;29;0;0;29;0;0;0
244603001;500;430;430;24;170;436;2;62;0;0;62;108;3;105
244603002;500;604;604;9;213;433;2;65;1;1;63;148;5;143
244603003;500;729;728;8;236;395;2;103;0;1;102;133;2;131
244603004;500;730;730;13;203;425;4;71;1;2;68;132;2;130
244603006;1000;885;887;7;218;945;1;54;0;1;53;164;8;156
244603007;1000;949;949;14;329;891;1;108;2;4;102;221;11;210
244603008;1000;896;897;9;198;926;1;73;0;3;70;125;7;118
244603009;500;741;741;11;162;457;2;41;1;1;39;121;7;114
244603011;1000;1005;1005;12;342;876;3;121;2;10;109;221;12;209
244603012;500;468;468;10;129;451;1;48;1;0;47;81;2;79
244603013;500;561;561;11;167;443;1;56;1;2;53;111;6;105
244603014;1000;847;847;5;240;930;1;69;3;2;64;171;8;163
244603016;500;368;368;27;134;431;2;67;0;3;64;67;5;62
244603017;500;531;531;10;146;445;1;54;1;1;52;92;3;89
244603018;1000;895;895;0;233;922;4;74;3;2;69;159;4;155
244603020;500;771;771;8;253;398;1;101;1;5;95;152;6;146
244603021;500;750;750;4;189;433;1;66;1;0;65;123;4;119
244603022;1000;876;876;9;294;877;2;121;4;2;115;173;9;164
244603024;1000;899;899;12;370;899;1;100;0;3;97;270;15;255
244603025;1000;998;998;9;445;871;1;128;3;1;124;317;15;302
244603026;1000;852;852;5;358;908;1;91;5;2;84;267;11;256
244603027;1000;783;783;23;380;906;1;93;7;4;82;287;18;269
244603028;1000;800;800;8;371;880;2;118;0;3;115;253;14;239
244603031;1000;862;862;8;339;879;3;118;4;4;110;221;15;206
244603032;1000;1036;1036;7;395;875;2;123;1;6;116;272;15;257
244603034;500;566;566;11;229;413;2;85;4;6;75;144;9;135
244603035;500;620;620;6;240;410;2;88;0;0;88;152;5;147
244603036;1000;782;782;7;351;859;4;137;3;3;131;214;7;207
244603037;1000;875;875;11;297;892;1;107;0;8;99;190;13;177
244603038;1000;810;810;7;339;853;1;146;0;6;140;193;12;181
244603039;500;337;337;43;203;408;1;91;4;2;85;112;7;105
244603040;500;547;547;10;248;433;4;63;2;2;59;185;5;180
244603041;500;670;672;7;251;417;1;82;1;4;77;169;14;155
244603042;1000;823;823;7;353;899;1;100;3;1;96;253;21;232
244603043;1000;988;988;8;414;840;2;158;4;2;152;256;14;242
244603044;1000;936;936;11;385;876;1;123;2;2;119;262;13;249
244603045;1000;931;931;14;344;859;1;140;2;3;135;204;10;194
244603046;1000;874;875;6;370;863;1;136;3;4;129;234;10;224
244603047;500;787;787;20;337;388;1;111;1;2;108;226;14;212
244603048;1000;988;988;9;419;880;2;118;0;5;113;301;9;292
244603050;1000;914;915;8;394;604;5;391;5;18;368;3;0;3
244603052;500;726;726;12;347;371;8;121;7;4;110;226;12;214
244603053;1000;927;927;8;380;866;1;133;1;4;128;247;6;241
244603054;1000;894;894;5;402;857;7;136;1;6;129;266;18;248
244603055;1000;821;821;12;333;900;2;98;1;1;96;235;9;226
244603056;500;567;567;9;197;433;6;61;0;1;60;136;5;131
244603057;500;713;713;6;290;377;3;120;4;8;108;170;4;166
244603058;500;499;499;12;178;431;1;68;0;3;65;110;8;102
244603059;500;539;540;6;225;416;6;78;2;6;70;147;7;140
244603060;500;580;580;9;252;396;2;102;0;0;102;150;11;139
244603061;500;501;501;7;180;417;1;82;1;6;75;98;7;91
244603062;500;647;650;5;250;410;1;89;3;5;81;161;11;150
244603063;500;622;622;6;222;425;7;68;7;3;58;154;11;143
244603064;1000;874;874;6;358;843;1;156;0;3;153;202;0;202
244604001;400;434;434;11;199;340;1;59;0;4;55;140;9;131
244604002;500;763;763;14;288;423;1;76;2;2;72;212;7;205
244604003;500;756;757;7;351;411;1;88;0;1;87;263;7;256
244604004;400;456;457;6;178;336;1;63;2;3;58;115;6;109
244604005;400;552;552;9;225;323;1;76;0;0;76;149;5;144
244604006;400;562;562;5;256;331;1;68;3;5;60;188;5;183
244604007;300;370;370;11;171;252;1;47;1;3;43;124;1;123
244604008;300;409;409;12;170;247;1;52;1;0;51;118;1;117
244604009;300;424;424;4;151;246;1;53;0;3;50;98;2;96
244604010;500;629;629;6;223;407;1;92;0;4;88;131;4;127
244604011;400;566;567;8;213;334;1;65;2;3;60;148;5;143
244604012;500;684;684;7;289;409;1;90;1;4;85;199;8;191
244604013;400;534;535;6;242;330;2;68;1;2;65;174;12;162
244604014;500;685;686;6;328;384;1;115;2;10;103;213;14;199
244604015;600;720;721;10;300;484;6;110;5;1;104;190;7;183
244604016;500;595;596;14;279;416;2;82;1;3;78;197;11;186
244604017;500;656;656;13;346;405;2;93;0;0;93;253;10;243
244604018;600;844;844;16;425;449;2;149;1;1;147;276;4;272
244604019;600;855;856;9;434;462;2;136;1;2;133;298;16;282
244604020;300;465;465;8;200;243;2;55;2;2;51;145;5;140
244604021;200;322;323;13;138;150;3;47;0;1;46;91;8;83
244604022;300;445;445;9;209;243;1;56;0;3;53;153;8;145
244604023;300;389;389;5;166;247;1;52;1;0;51;114;3;111
244604024;400;450;451;6;214;342;1;57;4;2;51;157;8;149
244604025;500;672;672;14;353;381;5;114;4;7;103;239;5;234
244604026;500;619;620;21;309;415;1;84;0;4;80;225;14;211
244604027;300;347;347;9;173;251;1;48;3;1;44;125;6;119
244604028;400;521;523;6;268;318;1;81;1;0;80;187;7;180
244604029;500;721;723;7;371;392;1;107;1;4;102;264;12;252
244604030;300;389;389;9;212;247;1;52;1;4;47;160;6;154
244604031;300;497;498;8;245;234;1;65;1;0;64;180;6;174
244604032;500;657;657;7;267;428;1;71;1;1;69;196;4;192
244604033;300;410;411;21;229;248;1;51;2;2;47;178;3;175
244604034;400;519;519;14;227;331;3;66;2;3;61;161;6;155
244604035;400;559;560;7;259;320;5;75;2;2;71;184;9;175
244604036;300;430;430;20;198;204;2;94;2;2;90;104;6;98
244604037;400;595;597;6;268;334;2;64;2;2;60;204;11;193
244604038;400;510;510;7;257;325;1;74;0;4;70;183;7;176
244604039;500;624;625;5;314;413;1;86;1;1;84;228;10;218
244604040;500;758;762;9;348;381;1;118;3;0;115;230;7;223
244604041;400;556;557;6;270;315;1;84;0;3;81;186;4;182
244604042;300;454;454;7;210;235;2;63;1;0;62;147;4;143
244604043;300;459;459;6;227;226;1;73;1;0;72;154;8;146
244604044;400;498;499;33;252;327;1;72;1;1;70;180;6;174
244604045;400;480;482;13;226;333;1;66;2;0;64;160;6;154
244604046;500;617;619;4;278;420;1;79;2;3;74;199;7;192
244604047;400;522;523;8;276;311;1;88;0;3;85;188;5;183
244604048;500;645;646;8;304;406;1;93;1;5;87;211;9;202
244604049;400;658;658;11;287;327;2;71;1;1;69;216;6;210
244604050;400;505;505;7;250;323;1;76;1;4;71;174;7;167
244604051;400;576;576;7;275;297;1;102;3;5;94;173;10;163
244604052;200;360;360;8;168;148;2;50;2;5;43;118;4;114
244604053;500;743;743;7;336;397;1;102;2;5;95;234;11;223
244604054;500;787;788;8;372;382;2;116;3;4;109;256;9;247
244604055;200;19;19;83;92;107;1;92;3;4;85;0;0;0
244604056;100;22;22;7;28;72;0;28;0;1;27;0;0;0
244605001;400;422;422;7;187;322;2;76;1;2;73;111;3;108
244605002;500;540;540;11;254;428;1;71;1;3;67;183;7;176
244605003;600;639;639;9;266;501;0;99;1;5;93;167;10;157
244605004;500;493;493;25;235;418;1;81;3;2;76;154;10;144
244605005;800;800;800;13;370;666;1;133;1;5;127;237;8;229
244605006;600;562;562;7;253;509;1;90;0;2;88;163;9;154
244605007;700;698;698;6;305;575;3;122;2;5;115;183;14;169
244605008;800;846;846;12;404;648;1;151;2;6;143;253;12;241
244605009;800;854;854;18;398;682;2;116;1;3;112;282;12;270
244605010;800;775;775;3;354;698;2;100;0;2;98;254;12;242
244605011;700;756;756;8;354;583;1;116;5;3;108;238;17;221
244605012;700;768;768;8;364;546;2;152;2;4;146;212;15;197
244605013;500;504;504;9;216;400;1;99;5;5;89;117;8;109
244605014;700;677;678;4;305;577;1;122;0;5;117;183;9;174
244605015;600;570;571;7;253;493;1;106;2;3;101;147;2;145
244605016;800;842;843;3;354;661;1;138;3;8;127;216;14;202
244605017;600;628;628;3;329;517;2;81;1;4;76;248;14;234
244605018;900;980;980;6;456;757;5;138;0;3;135;318;18;300
244605019;800;890;891;8;389;645;5;150;4;8;138;239;15;224
244605020;600;576;576;5;222;521;1;78;1;3;74;144;7;137
244605021;500;541;541;3;212;407;1;92;1;2;89;120;7;113
244605022;400;384;384;14;159;293;2;105;0;5;100;54;5;49
244605023;500;499;499;3;199;419;2;79;4;2;73;120;5;115
244605024;700;774;774;5;271;603;1;96;1;1;94;175;13;162
244605025;600;639;639;7;250;502;1;97;0;6;91;153;7;146
244605026;500;454;454;22;205;431;1;68;1;0;67;137;9;128
244605027;700;693;693;6;291;563;1;136;4;4;128;155;3;152
244605028;700;693;693;5;273;602;2;96;1;0;95;177;11;166
244605029;600;590;591;5;226;504;1;95;3;4;88;131;8;123
244605030;700;697;698;7;275;575;1;124;2;6;116;151;8;143
244605031;500;554;554;7;193;424;1;75;2;3;70;118;14;104
244605032;500;498;498;3;151;436;1;63;0;1;62;88;4;84
244605033;500;517;518;7;218;419;1;80;0;1;79;138;8;130
244605034;600;623;626;8;229;518;1;81;2;4;75;148;7;141
244605035;300;290;291;9;114;249;1;50;0;4;46;64;5;59
244605036;500;524;524;7;171;416;2;82;2;3;77;89;5;84
244605037;400;404;404;8;174;312;1;87;1;4;82;87;4;83
244605038;700;689;690;7;276;590;1;109;6;7;96;167;10;157
244605039;500;509;509;7;185;435;1;64;2;4;58;121;7;114
244605040;500;474;474;7;197;423;1;76;2;4;70;121;10;111
244605041;700;729;729;6;262;579;1;120;3;4;113;142;6;136
244605042;500;522;522;6;200;400;1;99;4;6;89;101;5;96
244605043;700;695;695;7;181;609;5;86;5;5;76;95;7;88
244605044;700;715;719;5;228;600;2;98;3;7;88;130;5;125
244605045;800;842;842;7;213;706;2;92;4;5;83;121;7;114
244605046;600;564;564;6;209;485;3;112;2;5;105;97;5;92
244605047;500;539;539;7;206;402;1;97;0;3;94;109;3;106
244605048;500;543;546;5;159;426;2;72;1;6;65;87;0;87
244605049;600;672;672;5;204;518;2;80;2;3;75;124;9;115
244605050;700;692;692;4;229;589;2;109;4;2;103;120;10;110
244605051;600;609;609;6;225;510;1;89;1;0;88;136;7;129
244605052;400;367;367;10;110;347;1;52;0;2;50;58;3;55
244605053;500;493;493;4;147;437;2;61;2;2;57;86;4;82
244605054;900;902;902;13;362;766;5;129;3;3;123;233;19;214
244605055;500;564;564;3;222;422;1;77;1;3;73;145;4;141
244605056;500;535;535;7;203;428;2;70;4;6;60;133;5;128
244605057;600;616;616;8;213;516;1;83;1;3;79;130;4;126
244605058;800;845;844;4;293;704;2;94;3;4;87;199;11;188
244605059;800;799;799;4;304;672;2;126;4;4;118;178;8;170
244605060;900;897;897;2;284;773;4;123;6;1;116;161;14;147
244605061;900;922;922;7;343;772;1;127;1;6;120;216;18;198
244605062;200;142;142;8;47;152;1;47;1;5;41;0;0;0
244605063;200;18;18;21;34;165;1;34;2;1;31;0;0;0
244605064;200;21;21;41;56;142;2;56;6;4;46;0;0;0
244605065;200;120;120;53;159;39;2;159;15;10;134;0;0;0
244605066;200;80;80;19;71;128;1;71;20;2;49;0;0;0
244606001;500;819;819;7;317;377;1;122;1;7;114;195;14;181
244606002;500;774;774;4;284;374;1;125;3;7;115;159;10;149
244606003;500;789;790;5;303;398;1;101;4;5;92;202;14;188
244606004;500;872;873;7;364;363;2;135;1;4;130;229;17;212
244606005;500;822;823;5;355;360;1;139;0;3;136;216;23;193
244606006;500;806;807;12;325;409;1;90;3;1;86;235;18;217
244606007;500;925;925;5;253;407;1;92;4;2;86;161;22;139
244606008;500;788;789;5;268;402;1;97;1;4;92;171;9;162
244606009;500;739;739;8;242;414;1;85;1;6;78;157;13;144
244606010;500;779;779;3;275;378;2;120;5;6;109;155;14;141
244606011;500;817;817;6;275;407;1;92;2;1;89;183;19;164
244606012;500;720;721;6;238;396;1;103;3;3;97;135;6;129
244606013;500;717;717;6;232;403;1;96;4;3;89;136;3;133
244606014;500;737;739;2;217;379;1;120;3;4;113;97;2;95
244606015;500;704;704;16;248;418;1;81;5;0;76;167;9;158
244606016;500;759;759;15;280;371;2;127;2;1;124;153;6;147
244606017;500;784;784;5;340;383;1;116;2;2;112;224;10;214
244606018;500;781;781;5;299;381;1;118;5;3;110;181;11;170
244606019;500;799;800;7;313;392;1;107;3;2;102;206;8;198
244606020;500;771;771;8;299;422;1;77;3;2;72;222;16;206
244606021;500;829;829;8;350;360;3;137;1;2;134;213;15;198
244606022;500;729;729;12;292;390;1;109;1;11;97;183;9;174
244606023;500;924;924;8;396;368;1;131;0;2;129;265;20;245
244606024;500;885;885;5;380;361;1;138;0;6;132;242;12;230
244606025;500;1016;1016;6;415;379;1;120;1;4;115;295;17;278
244606026;500;902;902;12;329;382;1;117;2;3;112;212;13;199
244606027;500;793;793;8;302;376;1;123;3;6;114;179;8;171
244606028;500;831;832;6;333;368;1;131;4;7;120;202;14;188
244606029;500;715;715;19;306;354;1;145;2;4;139;161;1;160
244606030;500;789;789;8;307;362;1;137;6;3;128;170;6;164
244606031;500;785;786;4;331;369;1;130;3;6;121;201;8;193
244606032;500;722;722;5;354;373;1;126;0;2;124;228;9;219
244606033;500;746;746;5;254;399;1;100;3;5;92;154;7;147
244606034;500;741;741;7;288;387;2;111;3;8;100;177;4;173
244606035;500;823;823;5;335;373;2;125;2;2;121;210;16;194
244606036;500;700;700;6;262;375;1;124;0;7;117;138;7;131
244606037;500;696;697;7;251;388;1;111;0;1;110;140;8;132
244606038;500;657;657;8;253;417;1;82;2;5;75;171;9;162
244606039;500;754;755;4;288;410;3;87;2;3;82;201;6;195
244606040;500;962;963;8;432;192;1;307;9;19;279;125;4;121
244606041;500;794;796;5;282;413;1;86;3;4;79;196;15;181
244606042;500;791;792;5;287;394;1;105;3;7;95;182;12;170
244606043;500;829;830;7;279;393;2;105;2;6;97;174;7;167
244606044;500;775;777;9;302;369;2;129;2;2;125;173;15;158
244606045;500;688;688;6;270;398;3;99;2;4;93;171;7;164
244606046;500;933;933;6;362;384;2;114;4;4;106;248;14;234
244606047;500;755;755;11;322;384;3;113;2;9;102;209;17;192
244606048;500;723;724;5;280;400;2;98;1;5;92;182;7;175
244606049;500;780;782;4;297;376;2;122;1;6;115;175;7;168
244606050;500;778;779;5;270;372;1;127;3;10;114;143;8;135
244606051;500;760;760;9;58;467;1;32;2;2;28;26;1;25
244606052;500;780;782;5;255;392;1;107;2;2;103;148;3;145
244606053;500;851;852;7;344;383;1;116;2;4;110;228;19;209
244606054;500;750;750;7;309;365;1;134;5;5;124;175;15;160
244606055;500;750;750;5;265;392;2;106;5;5;96;159;12;147
244606056;500;769;771;7;293;377;1;122;5;4;113;171;9;162
244606057;500;749;749;3;278;353;1;146;4;6;136;132;8;124
244606058;500;838;838;5;323;355;1;144;2;3;139;179;13;166
244606059;500;895;895;4;325;387;1;112;4;2;106;213;8;205
244606060;500;862;862;5;303;361;1;138;2;5;131;165;7;158
244606061;500;770;770;10;262;393;1;106;3;3;100;156;7;149
244606062;500;770;770;3;249;410;2;88;3;2;83;161;9;152
244606063;500;816;816;4;275;385;1;114;3;4;107;161;8;153
244606064;500;788;788;3;278;392;1;107;2;5;100;171;5;166
244606065;500;832;832;6;287;401;1;98;1;3;94;189;13;176
244606066;500;805;805;6;271;410;2;88;4;2;82;183;14;169
244606067;500;829;830;4;237;418;1;81;2;2;77;156;7;149
244606068;500;826;826;4;299;381;1;118;4;4;110;181;8;173
244606069;500;907;907;3;340;214;1;285;8;11;266;55;4;51
244606070;500;628;629;4;191;357;1;142;4;5;133;49;1;48
244606071;500;990;990;8;405;356;3;141;1;9;131;264;11;253
244606072;500;861;861;6;317;189;1;310;5;21;284;7;1;6
244606073;500;804;804;6;246;381;1;118;4;5;109;128;13;115
244606074;500;857;857;5;305;382;1;117;4;8;105;188;8;180
244606075;500;720;722;7;241;392;1;107;2;3;102;134;7;127
244606076;500;867;867;12;269;391;1;108;3;6;99;161;8;153
244606077;500;749;749;6;300;376;1;123;4;2;119;177;12;165
244606078;500;773;773;7;288;371;1;128;5;10;113;160;12;148
244606079;500;665;667;9;271;402;2;96;0;2;94;175;9;166
244606080;500;628;628;9;276;411;2;87;4;7;76;189;17;172
244606081;500;790;790;7;309;376;3;121;2;0;119;188;12;176
244606082;500;765;765;5;243;420;3;77;2;3;72;166;16;150
244606083;500;623;623;4;223;407;2;91;3;3;85;132;4;128
244606084;100;26;26;4;30;70;0;30;0;0;30;0;0;0
244607001;400;524;524;7;253;325;2;73;2;3;68;180;9;171
244607002;300;413;414;7;198;244;2;54;0;1;53;144;2;142
244607003;300;479;479;16;250;239;1;60;0;6;54;190;6;184
244607004;500;712;712;7;363;364;4;132;2;3;127;231;5;226
244607005;600;965;966;7;425;467;2;131;5;5;121;294;6;288
244607006;500;658;659;10;287;428;1;71;4;2;65;216;8;208
244607007;600;947;947;8;468;460;2;138;4;8;126;330;9;321
244607008;500;708;711;8;331;404;1;95;1;5;89;236;10;226
244607009;500;701;703;25;345;388;2;110;4;4;102;235;12;223
244607010;400;647;647;13;361;301;6;93;5;5;83;268;13;255
244607011;300;515;515;22;274;238;1;61;0;2;59;213;9;204
244607012;400;575;575;5;243;316;4;80;1;3;76;163;7;156
244607013;300;430;430;10;196;224;1;75;0;0;75;121;3;118
244607014;500;779;779;12;360;396;1;103;0;4;99;257;11;246
244607015;400;563;563;25;291;320;1;79;0;3;76;212;5;207
244607016;500;730;730;7;350;361;4;135;1;5;129;215;8;207
244607017;600;869;869;6;446;433;15;152;2;14;136;294;9;285
244607018;400;593;594;7;279;309;1;90;1;2;87;189;4;185
244607019;500;706;706;5;340;397;3;100;2;4;94;240;12;228
244607020;400;629;629;6;279;323;1;76;3;0;73;203;16;187
244607021;600;867;867;5;383;477;1;122;3;8;111;261;10;251
244607022;300;479;482;6;124;250;1;49;3;0;46;75;3;72
244607023;400;538;538;7;264;322;1;77;0;2;75;187;6;181
244607024;500;703;705;5;342;379;1;120;2;3;115;222;15;207
244607025;500;789;789;8;336;395;2;103;2;6;95;233;13;220
244607026;400;625;625;7;341;305;2;93;1;4;88;248;8;240
244607027;300;401;402;7;185;232;2;66;0;3;63;119;4;115
244607028;600;823;824;11;420;444;1;155;1;5;149;265;10;255
244607029;500;663;664;14;339;374;2;124;0;3;121;215;7;208
244607030;400;574;574;5;279;310;1;89;2;4;83;190;12;178
244607031;300;471;472;6;213;200;4;96;0;6;90;117;7;110
244607032;500;668;669;10;336;380;2;118;1;0;117;218;5;213
244607033;400;575;575;11;291;274;1;125;1;1;123;166;5;161
244607034;400;590;590;9;280;314;2;84;1;3;80;196;11;185
244607035;400;528;528;8;243;316;3;81;2;3;76;162;6;156
244607036;700;952;952;5;481;556;2;142;5;4;133;339;12;327
244607037;500;779;780;5;376;376;1;123;2;3;118;253;12;241
244607038;400;643;644;10;320;325;1;74;2;1;71;246;13;233
244607039;600;842;842;2;430;466;1;133;4;7;122;297;13;284
244607040;600;897;898;4;418;436;1;163;2;7;154;255;8;247
244607041;400;632;632;11;332;313;1;86;0;3;83;246;9;237
244607042;700;939;942;14;449;553;1;146;6;5;135;303;20;283
244607043;700;983;985;7;491;570;2;128;4;2;122;363;16;347
244607044;600;876;877;10;450;472;4;124;0;5;119;326;18;308
244607045;500;795;795;9;355;377;2;121;1;5;115;234;8;226
244607046;500;792;792;7;346;379;1;120;2;2;116;226;12;214
244607047;600;848;848;9;374;461;1;138;7;3;128;236;23;213
244607048;600;821;822;7;358;481;4;115;2;8;105;243;10;233
244607049;500;688;688;5;284;383;1;116;6;9;101;168;8;160
244607050;500;665;665;10;281;394;3;103;2;7;94;178;7;171
244607051;400;547;547;11;256;316;2;82;1;2;79;174;10;164
244607052;500;745;745;9;318;369;1;130;5;3;122;188;12;176
244607053;300;444;444;6;189;252;1;47;2;2;43;142;14;128
244607054;300;473;475;8;185;231;2;67;0;2;65;118;8;110
244607055;700;957;957;7;339;606;2;92;0;3;89;247;13;234
244607056;400;487;487;5;217;316;1;83;0;0;83;134;6;128
244607057;400;571;571;7;226;309;2;89;4;2;83;137;11;126
244607058;400;587;588;10;241;314;1;85;1;5;79;156;10;146
244607059;700;972;972;2;440;577;1;122;0;7;115;318;17;301
244607060;600;927;927;7;449;401;1;198;2;5;191;251;16;235
244607061;300;447;447;8;139;239;1;60;5;2;53;79;6;73
244607062;600;788;788;5;287;515;1;84;5;0;79;203;7;196
244607063;300;461;461;9;220;201;2;97;3;3;91;123;3;120
244607064;300;455;455;8;180;223;1;76;0;5;71;104;4;100
244607065;400;549;549;5;199;322;2;76;0;5;71;123;11;112
244607066;400;572;576;6;208;349;2;49;0;0;49;159;6;153
244607067;400;498;498;5;177;320;1;79;2;6;71;98;8;90
244607068;400;613;613;4;201;328;1;71;1;0;70;130;3;127
244607069;500;647;647;7;246;395;2;103;3;4;96;143;7;136
244607070;400;528;528;5;135;295;3;102;12;0;90;33;2;31
244607071;600;824;825;7;128;489;1;110;9;3;98;18;2;16
244607072;300;497;498;4;100;214;7;79;7;1;71;21;1;20
244607073;600;891;892;8;224;401;3;196;12;1;183;28;1;27
244607074;500;790;790;3;123;405;1;94;14;2;78;29;0;29
244607075;500;785;786;5;156;389;2;109;8;2;99;47;0;47
244607076;400;641;643;11;138;299;2;99;9;1;89;39;5;34
244607077;700;945;948;5;160;584;5;111;4;0;107;49;3;46
244607078;200;310;310;21;104;160;1;39;0;0;39;65;3;62
244607079;300;483;485;7;186;243;1;56;1;1;54;130;3;127
244607080;700;986;986;6;541;522;6;172;5;6;161;369;19;350
244607081;500;758;759;10;370;403;3;94;4;4;86;276;12;264
244607082;400;540;541;21;248;318;1;81;1;3;77;167;7;160
244607083;400;608;608;8;338;283;1;116;5;2;109;222;10;212
244607084;500;785;785;8;408;396;1;103;4;4;95;305;10;295
244607085;500;642;643;14;320;406;2;92;1;2;89;228;15;213
244607086;100;22;22;10;32;67;1;32;0;1;31;0;0;0
244614001;500;704;704;3;312;375;1;124;2;5;117;188;7;181
244614002;500;717;718;6;291;390;1;109;3;6;100;182;4;178
244614003;500;717;718;3;289;394;2;104;0;8;96;185;9;176
244614004;500;791;793;4;292;383;1;116;1;6;109;176;6;170
244614005;500;812;812;3;318;376;2;122;11;7;104;196;17;179
244614006;500;787;787;2;278;388;1;111;4;5;102;167;6;161
244614007;500;744;745;6;233;421;1;78;2;4;72;155;9;146
244614008;500;699;699;3;276;382;1;117;0;5;112;159;8;151
244614009;500;669;669;2;245;396;4;100;3;7;90;145;5;140
244614010;500;743;743;5;290;386;1;113;2;5;106;177;8;169
244614011;500;617;617;10;212;404;1;95;1;2;92;117;5;112
244614012;500;737;737;6;259;392;1;107;4;7;96;152;12;140
244614013;500;705;706;6;232;401;1;98;0;1;97;134;5;129
244614014;500;830;830;5;284;395;1;104;2;4;98;180;8;172
244614015;500;783;785;6;273;373;2;125;5;3;117;148;7;141
244614016;500;832;832;2;300;376;1;123;5;3;115;177;8;169
244614017;500;674;674;4;279;412;1;87;4;6;77;192;19;173
244614018;500;684;684;2;214;411;4;85;4;1;80;129;6;123
244614019;500;970;974;8;236;393;2;105;7;3;95;131;7;124
244614021;500;605;606;13;252;405;1;94;0;4;90;158;5;153
244614022;500;729;729;5;227;413;2;85;4;9;72;142;6;136
244614023;500;670;670;7;260;393;6;101;6;5;90;159;11;148
244614024;500;901;901;2;201;428;1;71;2;1;68;130;9;121
244614025;500;640;640;7;220;398;1;101;4;5;92;119;5;114
244614026;500;740;740;3;231;408;1;91;1;3;87;140;6;134
244614027;500;741;743;7;263;378;3;119;2;2;115;144;8;136
244614028;500;615;619;5;223;419;1;80;0;1;79;143;4;139
244614029;500;691;692;4;204;424;2;74;1;5;68;130;11;119
244614030;500;784;787;5;242;405;2;93;10;2;81;149;8;141
244614031;500;913;914;17;378;398;2;100;1;0;99;278;21;257
244614032;500;745;746;7;343;362;1;137;3;3;131;206;11;195
244614033;500;666;667;5;252;402;1;97;4;5;88;155;7;148
244614034;500;678;678;8;276;403;1;96;4;7;85;180;9;171
244614035;500;751;752;4;284;401;3;96;1;4;91;188;15;173
244614036;500;683;683;5;258;400;1;99;2;4;93;159;7;152
244614037;500;737;738;6;238;413;1;86;0;4;82;152;20;132
244614038;500;667;668;5;277;401;3;96;2;1;93;181;10;171
244614039;500;640;642;7;227;408;1;91;1;0;90;136;18;118
244614040;500;852;852;3;361;400;6;94;5;3;86;267;15;252
244614041;500;734;735;7;258;381;1;118;0;7;111;140;7;133
244614042;500;788;788;3;292;397;1;102;0;8;94;190;12;178
244614043;500;717;717;8;308;411;1;88;4;5;79;220;11;209
244614044;500;671;672;3;271;391;1;108;1;0;107;163;17;146
244614045;500;713;713;5;314;395;2;103;1;3;99;211;8;203
244614046;500;707;707;6;291;358;3;139;3;7;129;152;5;147
244614047;500;764;764;4;351;382;1;117;0;5;112;234;12;222
244614048;500;784;784;15;335;377;3;120;1;4;115;215;20;195
244614049;500;677;677;3;296;406;2;92;4;9;79;204;12;192
244614050;500;751;752;6;298;400;1;99;0;1;98;199;13;186
244614051;500;629;629;5;251;379;2;119;4;6;109;132;10;122
244614052;500;639;639;5;264;415;1;84;2;0;82;180;10;170
244614053;500;650;650;4;281;393;2;105;0;5;100;176;17;159
244614054;500;740;740;5;317;416;1;83;3;3;77;234;16;218
244614055;500;631;631;12;383;400;2;98;3;4;91;285;13;272
244614056;500;586;586;6;328;439;1;60;2;0;58;268;8;260
244614057;500;960;960;6;386;393;1;106;4;0;102;280;12;268
244614058;500;807;808;9;396;334;3;163;2;8;153;233;13;220
244614059;500;901;902;6;379;362;1;137;4;1;132;242;15;227
244614060;500;822;823;341;341;389;1;110;1;2;107;231;8;223
244614061;500;867;862;6;352;380;1;119;1;3;115;233;13;220
244614062;500;869;869;6;316;384;4;112;3;9;100;204;10;194
244614063;500;832;832;6;337;327;4;169;0;11;158;168;10;158
244614064;500;753;753;14;348;392;1;107;1;3;103;241;10;231
244614065;500;679;679;6;248;390;1;109;3;0;106;139;8;131
244614066;500;733;733;10;278;368;2;130;1;6;123;148;14;134
244614067;500;632;632;5;269;392;6;102;5;5;92;167;7;160
244614068;500;640;640;7;293;394;1;105;0;3;102;188;21;167
244614069;500;643;643;7;258;395;1;104;1;4;99;154;13;141
244614070;500;644;646;4;231;418;1;81;1;3;77;150;10;140
244614071;500;663;663;8;240;399;1;100;1;6;93;140;14;126
244614072;500;636;637;3;251;413;1;86;0;4;82;165;7;158
244614073;500;722;723;6;236;413;1;86;2;2;82;150;4;146
244614074;500;593;594;3;311;386;1;113;1;5;107;198;10;188
244614075;500;888;889;3;190;423;1;76;4;2;70;114;8;106
244614076;500;745;745;1;185;409;4;87;3;2;82;98;5;93
244614077;500;664;664;11;251;367;8;125;3;5;117;126;5;121
244614078;500;668;668;2;238;399;3;98;5;4;89;140;13;127
244622001;400;818;821;2;255;262;1;137;6;5;126;118;8;110
244622002;400;774;774;3;280;252;2;146;6;8;132;134;10;124
244622003;300;613;613;4;210;202;1;97;4;6;87;113;4;109
244622004;500;924;924;4;342;338;1;161;0;3;158;181;12;169
244622005;300;667;666;4;218;210;1;89;3;5;81;129;6;123
244622006;400;681;682;3;260;243;5;152;4;9;139;108;9;99
244622007;400;673;673;6;235;273;1;126;3;1;122;109;10;99
244622008;400;866;866;1;73;362;1;37;0;1;36;36;3;33
244622009;300;714;716;4;104;234;3;63;2;2;59;41;5;36
244622010;400;799;802;3;97;345;1;54;3;3;48;43;1;42
244622011;400;913;913;2;95;349;1;50;2;1;47;45;0;45
244622012;400;976;976;0;144;319;3;78;3;3;72;66;0;66
244622013;400;941;941;2;78;361;1;38;3;2;33;40;0;40
244622014;300;525;525;5;130;239;1;60;4;6;50;70;1;69
244622015;300;609;609;2;191;199;1;100;0;4;96;91;8;83
244622016;400;723;723;3;132;329;1;70;1;1;68;62;2;60
244622017;300;671;671;3;143;238;1;61;4;3;54;82;5;77
244622018;200;487;487;9;154;114;1;85;2;1;82;69;3;66
244622019;200;396;398;2;127;137;1;62;3;3;56;65;11;54
244622020;300;622;623;2;141;227;1;72;0;0;72;69;3;66
244622021;200;542;543;2;127;125;1;73;0;1;72;54;4;50
244622022;200;426;428;2;120;145;1;54;1;1;52;66;0;66
244622023;200;545;546;4;133;131;1;68;0;1;67;65;7;58
244622024;200;462;462;7;118;146;1;53;0;1;52;65;2;63
244622025;200;443;444;5;113;153;1;46;1;2;43;67;3;64
244622026;200;375;375;4;146;93;1;106;5;6;95;40;3;37
244622027;200;490;490;6;161;125;2;73;1;1;71;88;3;85
244622028;200;439;440;5;145;135;1;64;2;2;60;81;2;79
244622029;300;494;494;5;186;200;1;99;4;5;90;87;4;83
244622030;300;539;541;2;190;183;1;116;3;5;108;74;4;70
254611001;500;598;598;10;233;407;1;92;0;4;88;141;8;133
254611002;500;730;730;3;275;375;0;125;3;3;119;150;6;144
254611003;500;620;621;7;260;405;1;94;4;0;90;166;8;158
254611004;500;505;506;8;227;437;2;61;2;3;56;166;16;150
254611005;500;685;686;13;270;393;1;106;0;5;101;164;6;158
254611006;500;625;625;34;113;442;1;57;1;0;56;56;3;53
254611007;500;951;951;4;390;377;2;121;5;1;115;269;14;255
254611008;500;529;530;6;229;431;1;68;1;2;65;161;3;158
254611009;500;687;687;4;263;393;1;106;2;6;98;157;9;148
254611010;500;805;806;8;297;399;2;99;1;2;96;198;6;192
254611011;500;543;544;5;222;423;1;76;2;2;72;146;8;138
254611012;500;563;563;35;246;392;6;102;6;5;91;144;6;138
254611013;500;789;789;5;298;384;1;115;2;5;108;183;9;174
254611014;500;788;788;3;348;361;2;137;6;1;130;211;14;197
254611015;500;637;637;6;281;376;2;122;2;4;116;159;5;154
254611016;500;742;743;5;281;391;1;108;0;1;107;172;13;159
254611017;500;716;719;6;301;381;2;117;3;1;113;184;13;171
254611018;500;840;840;6;330;381;1;118;2;7;109;212;5;207
254611019;500;803;803;6;341;382;1;117;2;1;114;224;7;217
254611020;500;828;828;3;295;397;1;102;1;5;96;193;10;183
254611021;500;661;661;10;260;383;1;116;3;3;110;144;8;136
254611022;500;592;593;5;213;412;1;87;4;2;81;126;4;122
254611023;500;616;616;4;216;430;1;69;1;3;65;147;7;140
254611024;500;703;703;7;283;381;1;118;2;4;112;165;11;154
254611025;500;627;628;4;238;425;1;74;0;2;72;164;5;159
254611026;500;507;507;5;175;429;1;70;0;1;69;105;9;96
254611027;500;472;473;25;209;412;1;87;2;3;82;122;8;114
254611028;500;655;657;5;288;380;1;119;2;6;111;169;10;159
254611029;500;534;534;5;205;430;1;69;2;3;64;136;17;119
254611030;500;556;556;7;220;403;1;96;3;2;91;124;4;120
254611031;500;661;661;7;216;417;1;82;1;5;76;134;7;127
254611032;500;651;651;7;280;409;3;88;1;0;87;192;12;180
254611033;500;507;507;4;198;421;1;78;3;4;71;120;8;112
254611034;500;650;651;3;260;390;2;108;1;2;105;152;12;140
254611035;500;712;712;7;273;406;1;93;2;0;91;180;4;176
254611036;500;572;572;9;233;416;1;83;0;4;79;150;6;144
254611037;500;649;649;7;229;415;1;84;1;0;83;145;6;139
254611038;500;587;588;5;180;434;2;64;1;0;63;116;7;109
254611039;500;703;704;7;246;410;1;89;3;4;82;157;9;148
254611040;500;859;859;7;274;406;1;93;5;5;83;181;7;174
254611041;500;487;488;6;187;413;1;86;1;1;84;101;2;99
254611042;500;609;609;4;269;396;1;103;1;1;101;166;4;162
254611043;500;593;594;7;199;419;1;80;4;1;75;119;9;110
254611044;500;531;531;6;212;422;2;76;3;3;70;136;5;131
254611045;500;647;647;7;262;408;1;91;4;1;86;171;16;155
254611046;500;632;632;10;225;421;1;78;1;6;71;147;7;140
254611047;500;641;641;7;242;400;1;99;0;0;99;143;6;137
254611048;500;580;580;5;244;417;0;83;3;3;77;161;11;150
254611049;500;465;466;12;180;426;1;73;2;3;68;107;14;93
254611050;500;476;477;13;185;442;2;56;0;1;55;129;10;119
254611051;500;675;677;10;267;411;3;86;2;1;83;181;10;171
254611052;500;547;548;5;234;402;1;97;1;5;91;137;6;131
254611053;500;510;510;6;187;423;0;77;0;3;74;110;4;106
254611054;500;660;661;8;280;399;1;100;0;3;97;180;9;171
254611055;500;592;593;7;279;374;1;125;6;2;117;154;11;143
254611056;500;646;648;6;24;498;1;1;0;0;1;23;0;23
254611057;500;825;826;8;136;429;3;68;4;4;60;68;5;63
254611058;500;561;565;6;35;467;3;30;5;0;25;5;2;3
254611059;500;1096;1096;6;70;455;2;43;3;1;39;27;3;24
254611060;500;978;978;10;109;448;1;51;3;1;47;58;3;55
254611061;500;992;994;5;43;467;1;32;3;0;29;11;1;10
254611062;500;971;972;5;29;475;1;24;2;0;22;5;2;3
254611063;500;609;609;8;47;467;1;32;3;0;29;15;1;14
254611064;500;956;956;5;70;430;1;69;9;2;58;1;0;1
254611065;500;865;865;3;74;439;0;61;13;0;48;13;2;11
254611066;500;856;856;5;44;462;0;38;11;0;27;6;1;5
254611067;500;859;859;4;74;463;1;36;2;0;34;38;2;36
254611068;500;579;579;6;38;472;1;27;2;1;24;11;2;9
254611069;500;562;562;6;226;419;1;80;2;3;75;146;12;134
254611070;500;535;536;4;186;415;1;84;2;4;78;102;4;98
254611071;500;925;925;6;43;467;1;32;4;0;28;11;0;11
254611072;500;347;347;2;13;486;1;13;3;0;10;0;0;0
254611073;500;494;494;7;20;481;1;18;2;0;16;2;0;2
254611080;100;25;25;12;36;64;0;36;1;1;34;0;0;0
254611081;100;33;33;39;39;61;0;39;0;1;38;0;0;0
254611082;200;77;77;80;83;116;1;83;0;8;75;0;0;0
254612001;500;996;996;7;449;349;1;150;2;2;146;299;7;292
254612002;500;910;910;6;389;329;1;170;3;6;161;219;11;208
254612003;500;893;896;12;385;360;1;139;1;5;133;246;11;235
254612004;500;864;864;9;375;328;5;167;4;11;152;208;12;196
254612005;500;785;785;8;283;383;1;116;1;2;113;167;13;154
254612006;500;630;630;5;242;404;1;95;2;3;90;153;4;149
254612007;500;746;748;6;298;380;1;119;0;1;118;179;14;165
254612008;500;633;633;6;247;340;1;159;7;9;143;88;3;85
254612009;500;697;697;9;279;374;1;125;0;5;120;154;10;144
254612010;500;617;617;9;243;385;3;112;3;3;106;131;8;123
254612011;500;619;621;7;252;390;3;107;2;7;98;145;12;133
254612012;500;433;434;9;184;427;1;72;0;3;69;112;9;103
254612013;500;534;534;4;170;421;1;78;1;2;75;92;5;87
254612014;500;591;593;7;213;399;1;100;1;3;96;113;8;105
254612015;500;671;672;9;292;382;1;117;1;4;112;175;18;157
254612016;500;673;673;8;308;383;6;111;5;4;102;197;9;188
254612017;500;961;961;9;411;188;8;304;7;11;286;107;8;99
254612018;500;612;613;6;243;398;1;101;0;3;98;142;7;135
254612019;500;511;511;5;238;408;1;91;0;3;88;147;5;142
254612020;500;628;628;6;255;407;1;92;3;2;87;163;9;154
254612021;500;654;654;5;253;420;2;78;1;4;73;175;6;169
254612022;500;808;808;6;324;393;1;106;3;0;103;218;6;212
254612023;500;891;891;7;394;336;1;163;1;11;151;231;10;221
254612024;500;656;656;10;293;376;1;123;2;1;120;170;11;159
254612025;500;762;762;8;366;365;1;134;4;7;123;232;15;217
254612026;500;617;617;8;258;384;2;114;3;4;107;144;9;135
254612027;500;841;841;8;352;357;2;141;0;6;135;211;6;205
254612028;500;719;720;5;291;333;2;165;1;6;158;126;10;116
254612029;500;685;686;7;309;374;2;124;1;3;120;185;10;175
254612030;500;767;767;7;330;389;1;110;0;3;107;220;6;214
254612031;500;732;732;6;310;374;1;125;4;6;115;185;19;166
254612032;500;788;788;4;325;376;3;121;3;6;112;204;4;200
254612033;500;680;680;10;281;359;2;139;1;4;134;142;2;140
254612034;500;620;620;15;299;388;1;111;0;10;101;188;12;176
254612035;500;669;669;3;222;394;1;105;4;3;98;117;15;102
254612036;500;679;679;6;285;393;2;105;1;2;102;180;4;176
254612037;500;518;518;17;225;398;1;101;1;2;98;124;5;119
254612038;500;649;650;3;277;386;2;112;0;5;107;165;9;156
254612039;500;689;689;6;296;352;1;147;1;5;141;149;8;141
254612040;300;386;386;32;205;230;1;69;3;3;63;136;5;131
254612041;200;16;16;68;84;115;1;84;2;6;76;0;0;0
254613001;700;715;716;13;306;595;1;104;6;1;97;202;11;191
254613002;700;744;744;8;325;563;4;133;3;4;126;192;8;184
254613003;900;911;912;27;377;733;3;164;2;5;157;213;10;203
254613004;900;863;863;11;322;751;2;147;8;7;132;175;12;163
254613005;900;874;874;3;325;742;1;157;1;6;150;168;8;160
254613006;800;854;854;9;175;741;1;58;1;1;56;117;3;114
254613007;800;780;780;6;285;695;1;104;4;4;96;181;16;165
254613008;700;703;704;4;254;582;1;117;2;1;114;137;9;128
254613009;900;862;862;2;343;758;1;141;2;7;132;202;14;188
254613010;800;850;850;17;322;661;1;138;1;7;130;184;4;180
254613011;900;929;929;22;351;755;1;144;2;6;136;207;11;196
254613012;1000;968;968;7;417;812;1;187;0;5;182;230;8;222
254613013;900;868;870;7;338;754;1;145;0;8;137;193;11;182
254613014;900;882;882;7;301;756;2;142;6;4;132;159;15;144
254613015;900;945;945;5;366;727;3;170;5;8;157;196;15;181
254613016;900;936;936;5;346;743;1;156;3;3;150;190;12;178
254613017;800;847;849;5;280;661;1;138;3;3;132;142;13;129
254613018;900;887;887;4;311;756;1;143;6;1;136;168;8;160
254613019;900;909;910;4;243;813;2;85;3;6;76;158;10;148
254613020;900;879;881;4;297;782;1;117;5;4;108;180;9;171
254613021;900;892;892;6;271;794;2;104;6;6;92;167;6;161
254613022;900;940;942;5;306;783;1;116;3;1;112;190;6;184
254613023;900;955;955;4;327;777;1;122;3;2;117;205;12;193
254613024;1000;986;986;7;339;849;1;150;3;5;142;189;16;173
254613025;1000;1006;1007;4;369;836;7;157;6;3;148;212;12;200
254613026;800;806;806;6;322;659;1;140;0;7;133;182;8;174
254613027;800;815;816;7;292;663;1;136;3;9;124;156;6;150
254613028;900;926;926;3;373;737;1;162;2;6;154;211;7;204
254613029;900;881;881;6;294;770;3;127;2;5;120;167;12;155
254613030;800;852;855;3;282;665;1;134;3;0;131;148;6;142
254613031;800;758;759;6;288;666;1;133;3;6;124;155;6;149
254613032;800;789;791;4;279;679;2;119;3;6;110;160;8;152
254613033;800;784;784;4;290;654;1;145;1;2;142;145;8;137
254613034;800;839;839;27;323;659;1;140;0;5;135;183;10;173
254613035;900;865;865;6;290;779;1;120;4;3;113;170;9;161
254613036;800;847;848;7;319;675;1;124;5;2;117;195;10;185
254613037;800;854;854;3;334;668;2;130;4;9;117;204;10;194
254613038;800;832;832;4;271;689;1;110;0;7;103;161;7;154
254613039;900;893;895;2;308;752;1;147;3;7;137;161;15;146
254613040;900;901;902;3;331;775;1;124;1;4;119;207;18;189
254613041;1000;958;960;4;372;796;1;203;2;6;195;169;7;162
254613042;900;878;878;2;337;684;2;214;2;10;202;123;8;115
254613043;900;917;919;4;345;761;1;138;5;4;129;207;16;191
254613044;1000;1015;1019;5;350;871;1;128;3;4;121;222;12;210
254613045;1000;970;972;6;367;863;1;136;0;3;133;231;12;219
254613046;700;731;732;5;265;591;1;108;1;6;101;157;3;154
254613047;800;836;836;6;310;656;1;143;3;9;131;167;10;157
254613048;800;847;847;19;332;658;1;141;4;2;135;191;13;178
254613049;800;822;824;8;305;665;2;133;1;9;123;172;9;163
254613050;800;838;840;6;309;679;1;120;9;4;107;189;12;177
254613051;700;751;751;6;286;586;2;112;4;4;104;174;6;168
254613052;600;626;627;3;243;497;1;102;1;3;98;141;4;137
254613053;800;802;804;1;293;668;1;131;9;2;120;162;14;148
254613054;800;853;854;7;367;654;1;145;2;7;136;222;18;204
254613055;600;654;654;3;266;490;2;108;1;4;103;158;12;146
254613056;900;855;856;3;228;799;1;100;3;5;92;128;5;123
254613057;900;865;867;3;287;799;1;100;3;4;93;187;6;181
254613058;700;703;703;7;251;596;1;103;3;2;98;148;6;142
254613059;800;783;784;1;262;667;2;131;3;8;120;131;6;125
254613060;800;773;774;8;233;673;1;126;4;4;118;107;6;101
254613061;600;657;658;5;231;502;1;97;1;3;93;134;14;120
254613062;500;210;713;1;208;405;1;94;3;2;89;114;5;109
254613063;900;873;874;7;333;739;2;159;2;6;151;174;18;156
254613064;900;870;870;7;266;771;1;128;7;9;112;138;9;129
254613065;900;884;884;3;309;780;1;119;3;6;110;190;8;182
254613066;700;747;748;3;237;591;1;108;1;1;106;129;9;120
254613067;800;820;820;6;268;660;1;139;3;8;128;129;10;119
254613068;800;775;775;8;301;664;1;135;4;4;127;166;11;155
254613069;800;829;831;7;256;695;1;104;2;2;100;152;11;141
254613070;600;596;596;5;210;503;1;96;0;5;91;114;8;106
254613071;600;616;616;5;245;484;1;115;2;12;101;130;11;119
254613072;100;20;20;4;24;74;2;24;0;0;24;0;0;0
254618001;600;642;643;11;286;532;1;67;1;4;62;219;14;205
254618002;900;956;956;16;484;741;3;156;6;7;143;328;9;319
254618003;700;702;702;19;362;602;2;96;6;1;89;266;17;249
254618004;700;726;726;10;312;603;1;96;1;5;90;216;9;207
254618005;700;714;714;5;330;591;2;107;2;4;101;223;9;214
254618006;800;960;960;3;405;669;1;130;2;5;123;275;13;262
254618007;600;655;657;4;249;514;1;85;3;2;80;164;9;155
254618008;700;768;771;6;306;577;1;122;1;5;116;184;8;176
254618009;800;829;829;6;329;674;6;120;5;4;111;209;6;203
254618010;700;683;684;6;324;569;1;130;0;4;126;194;8;186
254618011;700;672;674;4;238;621;1;78;2;2;74;160;8;152
254618012;700;670;670;5;272;600;1;99;3;5;91;173;8;165
254618013;600;641;641;3;282;487;1;112;0;4;108;170;14;156
254618014;600;625;625;5;233;528;1;71;3;0;68;162;6;156
254618015;600;582;582;4;219;523;1;76;3;0;73;143;9;134
254618016;800;773;773;7;316;637;1;162;6;6;150;154;15;139
254618017;600;629;629;7;257;504;2;94;1;3;90;163;7;156
254618018;600;659;659;5;280;500;1;99;4;4;91;181;8;173
254618019;700;715;716;5;247;604;4;92;4;0;88;155;13;142
254618020;700;684;684;7;293;593;2;105;1;3;101;188;16;172
254618021;600;584;584;12;229;512;1;87;0;4;83;142;7;135
254618022;800;803;803;6;322;705;1;94;2;1;91;228;6;222
254618023;600;636;637;5;226;510;1;89;1;4;84;137;17;120
254618024;800;845;845;6;363;672;2;126;4;5;117;237;17;220
254618025;500;197;529;26;222;366;4;130;4;3;123;92;3;89
254618026;700;678;678;8;269;567;2;131;7;1;123;138;8;130
254618027;500;546;547;8;228;426;1;73;1;0;72;155;8;147
254618028;700;706;706;6;271;586;1;113;2;4;107;158;8;150
254618029;600;635;635;7;298;497;1;102;2;5;95;196;13;183
254618030;600;601;602;5;243;483;1;116;1;1;114;127;5;122
254618031;600;601;602;5;299;443;3;154;3;7;144;145;7;138
254618032;700;678;678;6;229;602;1;97;1;5;91;132;11;121
254618033;500;501;501;2;190;414;1;85;0;4;81;105;3;102
254618034;700;275;715;7;282;579;1;120;2;6;112;162;10;152
254618035;500;565;565;11;282;400;1;99;0;3;96;183;5;178
254618036;800;893;893;4;400;655;1;144;2;3;139;256;11;245
254618037;700;709;711;4;320;593;1;106;1;2;103;214;9;205
254618038;700;698;699;7;285;587;1;112;8;1;103;173;5;168
254618039;700;730;731;5;272;585;3;112;8;1;103;160;9;151
254618040;600;615;617;6;250;515;1;84;2;5;77;166;13;153
254618041;700;685;686;4;269;596;1;103;3;0;100;166;12;154
254618042;700;734;734;5;343;585;1;114;2;3;109;229;14;215
254618043;600;649;650;6;262;485;1;114;3;3;108;148;11;137
254618044;700;721;721;6;293;581;1;118;4;5;109;175;9;166
254618045;100;13;14;49;56;43;1;56;5;1;50;0;0;0
254618046;600;586;586;4;251;498;1;101;2;1;98;150;8;142
254618047;500;486;486;12;200;430;1;69;2;2;65;131;11;120
254618048;700;722;722;5;348;565;2;133;6;2;125;215;14;201
254618049;800;909;909;11;380;675;2;123;2;5;116;257;7;250
254618050;800;825;825;7;419;645;3;152;2;10;140;267;13;254
254618051;700;682;683;9;270;575;4;121;4;1;116;149;8;141
254618052;600;603;603;15;230;508;3;89;2;2;85;141;6;135
254618053;500;526;526;16;243;436;2;62;2;2;58;181;12;169
254618054;800;794;794;13;354;693;1;106;1;6;99;248;20;228
254618055;800;954;954;8;442;681;1;118;2;4;112;324;15;309
254618056;500;532;533;11;209;434;1;65;4;3;58;144;3;141
254618057;600;590;591;5;267;491;1;108;5;1;102;159;9;150
254618058;500;543;543;3;229;409;1;90;3;2;85;139;6;133
254618059;500;493;493;35;211;393;3;104;3;3;98;107;3;104
254618060;500;573;573;13;210;415;1;84;6;2;76;126;5;121
254618061;900;969;970;9;461;763;1;136;4;3;129;325;17;308
254618062;800;811;811;7;394;705;1;94;1;4;89;300;14;286
254618063;600;593;593;4;304;489;1;110;1;2;107;194;10;184
254618064;600;707;707;7;325;519;3;78;2;14;62;247;14;233
254618065;600;576;576;6;260;520;2;78;0;4;74;182;9;173
254618066;600;616;616;3;233;555;1;44;0;7;37;189;11;178
254618067;500;565;566;7;215;420;1;79;1;4;74;136;10;126
254618068;500;536;536;6;254;309;1;190;0;4;186;64;1;63
254618069;600;615;615;2;259;510;1;89;0;2;87;170;6;164
254618070;600;609;609;8;283;528;1;71;1;1;69;212;12;200
254618071;600;662;662;1;265;495;1;104;5;3;96;161;7;154
254618072;100;15;15;18;28;71;1;28;2;1;25;0;0;0
254618073;100;33;33;13;39;60;1;39;2;3;34;0;0;0
254619001;800;824;824;8;318;699;1;100;2;4;94;218;11;207
254619002;500;493;493;10;220;413;5;82;4;6;72;138;7;131
254619003;800;759;760;6;240;702;1;97;3;0;94;143;5;138
254619004;800;789;789;4;180;717;1;82;2;6;74;98;7;91
254619005;700;732;735;9;230;595;1;104;6;5;93;126;6;120
254619006;700;722;722;11;157;631;1;68;3;1;64;89;6;83
254619007;700;657;657;7;231;603;2;95;1;1;93;136;8;128
254619008;500;536;538;4;197;418;3;79;4;1;74;118;10;108
254619009;700;648;648;7;239;558;1;141;7;9;125;98;12;86
254619010;600;575;575;6;199;527;1;72;0;3;69;127;11;116
254619011;600;641;641;7;240;510;1;89;4;5;80;151;4;147
254619012;300;292;292;7;95;204;1;95;5;1;89;0;0;0
254619013;500;468;468;6;157;443;1;56;1;1;54;101;6;95
254619014;700;732;732;12;271;604;1;95;1;1;93;176;13;163
254619015;900;874;874;4;273;801;1;98;2;1;95;175;6;169
254619016;500;482;482;6;171;417;3;80;2;6;72;91;11;80
254619017;700;683;684;6;229;613;1;86;4;7;75;143;9;134
254619018;700;734;736;6;262;601;1;98;2;5;91;164;13;151
254619019;600;570;570;8;210;498;1;101;4;4;93;109;4;105
254619020;600;606;607;6;239;496;1;103;1;0;102;136;10;126
254619021;700;699;700;3;254;592;1;107;3;3;101;147;6;141
254619022;700;712;712;6;268;590;1;109;9;0;100;159;5;154
254619023;900;895;897;5;296;767;1;132;5;3;124;164;7;157
254619024;800;825;825;7;286;666;1;133;6;4;123;153;6;147
254619025;900;953;953;5;400;770;1;129;3;4;122;271;21;250
254619026;700;696;696;14;269;590;1;109;8;2;99;160;12;148
254619027;700;710;711;8;301;575;1;124;0;3;121;177;10;167
254619028;700;688;689;5;242;592;2;106;2;3;101;136;9;127
254619029;499;790;790;6;291;281;1;217;6;15;196;74;12;62
254619030;800;796;797;5;319;658;2;140;1;3;136;179;10;169
254619031;800;711;711;6;254;708;1;91;5;2;84;163;6;157
254619032;700;662;662;5;225;614;1;85;2;0;83;140;8;132
254619033;800;739;739;5;270;684;1;115;1;4;110;155;8;147
254619034;800;764;764;5;265;698;1;101;1;5;95;164;9;155
254619035;900;842;845;4;333;760;1;139;5;5;129;194;6;188
254619036;700;682;682;5;278;587;2;111;11;6;94;167;11;156
254619037;700;642;644;8;238;606;1;93;3;7;83;145;12;133
254619038;900;843;843;7;335;767;1;132;0;2;130;203;9;194
254619039;900;923;923;7;379;744;2;154;4;7;143;225;8;217
254619040;800;735;735;5;310;619;6;175;5;5;165;135;9;126
254619041;700;651;651;5;241;598;1;101;0;3;98;140;8;132
254619042;600;555;555;5;197;515;1;84;1;2;81;113;14;99
254619043;700;608;608;5;202;617;1;82;2;1;79;120;12;108
254619044;600;607;608;3;211;512;1;87;1;2;84;124;6;118
254619045;800;725;727;6;236;704;1;95;1;2;92;141;13;128
254619046;800;745;748;9;207;716;1;83;6;2;75;124;3;121
254619047;600;567;571;4;232;499;1;100;0;6;94;132;11;121
254619048;700;647;647;6;231;591;2;107;1;1;105;124;7;117
254619049;800;793;795;5;351;624;2;174;4;11;159;177;6;171
254619050;700;668;670;8;212;603;1;96;4;1;91;116;13;103
254619051;600;577;578;5;213;520;2;78;0;3;75;135;4;131
254619052;700;753;754;4;271;580;1;119;5;2;112;152;7;145
254619053;800;747;747;4;283;687;1;112;0;2;110;171;11;160
254619054;800;808;809;8;191;702;1;97;6;1;90;94;12;82
254619055;900;938;938;7;290;766;9;125;9;0;116;165;6;159
254619056;800;734;735;5;265;681;4;115;3;9;103;150;12;138
254619057;800;727;727;2;256;689;1;110;4;2;104;146;12;134
254619058;800;722;723;8;241;650;2;148;7;8;133;93;9;84
254619059;800;819;821;7;290;692;3;105;3;1;101;185;15;170
254619060;800;738;738;4;286;667;1;132;6;3;123;154;13;141
254619061;700;674;674;7;263;593;2;105;1;7;97;158;7;151
254619062;600;637;637;4;225;488;1;111;6;4;101;114;4;110
254619063;800;728;730;7;275;654;1;145;5;3;137;130;7;123
254619064;700;678;679;8;254;587;1;112;2;3;107;142;5;137
254619065;900;881;881;6;310;757;1;142;2;6;134;168;8;160
254619066;700;663;665;5;235;532;1;167;5;2;160;68;2;66
254619067;700;659;661;4;240;598;5;97;4;4;89;143;8;135
254619068;800;817;817;7;337;642;1;157;0;5;152;180;5;175
254619069;800;862;863;5;355;612;1;187;6;4;177;168;15;153
254619070;800;817;818;9;346;631;1;168;5;5;158;178;11;167
254619071;700;701;701;5;140;542;20;138;19;1;118;2;0;2
254619072;700;686;692;3;207;496;1;203;18;1;184;4;0;4
254619073;900;913;912;7;387;780;1;119;3;3;113;268;11;257
254619074;800;798;798;5;307;677;1;122;6;5;111;185;8;177
254619075;900;917;918;8;348;755;1;144;2;12;130;204;13;191
254619076;800;742;743;7;301;660;1;139;1;5;133;162;9;153
254619077;800;726;726;4;256;689;1;110;3;4;103;146;3;143
254619078;700;641;641;6;236;462;2;236;4;15;217;0;0;0
254619079;700;684;684;6;205;600;1;99;5;4;90;106;4;102
254619080;800;779;781;4;276;674;4;122;2;3;117;154;10;144
254619081;800;765;766;3;235;691;3;106;1;4;101;129;10;119
254619082;900;882;884;7;326;776;1;123;5;2;116;203;12;191
254619083;900;914;907;8;341;763;1;136;5;3;128;205;11;194
254619084;700;682;683;11;236;625;1;74;2;3;69;162;5;157
254619085;600;575;578;10;249;487;2;111;2;5;104;138;9;129
254619086;700;716;716;8;268;571;1;128;5;3;120;140;9;131
254619087;700;690;690;8;254;574;1;125;3;5;117;129;6;123
254619088;700;768;768;7;302;590;1;109;4;4;101;193;15;178
254619089;900;913;913;7;366;760;3;137;7;5;125;229;19;210
254619090;900;937;938;5;412;759;2;139;1;3;135;273;19;254
254619091;900;853;853;6;264;800;1;99;4;0;95;165;16;149
254619092;700;688;689;5;199;596;1;103;3;1;99;96;3;93
254619093;700;640;643;6;258;595;1;104;6;5;93;154;5;149
254619094;685;231;685;4;235;565;2;118;6;3;109;117;7;110
254619095;600;621;621;7;235;503;1;96;5;2;89;139;14;125
254619096;800;797;797;4;284;689;1;110;0;5;105;174;11;163
254619097;800;795;796;2;285;688;1;111;3;5;103;174;13;161
254619098;900;940;940;8;404;725;1;174;8;6;160;230;11;219
254619099;900;952;952;5;354;769;1;130;1;2;127;224;15;209
254619100;900;816;816;4;340;739;1;160;4;3;153;180;12;168
254619101;900;903;904;6;367;772;1;127;2;6;119;240;14;226
254619102;900;832;832;6;331;764;1;135;9;6;120;196;17;179
254619103;900;883;884;3;343;771;1;128;0;2;126;215;14;201
254619104;900;879;881;7;345;757;1;142;8;2;132;203;14;189
254619105;900;971;971;4;399;775;1;124;3;2;119;275;9;266
254619106;900;860;862;11;336;743;2;155;0;5;150;181;11;170
254619107;900;855;858;6;296;783;1;116;4;2;110;180;4;176
254619108;700;725;726;7;299;557;1;142;3;9;130;157;9;148
254619109;900;819;821;9;325;749;1;150;6;3;141;175;17;158
254619110;900;917;917;7;322;772;1;127;5;3;119;195;10;185
254619111;800;786;786;6;299;686;1;113;4;2;107;186;8;178
254619112;600;645;645;8;250;484;5;111;4;4;103;139;11;128
254619113;600;626;626;9;257;500;2;98;5;3;90;159;11;148
254619114;800;779;779;4;256;700;1;99;2;5;92;157;12;145
254619115;900;941;941;7;326;777;1;122;5;2;115;204;3;201
254619116;600;588;588;5;213;516;1;83;3;6;74;130;7;123
254619117;700;727;727;4;266;573;1;126;8;3;115;140;6;134
254619118;600;655;655;11;253;503;1;96;1;4;91;157;13;144
254619119;700;730;730;3;259;602;1;97;3;2;92;162;8;154
254619120;700;670;673;8;244;587;1;112;0;1;111;132;12;120
254619121;800;799;799;7;311;657;1;142;1;6;135;169;15;154
254619122;900;995;995;9;429;750;1;149;5;2;142;280;20;260
254619123;800;846;847;8;346;689;1;110;2;5;103;236;15;221
254619124;800;743;743;7;292;670;1;129;2;7;120;163;10;153
254619125;600;578;580;2;197;510;1;89;2;2;85;108;4;104
254619126;700;707;708;4;248;600;1;99;0;4;95;149;7;142
254619127;700;707;707;1;274;578;1;121;2;2;117;153;6;147
254619128;700;681;681;5;258;603;3;94;2;3;89;164;12;152
254619129;800;844;844;5;280;679;1;120;2;6;112;160;13;147
254619130;800;829;829;5;347;626;1;173;2;2;169;174;10;164
254619131;300;308;308;15;133;248;1;51;3;4;44;82;5;77
254619132;700;675;679;4;158;552;1;147;18;0;129;11;0;11
254619133;100;29;29;9;38;62;0;38;0;0;38;0;0;0
254620001;800;737;737;7;251;710;1;89;5;3;81;162;3;159
254620002;600;583;583;6;199;535;3;62;3;1;58;137;8;129
254620003;700;634;634;6;206;610;1;89;3;2;84;117;2;115
254620004;600;572;574;4;201;518;1;81;4;1;76;120;6;114
254620005;900;894;894;7;333;777;2;121;3;4;114;212;17;195
254620006;900;886;888;4;327;741;1;158;6;3;149;169;7;162
254620007;700;711;712;4;290;592;2;106;1;4;101;184;8;176
254620008;700;701;702;10;279;577;1;122;6;3;113;157;3;154
254620009;800;754;754;8;219;707;1;92;5;5;82;127;4;123
254620010;800;731;731;8;244;691;2;107;2;1;104;137;8;129
254620011;800;724;724;5;252;705;1;94;4;2;88;158;12;146
254620012;800;736;736;3;243;693;1;106;1;3;102;137;10;127
254620013;800;727;727;3;257;691;1;108;2;6;100;149;12;137
254620014;900;845;846;3;262;780;1;119;5;3;111;143;6;137
254620015;700;635;635;1;199;617;2;81;7;6;68;118;9;109
254620016;800;803;803;6;253;694;1;105;3;2;100;148;11;137
254620017;700;696;697;2;214;595;1;104;1;7;96;110;6;104
254620018;700;716;716;5;250;608;2;90;4;2;84;160;8;152
254620019;800;771;771;5;260;686;1;113;2;5;106;147;8;139
254620020;600;547;547;4;149;529;1;70;3;1;66;79;7;72
254620021;600;733;735;8;217;499;1;100;4;2;94;117;3;114
254620022;900;213;825;7;213;800;3;97;4;6;87;116;5;111
254620023;800;791;791;4;240;709;1;90;1;1;88;150;10;140
254620024;800;773;774;18;297;671;1;128;3;2;123;169;18;151
254620025;700;699;699;7;250;585;1;114;2;2;110;136;7;129
254620026;700;650;653;4;173;619;1;80;4;3;73;93;9;84
254620027;600;618;618;5;226;486;3;111;4;4;103;115;18;97
254620028;800;735;735;7;309;680;2;118;2;4;112;191;12;179
254620029;700;667;667;6;275;576;2;122;2;5;115;153;11;142
254620030;800;779;779;5;311;692;1;107;12;7;88;204;11;193
254620031;800;756;756;7;335;655;1;144;5;8;131;191;12;179
254620032;700;622;622;7;203;628;1;71;3;2;66;132;8;124
254620033;800;752;752;9;307;664;1;135;4;4;127;172;5;167
254620034;600;589;589;8;234;516;1;83;3;5;75;151;8;143
254620035;800;839;839;9;376;628;1;171;1;8;162;205;12;193
254620036;800;762;762;4;284;688;2;110;4;3;103;174;10;164
254620037;700;719;719;5;302;562;2;136;3;7;126;166;13;153
254620038;900;874;874;5;341;750;1;149;4;9;136;192;13;179
254620039;700;673;674;6;252;598;1;101;0;6;95;151;6;145
254620040;900;864;864;8;185;805;1;94;5;0;89;91;4;87
254620041;900;929;929;6;232;745;1;154;5;2;147;78;2;76
254620042;900;903;903;5;337;752;1;147;0;6;141;190;11;179
254620043;900;888;888;7;305;766;1;133;0;5;128;172;10;162
254620044;700;635;635;6;213;615;1;84;2;5;77;129;6;123
254620045;600;612;615;5;105;527;2;71;2;1;68;34;2;32
254620046;900;868;868;6;257;757;8;135;8;3;124;122;11;111
254620047;800;822;822;9;281;679;1;120;0;4;116;161;15;146
254620048;200;359;359;8;139;151;2;47;2;2;43;92;4;88
254620049;800;774;776;2;316;624;2;174;4;3;167;142;7;135
254620050;900;864;866;7;339;710;2;188;7;9;172;151;5;146
254620051;400;848;850;3;322;232;1;167;4;3;160;155;6;149
254620052;800;907;907;5;347;602;2;196;3;8;185;151;6;145
254620053;500;693;693;3;272;345;1;154;1;4;149;118;11;107
254620054;300;890;890;5;74;267;1;32;0;0;32;42;2;40
254620055;500;482;482;5;170;425;1;74;0;1;73;96;8;88
254620056;600;574;574;6;216;514;2;84;3;4;77;132;6;126
254621001;500;454;455;3;178;413;1;86;0;4;82;92;8;84
254621002;500;433;434;1;172;411;1;88;0;2;86;84;5;79
254621004;500;542;542;4;217;377;1;122;2;3;117;95;5;90
254621005;500;589;590;4;329;311;2;187;6;11;170;142;15;127
254621006;500;673;673;3;232;383;2;115;2;5;108;117;10;107
254621007;500;586;586;3;193;386;1;113;2;1;110;80;6;74
254621008;500;876;877;4;351;305;2;193;5;6;182;158;6;152
254621009;500;838;839;11;354;338;2;160;4;3;153;194;9;185
254621010;500;742;742;4;283;359;1;140;3;5;132;143;7;136
254621011;500;646;646;2;227;400;1;99;4;7;88;128;8;120
254621012;500;787;787;4;235;384;1;115;0;0;115;120;10;110
254621013;500;818;818;5;231;320;11;169;2;6;161;62;1;61
254621014;500;546;547;9;189;391;1;108;3;5;100;81;2;79
254621015;500;827;828;4;266;378;3;119;2;3;114;147;7;140
254621016;500;710;711;5;232;376;1;123;5;4;114;109;8;101
254621017;500;692;692;4;218;400;2;98;1;4;93;120;10;110
254621018;500;755;756;2;258;365;1;134;2;5;127;124;8;116
254621019;500;672;672;3;236;386;1;113;6;10;97;123;3;120
254621020;500;648;648;3;132;450;1;49;1;2;46;83;3;80
254621021;500;605;605;6;165;428;2;70;3;2;65;95;6;89
254621022;500;426;426;4;122;437;1;62;0;2;60;60;3;57
254621023;500;517;519;3;148;420;1;79;3;4;72;69;2;67
254621024;500;769;769;4;324;330;1;169;4;7;158;155;14;141
254621025;500;557;557;4;285;334;2;164;7;3;154;121;5;116
254621026;500;626;628;6;215;370;1;129;3;2;124;86;2;84
254621027;500;583;583;3;179;407;1;92;4;2;86;87;5;82
254621028;500;656;656;3;178;408;1;91;5;4;82;87;1;86
254621029;500;554;555;3;291;345;1;154;2;9;143;137;9;128
254621030;500;637;639;3;264;269;1;230;11;16;203;34;1;33
254621031;500;537;537;8;258;346;2;152;8;7;137;106;6;100
254621032;500;499;500;2;158;434;1;65;2;5;58;93;9;84
254621033;500;498;499;2;197;404;1;95;4;1;90;102;7;95
254621034;500;518;518;2;180;404;1;95;3;5;87;85;6;79
254621035;500;501;502;2;176;411;1;88;6;5;77;88;11;77
254621036;500;622;622;3;240;384;1;115;0;8;107;125;7;118
254621037;500;630;630;3;225;382;1;117;2;6;109;108;8;100
254624001;500;768;768;7;366;344;4;152;3;6;143;214;14;200
254624002;600;767;767;8;386;429;2;169;0;11;158;217;4;213
254624003;800;963;964;6;397;568;1;231;3;8;220;166;7;159
254624004;700;875;875;10;412;478;1;221;2;9;210;191;15;176
254624005;1000;972;972;10;429;798;2;200;8;2;190;229;8;221
254624006;800;950;950;9;380;617;1;182;5;8;169;198;11;187
254624007;600;764;764;8;366;447;1;152;5;3;144;214;12;202
254624008;800;988;988;10;411;594;1;205;7;9;189;206;17;189
254624009;400;601;601;9;258;294;1;105;1;3;101;153;9;144
254624010;400;457;457;8;238;267;2;131;1;8;122;107;10;97
254624011;600;762;762;10;392;416;1;183;2;4;177;209;13;196
254624012;100;93;93;8;35;64;1;35;0;0;35;0;0;0
254624013;600;810;810;7;369;436;1;163;2;2;159;206;12;194
254624014;300;488;489;7;221;227;1;72;1;3;68;149;9;140
254624015;400;206;206;39;133;266;1;133;2;4;127;0;0;0
254624016;300;53;53;141;148;151;1;148;1;16;131;0;0;0
254624017;100;27;27;37;60;39;1;60;2;4;54;0;0;0
254624018;100;86;86;12;64;35;1;64;1;3;60;0;0;0
254624019;100;28;28;23;49;50;1;49;0;2;47;0;0;0
260600001;700;741;741;6;296;527;2;171;8;6;157;125;7;118
260600002;600;624;624;4;289;462;1;137;10;5;122;152;17;135
260600003;600;630;632;1;235;464;1;135;3;8;124;100;4;96
260600004;700;799;800;4;306;527;1;172;3;4;165;134;10;124
260600005;600;631;632;3;251;471;1;128;0;5;123;123;9;114
260600006;800;865;865;3;323;632;1;167;3;7;157;156;7;149
260600007;500;540;540;4;297;318;1;181;1;15;165;116;4;112
260600008;500;512;512;7;244;379;1;120;1;6;113;124;10;114
260600009;400;441;442;4;209;279;1;120;4;3;113;89;7;81
260600010;300;350;351;6;175;150;1;149;3;5;141;26;2;24
260600011;200;233;234;5;121;76;3;121;1;3;117;0;0;0
260600012;100;99;99;6;51;48;1;51;1;1;49;0;0;0
260700001;400;575;575;0;245;298;1;101;3;5;93;144;7;137
260700002;400;670;670;4;254;290;1;109;3;2;104;145;13;132
260700003;500;850;852;2;321;352;1;147;2;3;142;174;4;170
260700004;500;815;815;7;362;307;1;192;7;7;178;170;4;166
260700005;500;829;829;8;353;362;1;137;2;8;127;216;20;196
260700006;500;843;843;6;360;299;1;200;3;6;191;160;16;144
260700007;500;936;936;4;396;340;2;158;1;2;155;238;15;223
260700008;400;776;776;5;315;269;1;130;4;6;120;185;9;176
260700009;400;646;646;5;274;283;1;116;4;5;107;158;4;154
260700010;400;714;715;4;288;113;1;286;3;4;279;2;0;2
260700011;500;827;828;2;323;330;1;169;4;7;158;154;12;142
260700012;400;762;762;4;223;255;1;144;3;2;139;79;4;75
260700013;500;792;793;6;265;400;1;99;5;5;89;166;15;151
260700014;300;516;516;6;147;211;2;88;4;7;76;59;0;59
260700015;500;944;948;2;229;298;1;201;14;2;185;28;3;25
260700016;500;803;803;1;196;361;1;138;4;0;134;58;3;55
260700017;400;671;672;5;261;274;1;125;2;6;117;136;9;127
260700018;500;862;863;1;340;329;1;170;2;3;165;170;10;160
260700019;400;688;690;4;176;306;1;93;7;3;83;83;1;82
260700020;400;685;685;3;212;295;1;104;2;3;99;108;6;102
260700021;400;772;772;2;285;250;1;149;4;5;140;136;12;124
260700022;400;688;690;0;220;299;1;100;5;4;91;120;8;112
260700023;500;773;773;5;292;351;2;147;1;1;145;145;6;139
260700024;100;60;60;7;47;51;2;47;0;3;44;0;0;0
260700025;400;690;691;5;254;240;1;159;1;3;155;95;3;92
260700026;400;655;655;4;250;278;1;121;6;1;114;129;6;123
260700027;300;461;461;3;205;186;1;113;2;1;110;92;4;88
260700028;400;674;674;5;233;262;1;137;6;4;127;96;6;90
260700029;400;737;738;3;282;199;1;200;2;8;190;82;3;79
260700030;400;600;602;5;243;246;3;151;2;1;148;92;6;86
260700031;400;566;566;4;222;194;1;205;9;5;191;17;2;15
260700032;300;413;414;4;162;176;1;123;4;3;116;39;1;38
260700033;100;73;73;5;60;39;1;60;0;0;60;0;0;0
260700034;100;75;75;7;45;54;1;45;3;1;41;0;0;0
260700035;100;29;29;7;29;70;1;29;0;0;29;0;0;0
260700036;400;684;684;6;207;237;1;162;8;7;147;45;2;43
260700037;400;701;706;2;186;242;1;157;6;5;146;29;3;26
260700038;200;170;173;5;110;89;1;110;5;2;103;0;0;0
260700039;100;90;90;6;63;36;1;63;0;2;61;0;0;0
260700040;100;94;95;5;55;44;1;55;3;3;49;0;0;0
260700041;400;741;744;3;252;235;8;157;7;7;143;95;3;92
260700042;400;670;670;3;234;254;1;145;12;4;129;89;8;81
260700043;400;751;752;3;272;205;2;193;6;3;184;79;8;71
260700044;300;543;543;3;160;207;2;91;3;4;84;69;5;64
260700045;100;38;38;17;30;69;1;30;2;2;26;0;0;0
260900001;500;657;657;4;233;305;2;193;4;14;175;40;6;34
260900002;600;664;664;7;249;419;2;179;3;7;169;70;2;68
260900003;600;720;721;3;268;422;1;177;7;5;165;91;9;82
260900004;500;607;607;4;246;328;2;170;5;5;160;76;6;70
260900005;700;900;901;2;278;507;1;192;6;5;181;86;5;81
260900006;200;119;119;7;80;119;1;80;1;2;77;0;0;0
260900007;100;48;48;7;38;61;1;38;0;2;36;0;0;0
260900008;100;75;75;6;41;58;1;41;2;1;38;0;0;0
260900009;200;123;123;6;77;122;1;77;6;6;65;0;0;0
260900010;100;71;71;8;46;53;1;46;0;1;45;0;0;0
260900011;200;152;152;7;86;113;1;86;2;2;82;0;0;0
261000001;500;618;619;4;224;390;1;109;2;8;99;115;5;110
261000002;500;496;496;2;135;431;1;68;0;4;64;67;5;62
261000003;400;453;454;5;142;288;1;111;3;3;105;31;1;30
261000004;200;226;226;3;100;99;1;100;4;4;92;0;0;0
261000005;200;261;261;4;138;61;1;138;1;9;128;0;0;0
261000006;700;826;827;6;310;483;1;216;8;3;205;94;5;89
261000007;100;139;139;5;79;20;1;79;2;1;76;0;0;0
261000008;100;130;130;3;75;24;1;75;0;3;72;0;0;0
261000009;150;175;176;3;88;61;1;88;0;5;83;0;0;0
261000010;150;182;182;7;83;66;1;83;2;6;75;0;0;0
261000011;200;208;208;3;104;95;1;104;1;2;101;0;0;0
261000012;100;137;137;6;68;31;1;68;4;1;63;0;0;0
261000013;300;338;338;4;140;202;1;97;2;5;90;43;1;42
261000014;200;197;197;2;107;92;1;107;1;4;102;0;0;0
261000015;200;178;178;4;76;123;1;76;0;1;75;0;0;0
261600001;400;599;599;5;211;263;1;136;0;2;134;75;5;70
261600002;400;588;588;8;201;281;1;118;4;5;109;83;4;79
261600003;400;511;511;2;207;274;1;125;2;6;117;82;5;77
261600004;500;675;675;3;232;334;1;165;3;6;156;67;8;59
261600005;300;293;293;2;122;177;1;122;4;4;114;0;0;0
261600006;100;56;56;8;47;52;1;47;0;0;47;0;0;0
261600007;100;56;56;6;36;63;1;36;0;0;36;0;0;0
261600008;150;125;125;7;77;72;1;77;1;1;75;0;0;0
261600010;100;46;46;7;42;57;1;42;0;0;42;0;0;0
261600011;100;55;55;7;45;54;1;45;0;0;45;0;0;0
261600012;50;36;36;6;26;23;1;26;1;0;25;0;0;0
261600013;150;106;106;5;33;116;1;33;3;1;29;0;0;0
261600014;150;132;132;6;68;81;1;68;1;2;65;0;0;0
261600015;300;392;392;3;137;205;1;94;6;5;83;43;1;42
261600016;100;63;63;5;42;57;1;42;0;1;41;0;0;0
261600017;150;101;101;6;48;101;1;48;1;1;46;0;0;0
261600019;100;80;80;8;44;55;1;44;1;0;43;0;0;0
261600020;50;35;35;7;27;22;1;27;0;0;27;0;0;0
261700001;700;764;765;5;246;589;1;110;1;4;105;136;10;126
261700002;600;624;624;5;224;498;1;101;4;8;89;123;11;112
261700003;700;750;750;5;241;597;1;102;0;3;99;139;7;132
261700004;900;991;992;5;345;762;2;136;1;4;131;209;10;199
261700005;900;914;914;2;270;770;2;128;6;7;115;142;7;135
261700006;900;940;940;0;325;747;1;152;2;5;145;173;9;164
261700007;700;766;767;0;228;572;1;127;11;1;115;101;6;95
261700008;100;16;16;9;23;76;1;23;0;0;23;0;0;0
261700009;800;811;811;2;291;668;1;131;5;2;124;160;10;150
261700010;600;686;687;2;201;505;1;94;2;4;88;107;7;100
261700011;700;767;768;1;202;607;1;92;3;2;87;110;13;97
261700012;500;548;549;1;228;397;1;102;3;1;98;126;6;120
261700013;800;898;898;6;351;617;2;181;4;6;171;170;7;163
261700014;800;829;830;5;285;682;1;117;4;5;108;168;12;156
261700015;300;372;372;6;127;232;1;67;4;3;60;60;4;56
261700016;400;297;297;1;117;282;1;117;3;2;112;0;0;0
261700017;400;466;466;4;156;316;2;82;6;4;72;74;5;66
261700018;600;657;657;4;210;522;1;77;5;5;67;133;8;125
261700019;800;863;863;6;295;652;1;147;2;5;140;148;6;142
261700020;400;369;369;5;155;333;1;66;0;2;64;89;5;84
261700021;500;547;548;4;132;430;1;69;0;3;66;63;5;58
261700022;400;326;326;5;133;260;7;133;6;6;121;0;0;0
261700023;100;66;66;5;54;44;2;54;1;3;50;0;0;0
261700024;200;164;164;6;87;112;1;87;1;4;82;0;0;0
261700025;500;564;564;1;200;371;1;128;1;7;120;72;5;67
261700026;700;772;771;2;179;605;1;94;6;1;87;85;8;77
261700027;500;588;588;0;170;397;1;102;2;2;98;68;3;65
261700028;500;563;547;1;147;398;1;101;0;2;99;46;5;41
261700029;200;105;105;4;63;136;1;63;2;0;61;0;0;0
261700030;100;72;72;7;44;54;2;44;0;0;44;0;0;0
261700031;200;52;53;3;43;156;1;43;0;1;42;0;0;0
261700032;400;281;274;2;168;230;2;168;3;2;163;0;0;0
261700033;400;459;459;5;142;362;1;37;2;0;35;105;9;96
261800001;700;718;718;3;317;482;2;216;7;4;205;101;5;96
261800002;800;822;822;3;366;547;1;252;7;6;239;114;8;106
261800003;700;763;763;3;377;478;3;219;7;7;205;158;5;153
261800004;600;686;686;3;343;325;1;274;10;10;254;69;2;67
261800005;1000;979;979;7;447;669;1;330;16;5;309;117;7;110
261800006;800;873;874;3;439;556;2;242;8;7;227;197;7;190
261800007;700;732;733;4;379;430;3;267;4;5;258;112;4;108
261800008;600;692;692;12;358;379;1;220;7;5;208;138;4;134
261800009;800;811;811;2;445;539;1;260;8;8;244;185;10;175
261800010;700;792;792;4;380;473;1;226;4;4;218;154;6;148
261800011;800;864;864;3;391;535;1;264;10;5;249;127;8;119
261800013;200;146;146;7;82;117;1;82;2;0;80;0;0;0
261800014;100;72;72;7;49;50;1;49;0;1;48;0;0;0
261800015;100;51;51;7;37;62;1;37;2;1;34;0;0;0
261800016;100;85;86;7;68;30;2;68;4;0;64;0;0;0
261800017;200;134;134;7;92;107;1;92;1;2;89;0;0;0
261800018;300;259;259;7;144;155;1;144;9;3;132;0;0;0
261800019;200;165;165;7;116;83;1;116;8;1;107;0;0;0
261800020;300;295;295;5;206;92;2;206;12;2;192;0;0;0
262000001;800;874;874;5;349;550;2;248;8;3;237;101;6;95
262000002;800;857;858;6;307;588;1;211;8;5;198;96;7;89
262000003;700;724;726;3;276;518;1;181;8;5;168;95;3;92
262000004;900;913;914;8;409;601;1;298;7;7;284;111;3;108
262000005;800;865;865;6;383;523;1;276;0;4;272;107;4;103
262000006;800;840;840;1;326;573;1;226;12;4;210;100;6;94
262000007;700;745;746;7;324;473;1;226;8;2;216;98;3;95
262000008;500;531;532;7;260;328;1;171;7;1;163;89;5;84
262000009;800;864;864;3;377;555;1;244;6;2;236;133;3;130
262000010;300;366;365;7;204;109;1;190;11;0;179;14;2;12
262000011;1000;1081;1082;8;599;406;2;592;23;2;567;7;0;7
262000012;900;1022;1022;7;569;327;4;569;18;1;550;0;0;0
262000013;200;168;168;4;96;103;1;96;5;3;88;0;0;0
262000014;400;410;410;6;226;241;1;158;5;2;151;68;4;64
262000015;200;238;238;5;154;45;1;154;2;4;148;0;0;0
262000016;200;93;141;5;93;106;1;93;15;0;78;0;0;0
262000017;100;22;22;5;22;77;1;22;3;0;19;0;0;0
262000018;100;52;70;6;58;41;1;58;3;1;54;0;0;0
262000019;400;396;396;5;240;208;1;191;11;1;179;49;5;44
262000020;200;208;208;2;147;52;1;147;2;6;139;0;0;0
262000021;100;52;52;5;44;55;1;44;2;1;41;0;0;0
262000022;100;36;36;3;34;65;1;34;3;1;30;0;0;0
262000023;100;36;36;6;30;69;1;30;0;3;27;0;0;0
262000024;500;503;503;4;231;318;19;163;18;6;139;68;6;62
262000025;300;287;287;1;114;185;1;114;2;6;106;0;0;0
262000026;600;659;659;6;250;420;2;178;4;6;168;72;6;66
262000027;100;25;25;8;31;68;1;31;3;0;28;0;0;0
262000028;100;58;58;3;50;48;2;50;1;0;49;0;0;0
262000029;100;69;69;5;46;51;3;46;2;0;44;0;0;0
262000030;900;1025;1027;7;591;316;1;583;28;0;555;8;0;8
262400001;600;688;690;0;276;422;1;177;2;6;169;99;1;98
262400002;600;694;695;3;283;442;2;156;2;10;144;127;5;122
262400003;400;388;389;0;159;276;1;123;0;4;119;36;0;36
262500001;600;615;619;6;248;355;1;244;3;12;229;4;0;4
262500002;600;584;587;3;221;480;1;119;2;6;111;102;6;96
262500003;500;552;552;3;225;348;1;151;13;8;130;74;0;74
262500004;800;811;812;4;287;611;1;188;2;6;180;99;6;93
262500005;400;460;463;4;207;255;1;144;4;0;140;63;3;60
262500006;500;585;587;3;263;326;1;173;5;8;160;90;5;85
262500007;600;664;666;6;225;472;2;126;1;2;123;99;7;92
262500008;500;491;495;4;226;364;1;135;4;3;128;91;9;82
262500009;600;658;659;5;237;446;1;153;5;5;143;81;4;77
262500010;500;547;550;3;213;329;1;170;3;5;162;43;1;42
262500011;700;714;718;5;291;491;1;208;5;4;199;83;4;79
262500012;500;483;484;4;201;353;1;146;1;1;144;55;2;53
262500013;500;543;545;4;206;354;1;145;7;3;135;61;2;59
262500014;700;719;720;0;236;524;1;175;10;4;161;61;6;55
262500015;500;532;539;2;218;363;1;136;4;1;131;82;5;77
262500016;500;586;587;3;237;326;1;173;4;9;160;64;4;60
262500017;200;160;160;5;69;130;1;69;2;2;65;0;0;0
262500018;200;183;128;2;107;92;1;107;5;3;99;0;0;0
262500019;100;50;52;7;45;54;1;45;2;0;43;0;0;0
262500020;100;27;27;1;28;71;1;28;1;0;27;0;0;0
262500021;100;25;25;33;53;46;1;53;1;3;49;0;0;0
262600001;700;620;620;7;241;549;4;147;3;4;140;94;6;88
262600002;700;778;779;9;292;552;2;146;3;2;141;146;9;137
262600003;700;846;849;8;309;542;1;157;4;9;144;152;8;144
262600004;700;811;812;5;348;506;1;193;6;4;183;155;12;143
262600005;700;723;723;7;287;536;1;163;3;0;160;124;6;118
262600006;600;763;763;9;333;396;1;203;13;1;189;130;3;127
262600007;600;758;758;9;334;405;1;194;4;8;182;140;8;132
262600008;600;746;747;7;296;422;3;175;0;8;167;121;8;113
262600009;800;895;899;6;317;609;3;188;6;7;175;129;9;120
262600010;800;885;886;8;366;632;1;167;3;7;157;199;15;184
262600011;800;895;897;6;350;592;3;205;6;3;196;145;6;139
262600012;600;756;757;5;332;400;1;199;7;9;183;133;6;127
262600013;800;791;797;5;329;585;1;214;8;5;201;115;7;108
262600014;500;458;460;6;255;319;1;180;6;3;171;75;4;71
262600015;200;68;68;4;46;153;1;46;1;6;39;0;0;0
262600016;400;320;321;2;178;221;1;178;11;10;157;0;0;0
262600017;200;157;157;4;88;111;1;88;5;2;81;0;0;0
262600018;700;903;904;4;357;431;1;268;6;5;257;89;2;87
262600019;700;753;753;3;310;481;1;218;7;10;201;92;6;86
262600020;400;285;288;4;154;245;1;154;2;9;143;0;0;0
262600021;400;246;246;26;203;196;1;203;1;3;199;0;0;0
262600022;200;101;102;6;77;122;1;77;1;2;74;0;0;0
262600023;200;75;77;6;46;153;1;46;0;1;45;0;0;0
262600024;100;28;46;7;35;64;1;35;1;0;34;0;0;0
262600025;49;20;20;6;26;22;1;26;0;0;26;0;0;0
263400001;700;832;834;6;387;494;1;205;3;7;195;182;11;171
263400002;500;600;601;6;255;375;1;124;2;1;121;132;8;123
263400003;500;648;648;2;233;418;1;81;2;2;77;152;16;136
263400004;600;704;706;6;285;485;1;114;2;0;112;171;13;158
263400005;600;691;691;2;216;516;1;83;1;2;80;133;10;123
263400006;400;488;475;4;232;212;1;187;15;5;167;45;3;42
263400007;250;208;196;5;119;130;1;119;10;1;108;0;0;0
263400008;100;50;50;5;39;60;1;39;0;1;38;0;0;0
263400009;150;105;105;6;66;83;1;66;0;6;60;0;0;0
263400010;100;54;54;7;39;60;1;39;0;2;37;0;0;0
263400011;750;769;769;7;253;551;1;198;26;2;170;55;2;53
263400012;120;91;92;7;55;64;1;55;2;1;52;0;0;0
263400013;460;462;449;7;272;222;2;236;6;3;227;36;1;35
263400014;300;251;250;6;132;167;1;132;3;2;127;0;0;0
263400015;170;149;149;8;77;92;1;77;2;3;72;0;0;0
263900001;500;556;556;0;168;377;1;122;5;4;113;46;1;45
263900002;500;342;343;2;137;439;1;60;0;2;58;77;4;73
263900003;1000;830;832;6;303;807;1;192;18;2;172;111;2;109
263900004;500;601;602;3;216;346;1;153;7;1;145;61;1;60
263900005;500;691;691;4;235;354;1;145;10;1;134;90;5;85
263900006;500;573;573;2;186;372;1;127;5;1;121;59;2;57
263900007;500;677;677;0;276;373;1;126;3;1;122;150;6;144
263900008;500;753;753;5;312;282;1;217;7;3;207;95;0;95
263900009;500;653;651;5;259;359;1;140;5;3;132;119;7;112
263900010;500;471;471;0;204;397;2;101;3;0;98;103;6;97
263900011;500;434;438;2;186;406;1;93;2;1;90;93;6;87
263900012;500;523;523;5;225;374;1;125;2;4;119;100;5;95
263900013;500;629;631;3;258;399;2;99;4;2;93;159;6;153
263900014;500;689;689;4;266;369;1;130;2;0;128;136;4;132
263900015;500;572;573;8;264;363;1;136;4;5;127;128;11;117
263900016;500;654;656;0;264;374;1;125;5;5;115;141;10;129
263900017;500;586;587;3;207;400;1;99;0;1;98;108;8;100
263900018;500;577;577;5;223;361;1;138;1;8;129;85;6;79
263900019;500;495;496;4;224;395;2;103;3;1;99;121;5;116
263900020;500;493;496;4;202;396;2;102;1;5;96;100;3;97
263900021;500;479;479;3;176;398;1;101;3;3;95;75;4;71
263900022;100;28;67;6;34;65;1;34;0;0;34;0;0;0
263900023;500;381;381;3;137;405;1;94;4;0;90;43;1;42
263900024;500;691;692;3;280;362;2;136;1;4;131;144;6;138
263900025;500;704;705;2;250;369;1;130;2;1;127;120;5;115
263900026;500;621;622;3;230;398;1;101;3;3;95;129;5;124
263900027;500;651;651;1;260;251;1;248;9;5;234;12;0;12
263900028;500;580;581;6;208;386;1;113;8;3;102;95;8;87
263900029;1000;636;637;10;279;849;1;150;4;4;142;129;7;122
263900030;1000;827;828;4;348;821;1;178;6;8;164;170;8;162
263900031;1000;719;719;4;298;755;2;243;11;4;228;55;3;52
263900032;1000;887;887;8;251;774;1;225;13;0;212;26;0;26
263900033;1000;816;816;5;256;743;1;256;22;0;234;0;0;0
263900034;500;889;889;4;249;253;2;245;28;0;217;4;0;4
263900035;1000;643;644;0;214;785;1;214;17;0;197;0;0;0
263900036;1000;996;998;4;246;761;1;238;14;0;224;8;0;8
263900037;100;87;87;9;83;16;1;83;1;0;82;0;0;0
263900038;100;66;66;4;43;55;2;43;0;1;42;0;0;0
263900039;200;175;175;4;88;111;1;88;4;3;81;0;0;0
263900040;100;132;132;6;66;33;1;66;6;1;59;0;0;0
263900041;100;99;101;5;70;29;1;70;2;2;66;0;0;0
263900042;500;702;702;3;246;323;5;172;4;1;167;74;5;69
263900043;100;89;89;1;52;45;3;52;0;2;50;0;0;0
263900044;200;203;203;3;112;87;1;112;3;1;108;0;0;0
263900045;300;363;363;6;201;98;1;201;15;7;179;0;0;0
263900046;200;171;171;6;121;77;2;121;5;0;116;0;0;0
263900047;100;133;133;3;67;32;1;67;1;0;66;0;0;0
263900048;200;217;220;2;123;76;1;123;2;3;118;0;0;0
263900049;200;164;164;3;99;100;1;99;4;3;92;0;0;0
263900050;200;168;170;3;104;95;1;104;2;2;100;0;0;0
263900051;200;207;208;0;93;105;2;93;5;2;86;0;0;0
263900052;300;285;285;0;82;217;1;82;1;4;77;0;0;0
263900053;400;396;396;2;175;307;1;92;3;2;87;83;3;80
263900054;500;477;477;4;216;375;1;124;3;1;120;92;4;88
263900055;500;524;527;0;229;345;3;152;3;8;141;77;5;72
263900056;500;442;445;0;176;342;1;157;2;3;152;19;0;19
263900057;200;215;216;3;115;84;1;115;1;6;108;0;0;0
263900058;300;317;317;1;171;174;1;125;4;0;121;46;0;46
263900059;500;438;438;3;190;368;1;131;1;3;127;59;2;57
263900060;500;504;505;0;216;340;1;159;3;5;151;57;2;55
263900061;300;342;342;0;171;159;1;140;1;5;134;31;1;30
263900062;400;490;490;2;199;243;1;156;5;4;147;43;0;43
263900063;400;483;485;0;199;300;1;99;4;1;94;100;4;96
263900064;100;40;41;0;31;67;2;31;4;1;26;0;0;0
263900065;100;19;19;12;18;80;2;18;1;0;17;0;0;0
263900066;100;31;31;1;31;69;0;31;0;0;31;0;0;0
264300001;700;811;811;6;340;468;1;231;5;11;215;109;4;105
264300002;700;864;865;3;347;530;1;169;3;1;165;178;8;170
264300003;600;724;726;4;193;466;1;133;5;5;123;60;0;60
264300004;600;718;718;7;216;491;1;108;2;8;98;108;12;96
264300005;600;719;720;5;242;472;1;127;1;4;122;115;8;107
264300006;700;777;777;1;259;570;1;129;4;7;118;130;8;122
264300007;700;886;887;8;287;516;2;182;0;5;177;105;5;100
264300008;700;869;869;6;307;518;1;181;1;3;177;126;6;120
264300009;200;133;133;7;53;146;1;53;1;1;51;0;0;0
264300010;200;118;118;2;49;150;1;49;1;0;48;0;0;0
264300011;100;49;49;7;32;67;1;32;1;0;31;0;0;0
264300012;200;138;138;5;72;127;1;72;2;4;66;0;0;0
264300013;500;596;596;4;201;378;1;121;6;3;112;80;4;76
264300014;500;489;489;3;130;431;1;68;3;4;61;62;2;60
264300015;200;67;145;3;67;132;1;67;4;2;61;0;0;0
264300016;600;748;749;5;263;436;1;163;3;9;151;100;6;94
264300017;400;410;410;4;142;291;2;107;2;1;104;35;4;31
264300018;500;485;485;6;186;364;1;135;3;2;130;51;2;49
264300019;100;22;22;8;20;79;1;20;0;0;20;0;0;0
264300020;100;34;34;7;25;74;1;25;0;0;25;0;0;0
264300021;200;117;118;5;54;145;1;54;3;2;49;0;0;0
264300022;100;36;36;3;27;72;1;27;1;0;26;0;0;0
264300023;600;598;600;7;194;471;1;128;1;2;125;66;3;63
264300024;600;599;599;2;187;487;1;112;5;1;106;75;2;73
264300025;200;81;81;3;44;155;1;44;0;1;43;0;0;0
264300026;200;152;152;4;82;117;1;82;1;2;79;0;0;0
264300027;700;718;718;3;336;449;2;249;7;6;236;87;4;83
264300028;700;716;718;5;267;509;1;190;2;4;184;77;4;73
264300029;100;48;48;7;20;79;1;20;1;0;19;0;0;0
264300030;100;62;62;7;36;63;1;36;0;0;36;0;0;0
264300031;100;62;62;8;37;62;1;37;2;0;35;0;0;0
264300032;300;256;256;6;123;176;1;123;1;2;120;0;0;0
264300033;400;327;327;7;215;184;1;215;13;2;210;0;0;0
264300034;100;57;57;4;46;53;1;46;2;1;43;0;0;0
264300035;100;63;63;5;43;56;1;43;0;2;41;0;0;0
264300036;200;211;211;1;89;110;1;89;0;0;89;0;0;0
264300037;600;707;707;9;313;387;1;212;6;4;202;101;6;95
264300038;100;49;49;5;31;68;1;31;0;1;30;0;0;0
264300039;600;754;755;4;304;298;1;301;8;15;278;3;1;2
264300040;600;643;643;3;238;434;1;165;3;4;158;73;6;67
264500001;50;32;32;8;29;20;1;29;2;0;27;0;0;0
264500002;110;103;103;8;71;38;1;71;0;6;65;0;0;0
264500003;800;784;784;4;265;645;1;154;5;5;144;111;5;106
264500004;800;749;749;1;309;621;1;178;3;5;170;131;4;127
264500005;500;553;553;0;221;357;1;142;3;1;138;79;4;75
264500006;500;545;545;7;193;389;1;110;5;2;103;83;3;80
264500007;600;582;582;2;198;500;1;99;2;1;96;99;5;94
264500008;700;758;759;0;281;539;1;160;0;5;155;121;3;118
264500009;500;557;557;3;160;431;1;68;3;1;64;92;4;88
264500010;700;687;687;3;207;579;2;119;3;3;113;88;4;84
264500011;500;546;549;4;207;377;1;122;7;3;112;85;6;79
264500012;500;536;536;4;165;402;1;97;1;4;92;68;5;63
264500013;500;487;487;2;144;416;2;82;3;1;78;62;3;59
264500014;30;16;16;6;15;14;1;15;0;1;14;0;0;0
264500015;80;56;56;7;35;44;1;35;0;1;34;0;0;0
264500016;90;80;79;7;42;47;1;42;3;5;34;0;0;0
264500017;40;19;19;7;21;18;1;21;0;2;19;0;0;0
264700001;600;647;649;1;185;500;1;99;1;4;94;86;9;77
264700002;400;452;454;3;155;311;1;88;6;1;81;67;2;65
264700003;700;671;677;1;241;561;1;138;10;1;127;103;4;99
264700004;550;585;586;0;220;429;1;120;2;3;115;100;8;92
264700005;500;529;536;0;180;373;1;126;1;7;118;54;5;49
264700006;600;590;592;3;183;501;1;98;4;5;89;85;7;78
264700007;500;546;548;0;179;384;1;115;3;1;111;64;2;62
264700008;200;216;216;3;89;109;2;89;1;5;83;0;0;0
264700009;150;141;141;1;79;70;1;79;2;7;70;0;0;0
264700010;180;170;170;5;84;95;1;84;2;1;81;0;0;0
264700011;20;15;15;0;13;6;1;13;0;1;12;0;0;0
265400001;600;673;674;3;252;446;1;153;8;5;140;99;4;95
265400002;500;534;535;0;188;366;1;133;3;3;127;55;3;52
265500001;400;437;438;3;151;339;1;60;3;3;54;91;5;86
265500002;400;444;444;0;154;336;1;63;2;1;60;91;2;89
265500003;300;348;348;0;140;240;1;59;2;1;56;81;3;78
265500004;600;570;571;3;221;513;1;86;3;5;78;135;15;120
265500005;500;499;510;3;177;402;1;97;3;2;92;80;2;78
265500006;600;616;621;2;206;485;1;114;3;1;110;92;4;88
265500007;600;640;642;0;209;497;1;102;2;1;99;107;10;97
265500008;500;539;540;0;176;398;4;98;2;5;91;78;4;74
265500009;600;560;562;4;175;516;1;83;1;3;79;92;8;84
265500010;600;613;613;0;204;527;1;72;3;0;69;132;11;121
265500011;500;497;499;0;199;426;1;73;1;2;70;126;6;120
265500012;600;581;583;3;221;471;3;126;3;1;122;95;3;92
265500013;50;10;10;0;8;41;1;8;1;0;7;0;0;0
265500014;50;17;17;0;15;34;1;15;0;1;14;0;0;0
265600001;500;611;611;2;190;400;1;99;8;0;91;91;3;88
265600002;400;535;537;3;172;308;1;91;3;3;85;81;5;76
265600003;150;199;200;3;94;55;1;94;3;1;90;0;0;0
265600004;200;224;224;5;103;95;2;103;2;4;97;0;0;0
265600005;50;47;48;7;29;20;1;29;0;0;29;0;0;0
265600006;100;81;81;5;49;50;1;49;11;0;38;0;0;0
265700001;500;557;557;0;230;341;2;157;5;8;144;73;3;70
265700002;400;432;432;0;161;297;0;103;3;1;99;58;5;53
265800001;600;639;642;6;263;444;1;155;3;4;148;108;4;104
265800002;500;588;588;2;238;372;1;127;2;4;121;111;7;104
265900001;600;627;642;4;367;316;1;283;12;9;262;84;8;76
265900002;600;638;648;2;414;249;1;350;18;10;322;64;0;64
265900003;500;615;625;3;357;228;1;271;3;6;262;86;8;78
265900004;500;569;580;2;331;216;1;283;8;6;269;48;3;45
265900005;500;548;556;4;364;195;1;304;13;5;286;57;3;54
265900006;600;689;690;6;466;142;2;456;23;2;431;10;0;8
265900007;100;71;71;9;77;21;2;77;30;0;47;0;0;0
265900008;100;39;39;1;40;60;0;40;2;1;37;0;0;0
270400001;400;424;432;4;211;258;1;141;11;1;129;70;1;69
270400002;100;59;59;5;33;66;1;33;0;0;33;0;0;0
270400003;200;162;162;4;100;98;2;100;1;2;97;0;0;0
270400004;300;373;373;4;184;132;1;167;6;1;160;17;0;17
270400005;400;457;459;3;157;244;2;154;5;2;147;3;0;3
270400006;400;459;460;5;185;242;1;157;5;0;152;28;1;27
270400007;400;477;477;5;196;268;1;131;1;6;124;65;4;61
270400008;400;515;518;2;204;249;1;150;1;1;148;54;0;54
270400009;200;238;238;4;104;94;2;104;5;0;99;0;0;0
270400010;400;460;461;3;180;228;1;171;2;1;168;9;0;9
270400011;400;589;589;3;306;148;1;251;10;0;241;55;0;55
270400012;400;421;417;4;154;258;1;141;0;9;132;13;0;12
270400013;100;52;52;7;41;58;1;41;0;3;38;0;0;0
270400014;200;147;147;3;85;113;2;85;0;0;85;0;0;0
270400015;200;113;113;6;83;116;1;83;0;4;79;0;0;0
270400016;100;38;38;6;32;67;1;32;2;1;29;0;0;0
270400017;100;64;64;5;43;56;1;43;1;0;42;0;0;0
270400018;100;119;120;6;74;25;1;74;0;0;74;0;0;0
270400019;100;31;31;6;24;75;1;24;0;0;24;0;0;0
270400020;100;78;80;6;36;62;2;36;0;0;36;0;0;0
270400021;100;93;95;6;57;42;1;57;1;3;53;0;0;0
270400022;100;59;60;5;36;63;1;36;2;0;34;0;0;0
270400023;200;137;138;5;83;116;1;83;2;0;81;0;0;0
270400024;30;15;15;1;15;14;1;15;0;0;15;0;0;0
270700001;500;655;655;6;279;304;1;195;16;4;175;84;3;81
270700002;500;685;685;5;371;243;1;256;16;5;235;115;5;110
270700003;600;649;652;7;286;402;1;197;5;8;184;89;1;88
270700004;500;481;481;6;244;271;1;228;8;6;214;16;0;16
270700005;700;716;716;8;328;484;1;215;7;5;203;113;2;111
270700006;600;765;766;7;382;341;1;258;7;8;243;124;9;115
270700007;600;770;770;6;364;341;1;258;4;4;250;106;6;100
270700008;500;540;541;4;170;380;1;119;7;5;107;51;5;46
270700009;600;626;626;8;210;452;1;147;4;6;137;63;4;59
270700010;200;241;241;4;112;87;1;112;2;2;108;0;0;0
270700011;200;136;136;6;82;117;1;82;1;4;77;0;0;0
270700012;100;68;68;4;58;41;1;58;1;0;57;0;0;0
270700013;100;35;35;7;31;67;2;31;1;0;30;0;0;0
270700014;200;170;170;2;86;113;1;86;5;2;79;0;0;0
270700015;600;604;604;5;319;334;1;265;2;9;254;54;5;49
270700016;500;499;499;3;351;163;2;335;1;5;329;16;0;16
270700017;300;292;292;4;126;173;1;126;8;1;117;0;0;0
270700018;100;113;114;6;66;33;1;66;2;2;62;0;0;0
270700019;600;636;636;4;333;290;1;309;21;0;288;24;0;24
270700020;600;692;693;3;331;288;1;311;10;6;295;20;0;20
270700021;200;169;169;3;104;95;1;104;1;2;101;0;0;0
270700022;100;25;25;7;29;70;1;29;0;2;27;0;0;0
271200001;500;801;803;11;312;355;1;144;5;2;137;168;7;161
271200002;500;774;774;5;270;354;1;145;2;3;140;125;10;115
271200003;500;708;708;6;206;318;1;181;3;4;174;25;0;25
271200004;500;531;531;6;197;390;1;109;0;1;108;86;4;82
271200005;500;783;784;5;298;355;1;144;0;5;139;154;12;142
271200006;500;788;789;6;302;366;1;133;1;6;126;169;10;159
271200007;500;708;710;5;294;353;1;146;4;5;137;148;8;140
271200008;500;609;611;6;274;341;1;158;1;7;150;116;4;112
271200009;1000;917;917;8;393;824;1;175;5;2;168;218;8;210
271200010;500;642;642;8;261;375;1;124;1;5;118;137;10;127
271200011;500;840;841;7;317;355;1;144;5;5;134;173;11;162
271200012;500;653;658;6;235;394;1;105;2;5;98;130;3;127
271200013;500;677;678;8;258;382;1;117;1;4;112;141;7;134
271200014;500;837;837;8;347;338;1;161;3;6;152;186;15;171
271200015;500;660;660;7;271;355;1;144;0;0;144;127;6;121
271200016;500;706;707;4;281;372;1;127;1;4;122;154;5;149
271200017;500;679;680;6;301;387;1;112;1;1;110;189;12;177
271200018;500;645;646;8;251;381;2;117;1;8;108;133;9;124
271200019;1000;950;950;8;395;778;2;220;9;9;202;175;12;163
271200020;500;678;678;7;281;380;2;118;2;1;115;163;6;157
271200021;500;625;625;8;276;369;1;130;3;3;124;146;12;134
271200022;500;760;763;6;302;329;1;170;5;4;161;132;5;127
271200023;500;841;841;8;362;357;1;142;3;6;133;220;11;209
271200024;1000;912;915;10;378;821;2;177;5;2;170;201;9;192
271200025;500;811;812;8;288;355;2;143;6;2;135;144;9;135
271200026;500;733;734;7;222;392;2;106;4;2;100;116;5;111
271200027;500;871;872;8;304;329;2;169;5;2;162;135;7;128
271200028;500;625;625;11;184;407;1;92;5;2;85;92;0;92
271200029;500;732;734;9;223;384;1;115;4;3;108;108;4;104
271200030;500;607;608;7;186;396;2;102;1;5;96;84;5;79
271200031;500;847;847;7;253;271;1;228;5;9;214;25;0;25
271200032;500;823;866;4;254;390;1;109;5;1;103;145;9;136
271200033;500;784;788;9;274;364;1;135;4;7;124;139;9;130
271200034;500;720;721;6;277;350;1;149;12;3;134;128;5;123
271200035;500;710;711;7;259;374;1;125;1;3;121;134;1;133
271200036;500;774;777;7;250;349;2;149;7;2;140;101;7;94
271200037;500;854;855;6;377;121;3;376;35;0;341;1;0;1
271200038;1000;1040;1042;6;517;505;3;492;46;0;446;25;0;25
271200039;500;690;695;6;212;353;2;145;7;2;136;67;3;64
271200040;500;658;658;8;197;379;2;119;2;4;113;78;4;74
271200041;500;843;843;7;273;356;1;143;6;2;135;130;6;124
271200042;500;840;840;7;266;389;1;110;4;3;103;156;7;149
271200043;500;942;943;7;340;355;2;143;7;3;133;197;7;190
271200044;500;892;896;9;382;331;1;168;4;2;162;214;10;204
271200045;500;882;884;7;340;334;1;165;1;6;158;175;3;172
271200046;500;871;875;5;331;343;1;156;5;5;146;175;5;170
271200047;500;809;809;7;310;353;3;144;2;1;141;166;6;160
271200048;500;576;576;7;226;393;1;106;3;5;98;120;6;114
271200049;500;709;709;5;254;385;1;114;5;7;102;140;6;134
271200050;500;576;577;6;216;408;1;91;2;0;89;125;7;118
271200051;500;745;748;7;292;371;1;128;3;0;125;164;8;156
271200052;500;745;746;10;306;350;1;149;5;3;141;157;8;149
271200053;500;809;811;8;322;340;1;159;4;7;148;163;9;154
271200054;500;714;714;8;283;352;1;147;8;5;134;136;5;131
271200055;500;758;758;7;281;366;1;133;5;1;127;148;11;137
271200056;500;605;607;10;208;429;1;70;0;2;68;138;2;136
271200057;500;751;782;7;266;341;1;158;5;1;152;108;6;102
271200058;500;550;550;4;245;366;0;134;3;1;130;111;4;107
271200059;500;532;533;4;234;363;2;135;8;0;127;99;6;93
271200060;500;678;682;10;242;338;1;161;4;4;153;81;1;80
271200061;500;753;759;1;257;318;1;181;4;7;170;76;4;72
271200062;500;793;795;4;248;290;1;209;2;6;201;39;2;37
271200063;200;222;224;5;157;42;1;157;3;2;152;0;0;0
271200064;500;663;663;4;280;247;1;252;24;5;223;28;0;28
271200065;500;812;813;2;212;354;1;145;8;1;136;67;2;65
271200066;500;775;775;4;245;299;2;199;3;3;193;46;3;43
271200067;500;787;787;7;281;286;1;213;7;4;202;68;0;68
271200068;500;604;605;6;319;269;1;230;11;7;212;89;1;88
271200069;500;910;915;3;315;293;1;206;3;5;198;109;7;102
271200070;500;904;909;3;323;306;2;192;2;4;186;131;7;124
271200071;500;945;946;3;376;209;1;290;10;4;276;86;2;84
271200072;500;919;919;0;385;290;1;209;5;5;199;176;7;169
271200073;500;991;993;7;393;283;1;216;10;6;200;177;14;163
271200074;200;591;591;6;238;25;1;174;10;1;163;64;4;60
271200075;100;174;174;4;82;16;2;82;2;1;79;0;0;0
271200076;500;759;759;7;251;338;1;161;6;10;145;90;5;85
271200077;500;669;671;6;259;350;7;143;6;4;133;116;6;110
271200078;500;704;708;7;259;331;2;167;8;6;153;92;5;87
271200079;500;984;985;6;330;245;1;254;9;4;241;76;7;69
271200080;500;901;901;5;207;313;1;186;12;9;165;21;1;20
271200081;500;903;903;5;462;162;1;337;14;4;319;125;5;120
271200082;500;913;914;5;323;224;1;275;7;3;265;48;3;45
271200083;500;902;902;5;337;250;1;249;9;6;234;88;4;84
271200084;150;152;152;7;95;54;1;95;2;0;93;0;0;0
271200085;500;993;993;7;264;235;1;264;10;4;250;0;0;0
271200086;200;468;468;6;148;80;2;118;1;6;111;30;2;28
271200087;100;77;77;8;59;40;1;59;1;0;58;0;0;0
271200088;100;42;42;7;31;69;0;31;0;2;29;0;0;0
271200089;100;11;11;33;37;62;1;37;2;3;32;0;0;0
271200090;100;23;23;4;27;73;0;27;0;0;27;0;0;0
272200001;500;571;575;2;202;388;1;111;4;5;102;91;0;91
272200002;500;633;633;3;210;384;1;115;5;1;109;95;4;91
272200003;500;647;649;5;215;355;1;144;6;1;137;71;2;69
272200004;800;810;813;7;396;456;1;343;25;1;317;53;0;53
272200005;600;721;726;2;138;510;2;88;8;0;80;50;2;48
272200006;900;893;895;3;199;770;1;129;11;4;114;70;1;69
272200007;1000;999;1005;4;160;882;1;117;8;0;109;43;0;43
272200008;200;236;240;3;127;72;1;127;2;3;122;0;0;0
272200009;600;661;664;6;233;455;1;144;9;1;134;89;0;89
272200010;400;407;408;2;177;279;1;120;4;0;116;57;0;57
272200011;400;470;472;2;254;167;2;231;4;2;225;23;1;22
272200012;400;417;418;5;169;245;1;154;10;0;144;15;1;14
272200013;500;608;608;3;210;338;1;161;3;2;156;49;1;48
272200014;500;503;504;3;259;269;1;230;6;2;222;29;0;29
272200015;400;412;413;4;194;213;1;186;9;1;176;8;0;8
272200016;600;673;673;3;391;228;2;370;8;0;362;21;0;21
272200017;100;18;18;5;23;76;1;23;0;1;22;0;0;0
272300001;200;258;258;3;93;106;1;93;1;3;89;0;0;0
272300002;100;36;36;7;24;75;1;24;2;1;21;0;0;0
272300003;200;183;183;3;89;110;1;89;2;0;87;0;0;0
272300004;200;192;192;4;81;118;1;81;2;0;79;0;0;0
272300005;100;152;153;3;84;14;2;84;1;1;82;0;0;0
272300006;100;76;76;5;49;50;1;49;4;0;45;0;0;0
272300007;100;129;129;4;82;17;1;82;3;0;79;0;0;0
272300008;100;43;43;3;38;61;1;38;0;0;38;0;0;0
272300009;200;156;156;3;100;99;1;100;4;1;95;0;0;0
272300010;200;170;170;6;95;104;1;95;1;0;94;0;0;0
272300011;100;60;60;6;23;76;1;23;1;2;20;0;0;0
272300012;200;201;202;3;116;83;1;116;5;0;111;0;0;0
272300013;200;300;300;5;127;72;1;127;9;3;115;0;0;0
272400001;700;776;777;2;296;500;2;198;3;5;190;98;3;95
272400002;700;752;752;8;372;478;1;221;11;8;202;151;9;142
272400003;700;768;770;3;312;490;1;209;2;3;204;103;4;99
272400004;200;265;265;4;154;45;1;154;2;9;143;0;0;0
272400005;100;49;49;8;40;59;1;40;2;2;36;0;0;0
272400006;600;649;651;1;260;405;1;194;4;2;188;66;1;65
272400007;500;579;579;3;235;350;1;149;2;4;143;86;3;83
272400008;500;602;602;2;225;306;1;193;7;7;179;32;2;30
272400009;600;649;649;5;238;388;2;210;10;5;195;28;0;28
272400010;600;718;719;3;307;308;1;291;14;3;274;16;0;16
272400011;700;801;813;4;261;500;1;199;7;6;186;62;4;58
272400012;700;804;809;4;317;427;1;272;21;1;250;45;1;44
272400013;700;804;808;5;392;334;2;364;12;9;343;28;0;28
272400014;500;536;538;1;174;356;1;143;7;4;132;31;1;30
272400015;500;514;515;2;183;336;1;163;4;2;157;20;0;20
272400016;800;1096;1096;6;332;479;1;320;16;0;304;12;0;12
272400017;800;1109;1109;7;358;461;1;338;10;1;327;20;1;19
272400018;800;849;858;4;350;474;1;325;13;4;308;25;0;25
272400019;500;596;596;6;208;322;1;177;3;1;173;31;0;31
272400020;500;599;599;7;237;294;1;205;6;6;193;32;1;31
272400021;240;187;187;14;125;114;1;125;6;4;115;0;0;0
272400022;30;15;15;0;15;14;1;15;1;0;14;0;0;0
272400023;30;17;17;0;17;12;1;17;0;0;17;0;0;0
272700001;400;611;625;6;251;267;1;132;4;0;128;119;3;116
272700002;400;671;672;10;227;254;1;145;8;1;136;82;0;82
272700003;400;741;744;6;294;217;1;182;6;1;175;112;4;108
272700004;400;778;779;12;295;254;1;145;2;5;138;150;3;147
272700005;400;616;616;5;214;260;1;139;2;2;135;75;5;70
272700006;400;706;711;8;258;248;1;151;4;3;144;107;4;103
272700007;400;777;778;6;275;205;1;194;0;7;187;81;3;78
272700008;400;794;798;3;310;215;1;184;8;5;171;126;5;121
272700009;400;798;800;3;303;229;1;170;8;2;160;133;6;127
272700010;400;763;764;7;304;222;1;177;2;7;168;127;5;122
272700011;400;744;744;5;216;266;1;133;4;2;127;83;1;82
272700012;400;732;733;9;292;229;2;169;3;6;160;123;5;118
272700013;400;835;837;7;302;228;1;171;2;7;162;131;7;124
272700014;400;617;619;6;273;223;1;176;4;4;168;97;5;92
272700015;400;515;517;2;187;259;1;140;7;0;133;47;3;44
272700016;400;472;473;3;152;295;1;104;5;1;98;48;3;45
272700017;100;64;64;6;38;60;2;38;2;1;35;0;0;0
272700018;300;307;314;3;123;176;1;123;5;1;117;0;0;0
272700019;200;168;169;5;84;115;1;84;3;3;78;0;0;0
272700020;200;188;188;5;112;87;1;112;1;2;109;0;0;0
272700021;200;128;128;5;60;137;3;60;1;1;58;0;0;0
272700022;300;320;322;5;139;193;1;106;2;0;104;33;1;32
272700023;300;309;309;7;139;159;2;139;5;2;132;0;0;0
272700024;300;349;349;4;136;189;1;110;5;0;105;26;1;25
272700025;100;26;26;7;20;78;2;20;0;0;20;0;0;0
272700026;100;37;37;5;19;80;1;19;0;0;19;0;0;0
272700027;100;49;49;8;35;64;1;35;1;0;34;0;0;0
272700028;100;52;52;7;36;63;1;36;2;0;34;0;0;0
272700029;400;492;492;6;219;250;1;149;2;2;145;70;5;65
272700030;100;84;85;8;51;48;1;51;0;1;50;0;0;0
272700031;100;81;81;6;58;41;1;58;1;0;57;0;0;0
272700032;100;49;49;6;24;75;1;24;0;1;23;0;0;0
272700033;300;294;294;5;69;227;4;69;3;1;65;0;0;0
272700034;100;88;88;5;62;37;1;62;2;1;59;0;0;0
272700035;400;351;353;7;178;221;1;178;2;5;171;0;0;0
272700036;300;290;290;7;85;214;1;85;3;2;80;0;0;0
272700037;200;201;201;41;77;122;1;77;8;2;67;0;0;0
272700038;100;18;18;0;18;82;0;18;2;1;15;0;0;0
273100001;500;727;730;9;184;397;2;101;6;3;92;83;8;75
273100002;600;878;879;9;182;509;1;90;0;2;88;92;6;86
273100003;600;904;906;6;240;470;1;129;9;2;118;111;5;106
273100004;500;841;842;4;207;395;2;103;5;2;96;104;4;100
273100005;400;664;664;6;160;302;1;97;5;1;91;63;1;62
273100006;400;658;658;8;230;282;4;114;5;4;105;116;4;112
273100007;500;866;866;8;267;373;5;122;9;4;109;145;7;138
273100008;600;891;891;7;321;427;1;172;6;2;164;149;8;141
273100009;500;765;765;5;243;361;1;138;3;1;134;105;0;105
273100010;500;800;800;6;253;370;1;129;5;3;121;122;4;118
273100011;500;874;874;6;307;334;1;165;4;6;155;142;8;134
273100012;700;1089;1089;10;462;491;1;208;11;12;185;254;12;242
273100013;500;996;996;9;381;353;1;146;1;1;144;235;9;226
273100014;500;719;719;10;313;334;1;165;2;1;162;148;8;140
273100015;500;789;789;7;314;319;1;180;5;5;170;134;11;123
273100016;600;929;930;10;401;398;3;199;1;1;197;199;8;191
273100017;500;717;718;9;243;369;2;129;4;1;124;114;1;113
273100018;500;766;767;8;298;338;1;161;3;8;150;136;4;132
273100019;500;841;841;6;358;322;2;176;5;6;165;182;7;175
273100020;500;773;774;6;310;337;1;162;4;3;155;148;9;139
273100021;500;880;881;6;257;349;1;150;8;6;136;107;3;104
273100022;500;836;837;7;392;297;1;202;7;4;191;190;9;181
273100023;500;762;762;10;298;341;1;158;6;5;147;140;4;136
273100024;400;563;563;9;210;286;2;112;2;3;107;98;4;94
273100025;300;494;496;6;180;212;2;86;1;0;85;94;3;91
273100026;500;789;789;9;304;340;1;159;3;6;150;145;2;143
273100027;500;825;825;9;327;345;1;154;3;4;147;173;5;168
273100028;700;1052;1052;7;438;510;3;187;7;3;177;251;9;242
273100029;600;915;916;9;388;434;1;165;4;7;154;223;6;217
273100030;500;726;727;6;297;331;1;168;0;5;163;129;8;121
273100031;400;696;696;8;302;263;1;136;1;1;134;165;9;156
273100032;500;760;761;8;335;345;3;152;5;4;143;183;10;173
273100033;500;779;780;9;344;354;1;145;3;4;138;199;11;188
273100034;500;843;844;8;359;337;2;161;5;5;151;198;7;191
273100035;500;731;727;4;289;361;1;138;6;5;127;151;6;145
273100036;400;581;581;6;229;284;3;113;2;4;107;116;7;109
273100037;300;527;527;5;230;185;2;113;3;7;103;117;5;112
273100038;500;856;856;8;380;336;2;162;6;7;149;218;11;207
273100039;600;914;914;8;349;376;1;223;3;7;213;126;10;116
273100040;600;906;907;6;383;425;1;174;1;6;167;209;7;202
273100041;500;811;812;9;362;338;2;160;6;2;152;202;5;197
273100042;400;668;669;7;288;273;1;126;3;1;122;162;5;157
273100043;500;788;788;7;353;365;1;134;2;2;130;219;8;211
273100044;500;793;794;11;366;341;4;155;6;2;147;211;8;203
273100045;500;859;859;9;314;333;1;166;2;4;160;148;4;144
273100046;500;820;821;4;315;335;2;163;3;3;157;152;4;148
273100047;500;877;877;8;340;332;1;167;7;4;156;173;7;166
273100048;300;521;521;8;157;225;1;74;1;2;71;83;5;78
273100049;400;593;595;6;236;292;0;108;6;2;100;128;5;123
273100050;500;745;748;10;319;333;2;165;1;5;159;154;6;148
273100051;399;724;725;8;299;257;2;140;2;9;129;159;7;152
273100052;500;876;877;8;412;309;1;190;4;6;180;222;6;216
273100053;500;745;745;5;331;343;2;155;6;1;148;176;12;164
273100054;500;810;809;7;359;322;1;177;3;8;166;182;5;177
273100055;500;778;771;7;360;345;1;154;4;10;140;206;12;194
273100056;600;886;886;8;402;430;2;168;2;5;161;234;8;226
273100057;500;769;769;8;326;347;1;152;4;5;143;174;4;170
273100058;500;805;805;9;345;336;1;163;0;1;162;182;10;172
273100059;300;494;495;10;223;187;1;112;2;1;109;111;5;106
273100060;500;812;812;8;337;369;1;130;4;1;125;207;3;204
273100061;500;776;778;9;280;381;1;118;2;4;112;162;7;155
273100062;400;552;553;9;258;295;1;104;1;2;101;154;7;147
273100063;200;123;123;39;107;92;1;107;8;4;95;0;0;0
273100064;500;868;869;9;344;316;7;177;4;5;168;167;9;158
273100065;600;903;905;8;388;406;1;193;5;7;181;195;11;184
273100066;600;958;960;11;422;407;2;191;2;5;184;231;16;215
273100067;600;989;989;7;410;400;2;198;6;6;186;212;28;184
273100068;400;696;697;8;307;285;1;114;1;3;110;193;4;189
273100069;500;779;782;10;319;367;1;132;1;2;129;187;8;179
273100070;600;970;972;10;383;421;3;176;6;3;167;207;15;192
273100071;600;896;896;9;401;428;2;170;2;9;159;231;10;221
273100072;500;865;867;12;366;339;1;160;3;3;154;206;11;195
273100073;500;721;721;10;265;363;1;136;1;0;135;129;4;125
273100074;500;713;713;8;317;362;1;137;3;2;132;180;14;166
273100075;500;729;730;9;344;353;1;146;1;3;142;198;7;191
273100076;600;921;921;9;432;407;1;192;1;5;186;240;6;234
273100077;500;720;720;7;323;354;2;144;5;6;133;179;11;168
273100078;700;1109;1113;10;530;463;1;236;8;10;218;294;13;281
273100079;500;788;790;10;360;307;1;192;7;5;180;168;3;165
273100080;400;666;667;8;335;282;1;117;5;4;108;218;11;207
273100081;400;541;544;9;233;285;1;114;3;1;110;119;8;111
273100082;500;734;736;6;294;351;1;148;2;3;143;146;8;138
273100083;500;801;801;9;333;352;1;147;7;5;135;186;10;176
273100084;600;930;930;10;429;427;2;171;4;5;162;258;17;241
273100085;400;565;565;10;204;293;1;106;1;2;103;98;10;88
273100086;700;1155;1157;7;452;524;1;175;7;1;167;277;11;266
273100087;600;906;908;7;361;466;1;133;1;2;130;228;4;224
273100088;400;711;713;8;269;285;1;114;4;3;107;155;6;149
273100089;700;1150;1150;9;122;607;1;92;11;1;80;30;3;27
273100090;600;964;965;7;219;475;1;124;8;5;111;95;0;95
273100091;500;766;766;9;309;364;1;135;3;3;129;174;11;163
273100092;500;767;767;7;330;322;1;177;5;7;165;153;5;148
273100093;400;646;646;9;276;258;1;141;3;5;133;135;9;126
273100094;600;890;890;7;358;425;1;174;3;3;168;184;8;176
273100095;600;923;926;6;380;420;4;176;9;3;164;204;5;199
273100096;400;652;654;9;266;259;1;140;2;3;135;126;1;125
273100097;600;986;986;8;417;404;1;195;5;1;189;222;7;215
273100098;400;643;645;9;266;282;1;117;1;2;114;149;5;144
273100099;500;794;794;8;327;341;1;158;2;3;153;169;6;163
273100100;500;754;757;11;337;333;1;166;3;3;160;171;7;164
273100101;400;590;590;5;252;276;2;122;2;5;115;130;8;122
273100102;500;797;799;8;310;338;1;161;5;3;153;149;8;141
273100103;400;595;596;7;211;304;1;95;3;3;89;116;7;109
273100104;300;487;488;10;187;218;1;81;0;2;79;106;2;104
273100105;600;1041;1041;8;465;413;2;185;8;5;172;280;5;275
273100106;300;495;495;9;173;227;1;72;5;2;65;101;6;95
273100107;400;664;665;12;273;264;1;135;0;0;135;138;5;133
273100108;400;613;613;7;277;262;1;137;3;3;131;138;16;122
273100109;600;897;897;8;367;429;2;169;2;5;162;198;7;191
273100110;400;587;587;5;192;298;1;101;1;3;97;91;3;88
273100111;500;835;836;6;316;361;2;137;5;2;130;179;7;172
273100112;400;545;545;10;187;308;2;90;0;0;90;97;5;92
273100113;600;913;913;7;348;444;1;155;1;3;151;193;11;182
273100114;400;641;641;8;247;287;1;112;6;6;100;135;3;132
273100115;600;877;878;11;338;454;1;145;3;4;138;193;10;181
273100116;500;856;858;7;358;335;3;162;6;5;151;196;8;188
273100117;600;923;924;6;334;415;3;182;2;3;177;152;7;145
273100118;500;804;791;13;329;363;1;136;5;3;128;193;10;183
273100119;600;873;875;5;263;445;1;154;6;3;145;108;14;94
273100120;700;1037;1041;7;380;499;1;200;5;5;190;180;4;176
273100121;500;773;773;6;264;358;1;141;4;5;132;123;8;115
273100122;500;775;777;6;295;344;1;155;7;1;147;140;9;131
273100123;500;750;751;8;258;389;1;110;1;4;105;148;9;139
273100124;400;557;558;6;198;316;2;82;1;0;81;116;3;113
273100125;500;790;790;9;299;374;1;125;1;3;121;174;7;167
273100126;500;721;721;9;233;382;1;117;3;3;111;116;4;112
273100127;500;840;840;8;347;343;1;156;2;7;147;191;9;182
273100128;500;735;736;4;225;383;1;116;3;4;109;109;6;103
273100129;500;746;746;7;256;355;1;144;7;2;135;112;3;109
273100130;500;820;820;7;288;367;1;132;5;6;121;156;5;151
273100131;500;836;836;9;254;382;1;117;4;3;110;137;7;130
273100132;700;1126;1126;8;113;588;1;111;8;1;102;2;0;2
273100133;700;1092;1097;8;146;581;2;117;14;2;101;29;0;29
273100134;700;1163;1163;9;358;358;2;340;21;1;318;17;1;16
273100135;700;1148;1152;15;331;403;1;296;44;2;250;35;0;35
273100136;700;1132;1137;13;137;561;4;135;24;1;110;2;0;2
273100137;700;1023;1023;9;155;546;1;153;24;0;129;2;0;2
273100138;700;1182;1182;9;182;532;1;167;21;2;144;15;1;14
273100139;500;844;844;7;363;383;2;115;2;4;109;248;10;238
273100140;500;766;766;10;313;363;1;136;4;5;127;174;13;161
273100141;500;825;825;6;275;360;1;139;5;5;129;136;9;127
273100142;500;800;801;5;285;359;1;140;5;3;132;145;5;140
273100143;500;870;871;3;297;370;1;129;4;4;121;168;7;161
273100144;500;778;783;3;266;381;1;118;3;0;115;148;7;141
273100145;200;41;41;32;54;145;1;54;0;9;45;0;0;0
273100146;600;963;964;7;329;443;1;156;6;4;146;173;11;162
273100147;600;897;897;7;367;424;2;174;4;7;163;193;11;182
273100148;500;834;834;3;274;364;2;134;2;1;131;140;7;133
273100149;500;883;883;5;341;352;2;146;4;7;135;195;6;189
273100150;700;639;639;8;124;599;1;100;7;1;92;24;2;22
273100151;100;57;57;5;51;48;1;51;0;2;49;0;0;0
273100152;200;114;114;4;76;123;1;76;2;2;72;0;0;0
273100153;1000;938;939;4;246;770;1;229;13;1;215;17;1;16
273100154;100;68;68;6;38;61;1;38;0;0;38;0;0;0
273100155;200;137;137;5;85;114;1;85;4;1;80;0;0;0
273100156;700;625;625;4;195;537;2;161;11;0;150;34;0;34
273100157;900;793;794;5;170;772;1;127;10;0;117;43;0;43
273100158;400;320;321;4;143;255;2;143;4;6;133;0;0;0
273100159;600;541;543;4;310;353;1;246;19;3;224;64;1;63
273100160;600;494;494;4;171;504;1;95;3;2;90;76;6;70
273100161;1100;977;980;7;281;876;3;221;21;6;194;60;5;55
273100162;300;228;228;6;110;189;1;110;3;0;107;0;0;0
273100163;100;43;43;6;34;64;2;34;1;1;32;0;0;0
273100164;500;484;484;4;226;357;1;142;15;1;126;84;4;80
273100165;300;179;264;5;184;115;1;184;4;8;172;0;0;0
273100166;200;133;133;6;92;107;1;92;4;3;85;0;0;0
273100167;300;239;240;6;154;145;1;154;3;3;148;0;0;0
273100168;200;115;115;5;85;114;1;85;1;0;84;0;0;0
273100169;200;108;108;8;76;123;1;76;3;2;71;0;0;0
273100170;200;95;95;5;78;121;1;78;0;1;77;0;0;0
273100171;100;58;58;6;47;51;2;47;4;1;42;0;0;0
273100172;300;184;184;5;127;171;2;127;1;5;121;0;0;0
273100173;100;80;80;7;67;32;1;67;1;2;64;0;0;0
273100174;100;78;78;4;69;28;3;69;4;2;63;0;0;0
273100175;500;414;414;6;190;394;1;105;3;0;102;85;5;80
273100176;100;50;50;5;38;60;2;38;0;0;38;0;0;0
273100177;500;458;458;5;211;403;1;96;2;3;91;115;4;111
273100178;700;636;636;3;265;563;2;135;6;1;128;130;8;122
273100179;600;541;542;4;219;492;1;107;1;4;102;112;10;102
273100180;600;485;486;7;149;489;1;110;7;2;101;39;0;39
273100181;400;326;327;2;178;220;2;178;7;4;167;0;0;0
273100182;300;89;173;6;95;204;1;95;0;3;92;0;0;0
273100183;800;740;741;14;329;539;1;260;21;2;237;69;1;68
273100184;400;363;363;6;181;216;3;181;3;5;173;0;0;0
273100185;200;101;101;6;78;121;1;78;2;0;76;0;0;0
273100186;100;55;55;7;47;52;1;47;0;0;47;0;0;0
273100187;200;92;92;8;70;129;1;70;0;0;70;0;0;0
273100188;300;219;219;5;119;180;1;119;3;2;114;0;0;0
273100189;100;31;32;8;20;79;1;20;1;0;19;0;0;0
273100190;200;117;118;5;61;138;1;61;4;2;55;0;0;0
273100191;300;283;282;4;126;173;1;126;8;3;115;0;0;0
273100192;300;205;205;4;114;184;2;114;2;1;111;0;0;0
273100193;300;224;224;4;128;171;1;128;8;1;119;0;0;0
273100194;200;107;107;5;75;124;1;75;3;0;72;0;0;0
273100195;700;624;624;6;264;482;1;217;11;2;204;47;1;46
273100196;500;395;396;5;221;337;6;157;5;4;148;64;4;60
273100197;700;618;618;5;225;558;1;141;7;3;131;84;3;81
273100198;200;192;192;6;83;116;1;83;1;3;79;0;0;0
273100199;200;106;106;5;70;129;1;70;1;3;66;0;0;0
273100200;600;492;493;3;195;442;1;157;4;1;152;38;3;35
273100201;800;774;775;9;381;467;1;332;19;2;311;49;3;46
273100202;300;228;230;2;156;143;1;156;5;3;148;0;0;0
273100203;300;252;252;4;86;213;1;86;6;5;75;0;0;0
273100204;500;740;743;9;302;360;1;139;2;3;134;163;8;155
273100205;600;977;977;6;387;459;1;140;4;10;126;247;7;240
273100206;300;27;27;77;90;209;1;90;3;7;80;0;0;0
273100207;200;33;33;8;34;165;1;34;2;2;30;0;0;0
273100208;100;44;44;25;65;34;1;65;8;3;54;0;0;0
273100209;100;55;55;12;65;31;4;65;3;1;61;0;0;0
273100210;100;29;29;9;35;63;2;35;0;0;35;0;0;0
273600001;500;668;669;7;260;353;1;146;1;5;140;114;7;107
273600002;500;730;733;9;200;400;1;99;4;1;94;101;4;97
273600003;500;765;767;0;228;325;1;174;7;0;167;54;1;53
273600004;500;712;716;7;274;319;1;180;12;4;164;94;5;89
273600005;500;722;723;5;261;329;2;169;5;2;162;92;1;91
273600006;600;666;669;7;351;259;1;340;13;3;324;11;0;11
273600007;800;828;831;7;348;458;1;341;21;1;319;7;0;7
273600008;500;660;662;2;149;391;1;108;8;2;98;41;3;38
273600009;500;697;697;4;174;379;2;119;6;1;112;55;2;53
273600010;500;713;720;5;232;370;4;126;4;1;121;106;3;103
273600011;500;741;743;3;207;371;1;128;9;2;117;79;0;79
273600012;500;586;587;3;209;395;2;103;4;3;96;106;6;100
273600013;500;669;669;0;232;384;1;115;4;3;108;117;11;106
273600014;500;567;570;7;176;382;1;117;7;2;108;57;0;57
273600015;500;700;700;5;226;371;1;128;1;8;119;98;7;91
273600016;500;605;605;4;206;379;1;120;5;4;111;86;4;82
273600017;500;545;545;6;236;363;1;136;6;4;126;99;1;98
273600018;500;847;847;4;204;389;1;110;8;3;99;94;1;93
273600019;100;15;15;6;10;89;1;10;0;1;9;0;0;0
273600020;500;544;544;5;302;239;1;260;11;0;249;42;3;39
273600021;500;487;487;4;257;260;4;236;24;1;211;21;1;20
273600022;200;171;174;5;84;115;1;84;6;1;77;0;0;0
273600023;100;48;49;8;38;61;1;38;1;0;37;0;0;0
273600024;200;112;114;5;48;151;1;48;3;1;44;0;0;0
273600025;500;798;801;8;366;136;1;363;40;1;322;3;0;3
273600026;500;516;517;6;174;346;1;153;7;0;146;21;0;21
273600027;100;57;57;5;32;67;1;32;2;0;30;0;0;0
273600029;100;53;53;4;25;75;0;25;0;2;23;0;0;0
273600030;200;135;135;6;90;106;4;90;3;0;87;0;0;0
273600031;200;116;116;6;88;111;1;88;3;0;85;0;0;0
273600032;600;675;681;4;344;411;1;188;7;1;180;156;0;156
273600033;200;125;125;4;92;107;1;92;1;1;90;0;0;0
273600034;200;155;155;4;83;116;1;83;5;0;78;0;0;0
273600035;400;334;334;4;107;297;1;102;1;2;99;5;2;3
273600036;200;169;169;3;75;123;2;75;4;3;68;0;0;0
273600037;100;95;95;4;68;31;1;68;3;1;64;0;0;0
273600038;100;58;58;5;44;55;1;44;1;0;43;0;0;0
273600040;100;25;25;1;25;75;0;25;1;0;24;0;0;0
273700001;500;742;743;7;324;275;1;224;14;2;208;100;3;97
273700002;500;786;793;3;306;294;1;205;10;6;189;101;2;99
273700003;500;826;829;5;370;208;1;291;26;1;264;79;1;78
273700004;400;609;611;8;232;192;3;205;11;2;192;27;1;26
273700005;500;812;817;2;278;232;3;265;13;2;250;13;3;10
273700006;200;303;304;5;100;133;2;65;4;2;59;35;2;33
273700007;100;28;28;6;15;84;1;15;0;1;14;0;0;0
273700008;100;18;18;8;19;80;1;19;0;3;16;0;0;0
273700009;100;13;13;7;12;87;1;12;0;1;11;0;0;0
273700010;100;22;22;0;21;78;1;21;4;0;17;0;0;0
273700011;100;11;11;0;11;88;1;11;0;0;11;0;0;0
273800001;500;754;754;4;315;262;1;237;9;2;226;78;6;72
273800002;500;741;749;3;257;300;1;199;7;2;190;56;2;54
273800003;500;837;837;3;317;185;1;314;27;0;287;3;0;3
273800004;500;313;313;6;187;312;1;187;8;1;178;0;0;0
273800005;500;631;635;7;244;270;1;229;8;2;219;15;2;13
273800006;400;418;418;5;212;200;1;199;11;5;183;13;0;13
273800007;100;21;21;0;20;79;1;20;0;0;20;0;0;0
280200001;250;629;633;2;215;71;1;178;7;6;165;37;3;34
280200002;250;647;647;4;171;114;2;134;4;0;130;37;1;36
280200003;100;54;54;4;28;70;2;28;0;0;28;0;0;0
280200004;50;19;19;3;16;33;1;16;0;0;16;0;0;0
280200005;50;26;26;6;25;24;1;25;0;0;25;0;0;0
280200006;100;66;67;6;47;52;1;47;1;0;46;0;0;0
280200007;100;47;49;6;34;65;1;34;0;0;34;0;0;0
280200008;50;26;26;6;21;28;1;21;1;0;20;0;0;0
280200009;50;20;20;8;21;28;1;21;1;1;19;0;0;0
280200010;50;31;31;7;23;26;1;23;0;0;23;0;0;0
280200011;100;49;51;5;30;68;2;30;1;2;27;0;0;0
280200012;200;243;246;6;106;93;1;106;8;2;96;0;0;0
280200013;300;342;342;3;164;135;1;164;9;0;155;0;0;0
280200014;100;78;78;4;47;52;1;47;0;0;47;0;0;0
280200015;100;67;67;5;36;63;1;36;2;1;33;0;0;0
280200016;130;120;121;6;66;63;1;66;6;0;60;0;0;0
280200017;50;47;47;2;29;20;1;29;0;0;29;0;0;0
280200018;120;91;91;5;50;69;1;50;2;1;47;0;0;0
280200019;220;289;292;5;134;85;1;134;1;1;132;0;0;0
280200020;100;55;55;6;31;68;1;31;0;1;30;0;0;0
280200021;50;24;24;6;17;32;1;17;0;0;17;0;0;0
280200022;150;174;174;7;86;63;1;86;8;1;77;0;0;0
280200023;150;182;182;5;100;49;1;100;0;0;100;0;0;0
280200024;120;79;79;6;53;66;1;53;2;1;50;0;0;0
280200025;100;59;59;7;38;61;1;38;0;0;38;0;0;0
280200026;160;189;190;5;91;68;1;91;2;5;84;0;0;0
280200027;50;28;28;5;16;33;1;16;0;0;16;0;0;0
280200028;50;20;20;7;25;24;1;25;1;0;24;0;0;0
280200029;200;208;208;6;100;99;1;100;2;4;94;0;0;0
280200030;50;37;37;6;14;35;1;14;0;0;14;0;0;0
280200031;130;111;117;7;50;79;1;50;1;1;48;0;0;0
280200032;300;356;356;3;153;174;1;125;0;0;125;28;0;28
280200033;50;30;30;4;19;30;1;19;0;0;19;0;0;0
280200034;150;184;190;6;106;42;2;106;3;1;102;0;0;0
280200035;350;663;684;5;295;57;1;292;6;3;283;3;0;3
280200036;50;30;25;5;19;30;1;19;0;0;19;0;0;0
280200037;120;86;86;5;57;62;1;57;1;1;55;0;0;0
280200038;120;83;83;5;48;71;1;48;0;2;46;0;0;0
280200039;80;38;38;8;29;50;1;29;1;0;28;0;0;0
280200040;100;58;58;0;57;43;0;57;0;0;57;0;0;0
282200001;600;655;655;4;280;407;1;192;5;9;178;88;4;84
282200002;600;600;600;7;213;459;2;139;0;2;137;74;4;70
282200003;800;976;981;5;345;494;1;305;14;16;275;40;1;39
282200004;600;616;616;7;187;458;1;141;2;4;135;46;0;46
282200005;600;650;655;8;205;452;1;147;2;3;142;58;8;50
282200006;600;582;582;8;176;471;1;128;12;4;112;48;3;45
282200007;600;749;750;6;188;420;1;179;7;2;170;9;1;8
282200008;800;819;822;8;130;669;1;130;15;1;114;0;0;0
282200009;900;1105;1107;8;267;636;1;263;14;2;247;4;0;4
282200010;600;651;651;2;200;435;1;164;1;1;162;36;1;35
282200011;700;734;734;8;155;581;1;118;2;2;114;37;2;35
282200012;900;958;965;5;219;680;1;219;22;2;195;0;0;0
282200013;300;243;243;5;118;181;1;118;1;0;117;0;0;0
282200014;300;325;326;8;130;170;1;129;1;2;126;1;0;1
282200015;600;692;692;9;190;409;1;190;6;1;183;0;0;0
282200016;500;464;464;5;193;306;1;193;4;4;185;0;0;0
282200017;200;133;133;7;68;131;1;68;1;1;66;0;0;0
282200018;300;301;301;5;163;136;1;163;2;1;160;0;0;0
282200019;700;878;878;11;260;476;1;223;8;2;213;37;1;36
282200020;400;342;343;6;148;251;1;148;4;0;144;0;0;0
282200021;400;414;417;5;144;260;1;139;2;1;136;5;2;3
282200022;300;262;262;6;113;186;1;113;0;0;113;0;0;0
282200023;200;165;165;5;89;110;1;89;0;2;87;0;0;0
282200024;300;230;230;7;79;220;1;79;2;2;75;0;0;0
282200025;300;293;293;7;118;181;1;118;2;2;114;0;0;0
282200026;400;422;423;5;232;167;1;232;6;6;220;0;0;0
282200027;200;203;203;7;75;124;1;75;1;2;72;0;0;0
282200028;700;795;798;10;216;500;1;199;11;4;184;17;1;16
282200029;600;260;695;7;260;339;1;260;12;9;239;0;0;0
282200030;200;234;234;4;101;97;2;101;1;0;100;0;0;0
282200031;500;493;493;4;192;314;1;185;6;1;178;7;0;7
282200032;600;646;654;5;217;417;1;182;10;2;170;35;2;33
282200033;600;575;583;7;224;398;2;200;9;2;189;24;1;23
282200034;300;276;277;6;99;200;1;99;6;2;91;0;0;0
282200035;500;599;599;5;222;289;2;209;3;2;204;13;0;13
282200036;200;218;218;7;106;92;2;106;0;3;103;0;0;0
282200037;500;536;536;7;156;344;1;155;8;1;146;1;0;1
282200038;700;837;837;10;254;451;1;248;15;2;231;6;0;6
282200039;300;366;367;6;125;182;1;117;0;1;116;8;1;7
282200040;200;138;138;6;89;110;1;89;0;0;89;0;0;0
282200041;200;170;170;7;81;117;2;81;2;1;78;0;0;0
282200042;600;781;781;7;247;357;1;242;11;2;229;5;0;5
282200043;200;219;220;6;113;86;1;113;4;0;109;0;0;0
282200044;500;708;708;10;230;269;1;230;11;2;217;0;0;0
282200045;300;284;284;5;135;164;1;135;1;1;133;0;0;0
282200046;300;313;313;5;91;208;1;91;1;2;88;0;0;0
282200047;300;271;272;8;129;168;3;129;1;1;127;0;0;0
282200048;100;60;60;6;23;76;1;23;0;0;23;0;0;0
282200049;200;125;129;5;67;132;1;67;3;0;64;0;0;0
282200050;100;69;69;5;33;66;1;33;0;0;33;0;0;0
282200051;700;918;918;12;249;449;2;249;12;5;232;0;0;0
282200052;400;421;421;5;161;238;1;161;1;1;159;0;0;0
282200053;100;22;22;14;36;63;1;36;3;1;32;0;0;0
282200054;100;14;14;4;18;81;1;18;1;0;17;0;0;0
282200055;100;24;24;2;26;73;1;26;1;0;25;0;0;0
282200056;100;20;20;4;24;75;1;24;0;0;24;0;0;0
282200057;100;12;12;6;18;81;1;18;0;0;18;0;0;0
282300001;400;534;539;5;249;185;1;214;4;8;202;35;3;32
282300002;400;515;525;2;246;181;1;218;3;15;200;28;5;23
282300003;700;736;748;3;357;364;1;335;10;4;321;22;3;19
282300004;400;446;446;4;222;210;1;189;4;5;180;33;2;31
282300005;700;806;820;9;414;290;1;409;11;6;392;5;1;4
282300006;300;352;356;6;205;95;1;204;5;2;197;1;0;1
282300007;500;552;553;6;230;269;1;230;5;4;221;0;0;0
282300008;500;483;484;4;169;334;1;165;4;2;159;4;0;4
282300009;300;293;293;4;145;154;1;145;4;1;140;0;0;0
282300010;400;449;449;5;221;189;1;210;7;4;199;11;1;10
282300011;300;403;407;7;207;92;1;207;7;4;196;0;0;0
282300012;100;51;51;3;53;47;0;53;1;0;52;0;0;0
282400001;600;694;695;8;233;480;2;118;1;9;108;115;11;104
282400002;500;612;612;8;170;389;1;110;1;14;95;60;7;53
282400003;600;718;720;6;231;466;1;133;5;12;116;98;9;89
282400004;600;639;639;9;257;463;1;136;3;14;119;121;11;110
282400005;800;943;945;8;235;653;1;146;6;15;125;89;11;78
282400006;700;858;859;6;252;514;1;185;1;18;166;67;9;58
282400007;600;772;773;10;126;508;1;91;4;4;83;35;8;27
282400008;600;791;791;8;103;512;2;86;2;1;83;17;0;17
282400009;800;915;915;7;273;642;1;157;2;12;143;116;8;108
282400010;600;754;755;7;218;475;1;124;4;14;106;94;17;77
282400011;500;588;588;2;154;421;1;78;0;10;68;76;9;67
282400012;600;764;764;8;241;468;1;131;2;11;118;110;10;100
282400013;700;760;764;9;223;563;1;136;1;12;123;87;9;77
282400014;600;634;634;10;201;480;1;119;2;10;107;82;15;67
282400015;700;737;737;8;219;547;1;152;2;7;143;67;8;59
282400016;700;771;772;6;225;551;1;148;4;8;136;77;8;69
282400017;700;776;776;6;199;558;1;141;4;10;127;58;6;52
282400018;700;716;716;6;203;582;1;117;1;7;109;86;11;75
282400019;200;223;224;8;123;76;1;123;2;7;114;0;0;0
282400020;200;191;191;7;73;126;1;73;1;11;61;0;0;0
282400021;500;511;511;8;80;420;4;76;3;4;69;4;1;3
282400022;100;103;103;8;48;51;1;48;0;1;47;0;0;0
282400023;100;69;70;9;52;47;1;52;5;0;47;0;0;0
282400024;100;83;83;6;44;55;1;44;0;3;41;0;0;0
282400025;400;498;498;3;136;288;1;111;4;4;103;25;1;24
282400026;500;537;537;6;162;361;2;137;5;6;126;25;2;23
282400027;500;507;507;4;159;348;1;151;5;6;140;8;0;8
282400028;200;202;202;7;75;124;1;75;1;1;73;0;0;0
282400029;400;377;377;5;88;329;1;70;5;1;64;18;3;15
282400030;300;338;338;4;65;235;1;64;2;1;61;1;0;1
282400031;100;80;80;7;43;56;1;43;2;2;39;0;0;0
282400032;700;742;742;7;217;506;1;194;3;5;185;23;0;23
282400033;200;174;174;6;107;92;1;107;1;3;103;0;0;0
282400034;100;106;106;5;39;60;1;39;1;2;36;0;0;0
282400035;400;398;398;8;89;320;1;79;6;3;70;10;1;9
282400036;600;697;698;8;67;546;1;53;0;2;51;11;2;9
282400037;500;480;486;3;194;320;1;179;9;10;160;15;0;15
282400038;300;287;287;8;153;146;1;153;2;9;142;0;0;0
282400039;100;31;31;8;18;81;1;18;0;0;18;0;0;0
282400040;600;690;691;9;133;489;1;110;10;4;96;23;0;23
282400041;100;50;50;6;38;61;1;38;0;2;36;0;0;0
282400042;400;461;463;2;212;219;1;180;5;10;165;32;3;29
282400043;100;73;73;7;34;65;1;34;0;3;31;0;0;0
282400044;300;306;307;7;183;116;1;183;3;4;176;0;0;0
282400045;100;125;125;7;70;29;1;70;1;3;66;0;0;0
282400046;500;588;588;5;168;345;1;154;5;12;137;14;1;13
282400047;800;862;862;7;178;653;2;145;2;6;137;33;4;29
282400048;600;691;691;9;143;479;1;120;5;14;101;23;2;21
282400049;200;193;193;6;50;149;1;50;1;0;49;0;0;0
282400050;100;112;112;8;63;36;1;63;2;1;60;0;0;0
282400051;100;14;14;0;14;85;1;14;0;1;13;0;0;0
283500001;500;767;767;8;309;332;1;167;3;8;156;142;15;127
283500002;500;606;606;9;216;375;1;124;9;4;111;92;2;90
283500003;500;637;637;10;221;373;1;126;2;4;120;95;5;90
283500004;500;894;896;7;330;301;2;197;5;10;182;133;10;123
283500005;500;657;657;7;254;342;1;157;4;9;144;97;8;89
283500006;500;758;760;8;283;315;1;184;3;10;171;99;8;91
283500007;500;715;715;5;258;349;1;150;2;7;141;108;9;99
283500008;500;707;710;7;237;294;1;205;9;4;192;32;2;30
283500009;500;656;657;7;261;314;1;185;8;6;171;76;5;71
283500010;500;749;749;6;240;346;2;152;2;2;148;88;5;83
283500011;500;866;868;8;304;286;1;213;5;9;199;91;5;86
283500012;500;622;622;7;228;350;1;149;4;5;140;78;5;73
283500013;500;928;929;7;347;273;1;226;3;1;222;121;6;115
283500014;500;928;929;7;349;317;1;182;2;11;169;167;11;156
283500015;500;906;907;9;392;262;1;237;4;7;226;155;6;149
283500016;500;782;782;8;285;315;1;184;6;10;168;101;5;96
283500017;500;800;800;5;300;230;1;269;2;8;259;31;1;30
283500018;500;862;862;5;329;319;1;180;3;6;171;149;9;140
283500019;500;765;766;6;337;291;1;208;4;3;201;129;0;129
283500020;500;692;695;10;287;295;2;203;3;10;190;79;3;76
283500021;500;940;941;8;359;325;1;174;3;10;161;185;10;175
283500022;500;975;976;8;396;279;1;220;7;6;207;176;10;166
283500023;500;921;921;7;350;294;1;205;3;6;196;145;12;133
283500024;500;625;626;7;231;357;1;142;10;4;128;89;5;84
283500025;500;922;924;5;331;290;1;209;5;12;192;122;10;112
283500026;500;733;735;10;324;345;1;154;4;6;144;170;7;163
283500027;500;899;900;8;361;251;1;248;3;2;243;113;5;108
283500028;500;573;573;9;221;391;1;108;2;4;102;113;7;106
283500029;500;665;665;8;282;347;1;152;2;12;138;130;10;120
283500030;500;548;549;8;231;385;3;112;0;5;107;119;7;112
283500031;500;681;683;8;281;346;1;153;3;6;144;128;7;121
283500032;500;734;736;9;310;317;1;182;6;2;174;128;4;124
283500033;500;660;662;9;280;366;1;133;3;4;126;147;6;141
283500034;500;744;744;9;323;335;1;164;4;8;152;159;6;153
283500035;500;893;895;8;336;303;1;196;4;6;186;140;7;133
283500036;500;921;922;9;361;266;2;234;6;11;217;127;6;121
283500037;500;684;684;10;270;330;1;169;3;6;160;101;6;95
283500038;500;813;813;4;282;331;1;168;5;1;162;114;4;110
283500039;500;621;622;7;231;335;2;163;4;7;152;68;7;61
283500040;500;936;939;9;319;272;1;227;11;6;210;92;4;88
283500041;500;644;645;6;202;358;2;140;8;4;128;62;3;59
283500042;500;840;841;11;176;351;1;148;7;4;137;28;0;28
283500043;500;1022;1023;8;178;330;2;168;27;1;140;10;1;9
283500044;500;805;806;9;280;326;1;173;4;2;167;107;2;104
283500045;400;470;473;5;180;284;1;115;1;4;110;65;2;63
283500046;400;493;493;2;179;315;1;84;2;4;78;95;2;93
283500047;400;383;383;6;126;299;2;99;3;2;94;27;2;24
283500048;300;258;260;5;126;173;1;126;3;2;121;0;0;0
283500049;100;101;101;7;52;47;1;52;0;5;47;0;0;0
283500050;500;828;828;6;380;153;1;346;13;6;327;34;4;30
283500051;200;147;147;9;68;130;2;68;2;1;65;0;0;0
283500052;300;299;306;7;151;148;1;151;4;3;144;0;0;0
283500053;300;302;304;8;166;133;1;166;1;0;165;0;0;0
283500054;400;497;499;4;184;257;2;141;10;1;130;43;4;39
283500055;500;600;601;10;198;301;1;198;7;1;190;0;0;0
283500056;300;267;267;4;94;205;1;94;1;2;91;0;0;0
283500057;500;902;900;7;267;233;1;266;13;4;249;1;0;1
283500058;400;458;461;6;181;227;1;172;4;4;164;9;1;8
283500059;500;521;521;8;213;286;1;213;9;3;201;0;0;0
283500060;400;383;383;5;171;227;2;171;12;3;156;0;0;0
283500061;100;102;102;8;23;76;1;23;1;0;22;0;0;0
283500062;300;334;336;7;144;168;1;131;1;2;128;13;0;13
283500063;400;396;396;7;245;155;1;244;6;8;230;1;0;1
283500064;400;448;449;8;179;220;1;179;3;4;172;0;0;0
283500065;400;453;456;6;182;226;1;173;12;1;160;9;0;9
283500066;400;410;411;8;110;307;1;92;7;5;80;18;0;18
283500067;400;498;498;6;235;175;1;224;16;2;206;11;0;11
283500068;400;518;518;6;248;150;2;248;12;8;228;0;0;0
283500069;200;219;219;7;133;66;1;133;2;3;128;0;0;0
283500070;100;82;82;7;65;34;1;65;0;1;64;0;0;0
283500071;200;177;178;8;92;107;1;92;1;2;89;0;0;0
283500072;500;544;544;8;177;335;1;164;8;3;153;13;1;12
283500073;400;426;427;5;131;277;3;120;7;0;113;11;1;10
283500074;400;391;397;9;169;278;1;121;6;1;114;48;1;47
283500075;200;231;232;6;123;76;1;123;1;2;120;0;0;0
283500076;500;590;591;8;263;299;1;200;21;3;176;63;0;63
283500077;200;200;200;7;140;58;2;140;5;2;133;0;0;0
283500078;200;139;139;6;79;120;1;79;1;0;78;0;0;0
283500079;100;78;78;8;52;47;1;52;1;1;50;0;0;0
283500080;400;412;412;5;169;259;1;140;6;3;131;29;2;27
283500081;500;659;659;9;363;136;1;363;3;3;357;0;0;0
283500082;50;23;23;7;22;27;1;22;0;0;22;0;0;0
283500083;400;378;379;8;129;274;1;125;9;1;115;4;0;4
283500084;400;444;444;6;170;230;1;169;10;3;156;1;0;1
283500085;400;437;437;7;156;245;10;155;9;3;143;1;0;1
283500086;400;360;360;6;92;307;1;92;4;1;87;0;0;0
283500087;400;524;524;9;147;255;1;144;7;0;137;3;0;3
283500088;200;221;221;7;108;90;2;108;3;0;105;0;0;0
283500089;200;193;193;5;86;113;1;86;4;1;81;0;0;0
283500090;400;370;370;8;143;259;2;139;8;2;129;4;0;4
283500091;200;126;126;8;75;124;1;75;0;1;74;0;0;0
283500092;100;103;104;6;65;34;1;65;0;1;64;0;0;0
283500093;500;619;619;9;283;246;1;253;6;3;244;30;1;29
283500094;200;194;194;5;77;117;6;77;3;0;74;0;0;0
283500095;500;549;549;6;174;326;1;173;9;1;163;1;0;1
283500096;400;443;443;6;164;238;1;161;4;1;156;3;1;2
283500097;300;257;257;6;95;203;2;95;6;4;85;0;0;0
283500098;500;630;631;7;299;245;1;254;10;3;241;45;3;42
283500099;300;335;338;5;121;181;2;117;1;5;111;4;0;4
283500100;500;562;562;9;199;318;1;181;9;3;169;18;1;17
283500101;200;241;241;8;91;107;2;91;1;2;88;0;0;0
283500102;100;72;72;7;46;53;1;46;3;0;43;0;0;0
283500103;500;798;798;8;371;128;1;371;5;2;364;0;0;0
283500104;100;21;21;39;51;48;1;51;3;2;46;0;0;0
283500105;100;45;45;9;53;45;2;53;0;0;53;0;0;0
290900001;300;448;449;4;166;157;1;142;1;6;135;24;0;24
290900002;500;627;630;5;236;388;1;111;2;7;102;125;6;119
290900003;500;623;625;1;287;382;1;117;8;3;106;170;5;165
290900004;300;356;357;4;130;234;1;65;0;3;62;65;2;63
290900005;300;429;433;4;111;233;1;66;1;2;63;45;4;41
290900006;300;514;515;5;202;201;1;98;3;4;91;104;1;103
290900007;300;450;451;6;158;223;1;76;1;0;75;82;1;81
290900008;500;588;590;8;195;386;1;113;7;1;105;82;6;76
290900009;500;610;610;7;194;408;2;90;1;2;87;104;13;91
290900010;300;467;468;4;168;222;1;77;3;3;71;91;8;83
290900011;400;529;531;5;167;313;2;85;5;1;79;82;2;80
290900012;500;612;615;4;196;371;2;127;5;2;120;69;2;67
290900013;600;693;696;5;246;478;1;121;0;5;116;125;7;118
290900014;600;710;710;4;294;444;1;155;4;6;145;139;7;132
290900015;300;472;472;6;198;189;1;110;0;1;109;88;5;83
290900016;500;612;614;2;226;384;1;115;4;4;107;111;7;104
290900017;500;609;610;3;221;384;2;114;6;1;107;107;6;101
290900018;500;627;628;4;251;368;1;131;0;1;130;120;2;118
290900019;500;667;669;0;222;384;3;113;1;0;112;109;3;106
290900020;500;615;617;0;219;396;1;103;4;4;95;116;7;109
290900021;500;635;636;7;219;392;1;107;3;3;101;112;6;106
290900022;500;603;604;6;226;273;1;226;6;10;210;0;0;0
290900023;300;470;470;5;151;145;4;151;3;0;148;0;0;0
290900024;500;643;645;4;220;404;1;95;5;3;87;125;13;112
290900025;600;754;756;8;289;510;1;89;1;6;82;200;8;192
290900026;700;946;948;8;340;362;1;337;6;15;316;3;0;3
290900027;400;527;527;7;178;322;1;77;3;3;71;101;2;99
290900028;500;604;604;6;214;405;3;92;5;5;82;122;8;114
290900029;400;521;524;5;172;330;2;68;0;1;67;104;1;103
290900030;500;598;598;5;195;380;1;119;4;3;112;76;3;73
290900031;500;657;658;4;241;358;1;141;4;0;137;100;3;97
290900032;500;615;615;8;240;391;1;108;2;1;105;132;9;123
290900033;500;568;568;4;213;401;1;98;0;3;95;115;10;105
290900034;300;445;447;4;166;214;1;85;3;0;82;81;1;80
290900035;300;390;391;3;139;164;1;135;2;6;127;4;0;4
290900036;600;810;813;8;320;445;1;154;5;1;148;166;7;159
290900037;700;919;919;7;335;487;2;211;1;8;202;124;4;120
290900038;600;703;706;7;288;322;1;277;7;4;266;11;0;11
290900039;500;587;587;9;228;378;1;121;4;3;114;107;9;98
290900040;400;511;513;7;226;290;1;109;7;1;101;117;5;112
290900041;300;462;463;6;165;220;2;78;1;3;74;87;3;84
290900042;500;577;579;0;230;391;1;108;4;3;101;122;4;118
290900043;400;579;583;5;197;302;1;97;0;2;95;100;3;97
290900044;400;519;519;7;227;311;1;88;2;2;84;139;4;135
290900045;600;677;678;5;260;457;3;140;5;4;131;120;6;114
290900046;500;598;598;8;204;382;1;117;5;5;107;87;6;81
290900047;500;625;626;8;232;381;1;118;2;5;111;114;7;107
290900048;400;508;510;7;153;325;1;74;1;3;70;79;4;75
290900049;600;870;870;1;234;434;4;162;17;2;143;72;1;71
290900050;500;649;650;6;187;371;2;127;5;3;119;60;1;59
290900051;500;629;629;3;163;378;1;121;1;1;119;42;3;39
290900052;200;266;266;6;79;119;2;79;3;2;74;0;0;0
290900053;300;466;468;3;124;198;3;99;12;0;87;25;0;25
290900054;500;616;616;6;194;350;3;147;8;2;137;47;4;43
290900055;400;518;518;5;139;293;1;106;7;3;96;33;2;31
290900056;500;599;599;8;130;377;1;122;4;2;116;8;0;8
290900057;600;786;787;8;189;410;1;189;14;0;175;0;0;0
290900058;600;800;800;7;252;347;1;252;67;0;185;0;0;0
290900059;100;20;20;14;33;66;1;33;2;0;31;0;0;0
290900060;400;380;380;4;234;189;1;210;9;1;200;24;4;20
290900061;100;55;55;8;42;57;1;42;3;1;38;0;0;0
290900062;500;447;450;3;187;334;1;165;3;6;156;22;1;21
290900063;400;392;394;3;161;294;1;105;0;1;104;56;6;50
290900064;300;296;296;7;129;170;1;129;8;1;120;0;0;0
290900065;100;35;35;7;32;67;1;32;0;1;31;0;0;0
290900066;400;416;416;4;214;227;1;172;3;2;167;42;1;41
290900067;500;585;586;3;329;201;0;299;0;15;284;30;2;28
290900068;300;330;330;0;175;124;1;175;2;5;168;0;0;0
290900069;400;380;381;5;138;297;2;101;4;1;96;37;2;35
290900070;600;627;629;7;190;437;1;162;14;4;144;28;0;28
290900071;300;250;250;2;128;170;2;128;4;2;122;0;0;0
290900072;400;398;400;4;203;216;1;183;10;7;166;20;0;20
290900073;200;213;214;5;131;68;1;131;5;2;124;0;0;0
290900074;200;174;174;5;114;85;1;114;3;1;110;0;0;0
290900075;100;55;55;7;44;55;1;44;0;0;44;0;0;0
290900076;400;371;371;1;155;258;2;140;9;1;130;15;0;15
290900077;400;425;427;2;173;247;2;151;6;0;145;22;0;22
290900078;500;527;530;4;183;338;1;161;19;1;141;22;1;21
290900079;100;108;109;5;68;31;1;68;2;2;64;0;0;0
290900080;500;620;621;3;232;315;1;184;7;6;171;48;2;46
290900081;500;590;596;5;244;300;2;198;5;8;185;46;1;45
290900082;500;799;801;4;325;199;2;299;14;6;279;26;2;24
290900083;300;245;245;7;117;182;1;117;5;4;108;0;0;0
290900084;200;157;157;6;108;91;1;108;4;2;102;0;0;0
290900085;200;148;149;3;56;142;2;56;0;1;55;0;0;0
290900086;300;313;316;5;185;114;1;185;11;1;173;0;0;0
290900087;500;822;823;3;326;222;1;277;17;5;255;49;0;49
290900088;200;191;191;5;123;76;1;123;6;2;115;0;0;0
290900089;100;98;99;3;69;30;1;69;1;0;68;0;0;0
290900090;400;559;561;5;314;128;1;271;6;3;262;43;1;42
290900091;200;182;182;3;87;112;1;87;4;1;82;0;0;0
290900092;100;42;42;0;42;57;1;42;0;1;41;0;0;0
291100001;300;523;527;4;235;143;1;156;4;3;149;79;3;76
291100002;300;565;570;2;241;139;1;160;5;5;150;81;2;79
291100003;400;809;809;6;397;143;2;255;7;6;242;142;2;140
291100004;300;688;691;4;307;92;1;207;8;7;192;100;3;97
291100005;300;374;376;5;193;159;2;139;4;1;134;54;1;53
291100006;200;232;232;5;135;64;1;135;6;6;123;0;0;0
291100007;100;51;53;7;37;62;1;37;0;0;37;0;0;0
291100008;200;180;181;4;76;123;1;76;4;4;68;0;0;0
291100009;100;53;58;6;37;62;1;37;0;0;37;0;0;0
291100010;100;59;59;6;42;57;1;42;0;0;42;0;0;0
291100011;100;98;98;7;32;67;1;32;0;2;30;0;0;0
291100012;100;51;51;7;26;73;1;26;0;0;26;0;0;0
291100013;300;308;308;7;115;184;1;115;2;0;113;0;0;0
291100014;100;36;36;6;29;70;1;29;1;0;28;0;0;0
291100015;100;92;92;4;56;43;1;56;0;0;56;0;0;0
291100016;100;82;84;4;53;46;1;53;1;1;51;0;0;0
291100017;100;106;108;5;58;41;1;58;4;1;53;0;0;0
291100018;200;190;198;7;57;142;1;57;1;0;56;0;0;0
291100019;200;182;182;7;54;145;1;54;1;0;53;0;0;0
291100020;300;392;392;8;120;193;1;106;3;0;103;14;0;14
291100021;200;318;318;8;54;145;1;54;1;0;53;0;0;0
291100022;200;233;234;5;57;142;1;57;0;0;57;0;0;0
291100023;100;76;76;6;41;58;1;41;0;0;41;0;0;0
291100024;200;194;194;5;27;172;1;27;1;0;26;0;0;0
291100025;100;93;93;7;32;67;1;32;2;0;30;0;0;0
291100026;100;101;101;6;23;76;1;23;2;0;21;0;0;0
291100027;100;29;29;0;28;71;1;28;0;0;28;0;0;0
291100028;100;18;18;4;21;78;1;21;1;1;19;0;0;0
291700001;500;530;530;4;257;308;2;190;6;2;182;67;0;67
291700002;600;637;639;2;316;323;1;276;14;0;262;40;4;36
291700003;600;631;631;4;305;363;1;236;4;4;228;69;3;66
291700004;700;696;696;8;381;423;1;276;5;2;269;105;5;100
291700005;500;553;553;3;283;285;1;214;3;2;209;69;5;64
291700006;600;634;634;2;328;358;1;241;2;1;238;87;1;86
291700007;600;616;617;2;317;363;1;236;2;8;226;81;2;79
291700008;400;436;436;0;246;202;1;197;1;0;196;49;3;46
291700009;252;252;252;0;97;154;1;97;3;4;90;0;0;0
291700010;600;592;592;9;180;419;1;180;8;0;172;0;0;0
291700011;400;434;435;5;100;298;2;100;10;0;90;0;0;0
291700012;300;298;298;3;154;144;2;154;12;0;142;0;0;0
291700013;200;219;219;3;155;44;1;155;5;0;150;0;0;0
291700014;200;200;200;4;108;91;1;108;7;0;101;0;0;0
291700015;100;90;90;5;73;26;1;73;6;0;67;0;0;0
291700016;500;495;495;3;309;230;1;269;2;6;261;40;1;39
291700017;100;129;130;5;74;25;1;74;4;1;69;0;0;0
291700018;50;25;25;5;19;30;1;19;0;0;19;0;0;0
291700019;200;158;158;5;109;90;1;109;2;0;107;0;0;0
291700020;100;71;71;5;56;43;1;56;0;0;56;0;0;0
291800001;400;545;552;4;263;175;1;224;5;1;218;39;0;39
291800002;200;160;160;7;102;97;1;102;2;2;98;0;0;0
291800003;100;27;28;5;23;76;1;23;0;0;23;0;0;0
291800004;300;360;370;6;133;166;1;133;1;1;131;0;0;0
291800005;300;474;474;6;158;141;1;158;2;0;156;0;0;0
291800006;100;42;42;2;23;76;1;23;1;0;22;0;0;0
291800007;100;123;123;4;48;51;1;48;1;0;47;0;0;0
291800008;300;485;490;9;111;187;2;111;0;0;111;0;0;0
291800009;100;68;69;6;18;81;1;18;0;0;18;0;0;0
291800010;200;227;229;6;93;106;1;93;2;0;91;0;0;0
291800011;200;201;201;3;55;144;1;55;5;0;50;0;0;0
291800012;100;44;44;6;33;65;2;33;1;1;31;0;0;0
291800013;200;222;222;6;92;107;1;92;2;0;90;0;0;0
291800014;100;111;111;6;33;66;1;33;0;0;33;0;0;0
291800015;100;42;42;2;43;57;0;43;0;0;43;0;0;0
291900001;500;533;539;2;246;347;1;152;7;5;140;94;3;91
291900002;500;504;504;3;261;310;1;189;4;4;181;72;4;68
291900003;300;392;396;5;204;104;1;195;2;8;185;9;1;8
291900004;500;566;566;10;196;314;1;185;7;1;177;11;0;11
291900005;200;252;252;7;138;61;1;138;5;0;133;0;0;0
291900006;200;160;161;4;103;95;2;103;2;1;100;0;0;0
291900007;200;169;169;7;75;123;2;75;1;0;74;0;0;0
291900008;100;83;83;6;55;44;1;55;1;1;53;0;0;0
291900009;200;230;236;7;141;58;1;141;7;1;133;0;0;0
291900010;600;656;675;9;366;232;2;366;3;0;363;0;0;0
291900011;700;740;761;8;351;356;1;343;9;1;333;8;1;7
291900012;600;598;609;11;286;313;1;286;11;4;271;0;0;0
291900013;400;417;417;9;242;157;1;242;11;1;230;0;0;0
291900014;500;511;521;8;284;218;1;281;11;3;267;3;1;2
291900015;700;801;828;8;418;281;1;418;12;1;405;0;0;0
291900016;100;36;36;4;39;60;1;39;0;0;39;0;0;0
291900017;100;78;78;5;82;17;1;82;0;0;82;0;0;0
292800001;600;631;631;8;261;418;1;181;4;4;173;80;8;72
292800002;600;587;588;7;281;421;2;177;4;3;170;104;6;98
292800003;500;517;517;7;226;367;1;132;2;5;125;94;5;89
292800004;700;691;691;9;355;481;1;218;4;4;210;137;4;133
292800005;600;649;649;4;289;408;2;190;6;3;181;99;5;94
292800006;500;498;498;3;230;340;1;159;6;5;148;71;2;69
292800007;500;533;533;3;258;308;1;191;3;7;181;67;3;64
292800008;500;579;579;7;280;344;1;155;9;3;143;125;5;120
292800009;600;599;600;9;290;399;1;200;1;7;192;90;7;83
292800010;500;529;529;3;257;331;1;168;2;4;162;89;6;83
292800011;500;502;506;5;261;341;1;158;3;4;151;103;2;101
292800012;600;668;668;8;314;411;1;188;5;6;177;126;6;120
292800013;600;606;607;7;295;410;1;189;6;7;176;106;5;101
292800014;500;526;526;1;241;335;1;164;0;7;157;77;2;75
292800015;400;445;445;6;219;256;1;143;5;3;135;76;5;71
292800016;500;581;581;2;292;283;1;216;3;1;212;76;2;74
292800017;500;549;549;5;280;316;2;182;0;2;180;98;2;96
292800018;500;481;481;4;220;331;1;168;4;1;163;52;2;50
292800019;600;600;600;2;307;403;1;196;9;5;182;111;1;110
292800020;500;522;523;1;225;349;1;150;1;6;143;75;2;73
292800021;500;508;508;7;233;265;2;233;25;0;208;0;0;0
292800022;500;500;500;7;241;273;1;226;22;0;204;15;0;15
292800023;500;583;583;1;272;283;1;216;22;2;192;56;2;54
292800024;300;373;374;6;167;187;1;112;5;2;105;55;0;55
292800025;500;509;509;5;248;344;2;154;2;2;150;94;0;94
292800026;600;652;653;4;313;350;2;248;8;2;238;65;3;62
292800027;700;685;685;7;358;392;3;305;25;1;279;53;2;51
292800028;100;107;107;5;64;35;1;64;3;0;61;0;0;0
292800029;200;161;162;3;115;84;1;115;4;3;108;0;0;0
292800030;100;102;103;7;64;35;1;64;1;2;61;0;0;0
292800031;200;162;163;6;108;91;1;108;1;3;104;0;0;0
292800032;100;95;95;5;64;35;1;64;3;1;60;0;0;0
292800033;500;479;481;5;332;206;1;293;6;3;284;39;1;38
292800034;300;235;235;4;144;155;1;144;5;1;138;0;0;0
292800035;300;291;291;4;167;132;1;167;6;5;156;0;0;0
292800036;400;391;391;2;208;194;2;204;7;2;195;4;0;4
292800037;99;99;99;3;51;47;1;51;2;1;48;0;0;0
292800038;100;35;35;8;20;79;1;20;2;0;18;0;0;0
292800039;100;82;83;3;40;59;1;40;2;0;38;0;0;0
292800040;200;210;210;6;96;102;2;96;5;4;87;0;0;0
292800041;200;155;155;4;69;130;1;69;13;0;56;0;0;0
292800042;600;592;593;3;328;307;1;292;17;4;271;36;0;36
292800043;100;112;112;7;48;50;2;48;2;0;46;0;0;0
292900001;500;638;638;3;256;264;1;235;9;5;221;21;0;21
292900002;700;870;870;4;351;390;1;309;15;4;290;42;1;41
292900003;400;441;441;3;195;216;1;183;8;1;174;12;1;11
292900004;500;574;574;5;237;307;1;192;2;4;186;45;0;45
292900005;800;852;852;6;297;538;4;258;13;2;243;39;0;39
292900006;800;833;835;4;230;607;1;192;13;3;176;38;1;37
292900007;500;582;584;1;211;329;1;170;10;4;156;41;0;41
292900008;500;508;511;6;226;286;1;213;5;2;206;13;0;13
292900009;300;309;310;5;180;119;1;180;7;3;170;0;0;0
292900010;200;161;161;3;77;121;2;77;1;3;73;0;0;0
292900011;100;70;70;7;56;43;1;56;1;1;54;0;0;0
292900012;300;247;247;6;189;110;1;189;1;1;187;0;0;0
292900013;200;191;191;4;115;84;1;115;3;2;110;0;0;0
292900014;200;177;177;3;130;69;1;130;2;0;128;0;0;0
292900015;100;57;57;7;42;57;1;42;1;0;41;0;0;0
292900016;200;172;172;4;98;101;1;98;7;3;88;0;0;0
293000001;500;866;866;11;294;224;1;275;6;2;267;19;0;19
293000002;300;360;360;4;119;180;1;119;2;1;116;0;0;0
293000003;300;545;545;8;171;128;1;171;5;0;166;0;0;0
293000004;200;384;384;6;107;92;1;107;0;1;106;0;0;0
293000005;200;229;230;4;80;119;1;80;1;0;79;0;0;0
293000006;300;505;508;5;187;115;1;184;1;4;179;3;1;2
293000007;200;396;402;9;109;90;1;109;1;0;108;0;0;0
293000008;300;430;430;5;99;200;1;99;9;0;90;0;0;0
293000009;500;560;565;7;209;290;1;209;8;2;199;0;0;0
293000010;200;335;335;5;90;109;1;90;3;0;87;0;0;0
293000011;500;801;817;9;172;326;2;172;4;0;168;0;0;0
293000012;500;843;862;7;343;212;2;286;9;4;273;57;1;56
293000013;300;510;531;12;158;142;1;157;4;1;152;1;0;1
293000014;200;100;105;6;59;140;1;59;0;0;59;0;0;0
293000015;200;252;262;1;81;118;1;81;2;3;76;0;0;0
293000016;500;288;958;15;303;196;1;303;6;4;293;0;0;0
293000017;300;500;506;8;170;129;1;170;3;0;167;0;0;0
293000018;500;878;914;7;274;225;1;274;7;4;263;0;0;0
293000019;500;544;559;9;187;312;1;187;10;1;176;0;0;0
293000020;500;883;899;14;284;226;2;272;2;1;269;12;0;12
293000021;200;287;289;8;68;131;1;68;0;0;68;0;0;0
293000022;500;693;704;21;251;252;1;247;6;2;239;4;0;4
293000023;300;440;440;16;148;151;1;148;0;3;145;0;0;0
293000024;300;364;365;9;122;185;1;114;7;1;106;8;0;8
293000025;200;157;159;6;96;103;1;96;4;2;90;0;0;0
293000026;300;321;321;5;168;132;4;164;5;4;155;4;0;4
293000027;100;64;64;7;68;32;0;68;1;0;67;0;0;0
293000028;100;63;63;4;65;35;0;65;0;0;65;0;0;0
293000029;100;55;55;4;58;42;0;58;3;0;55;0;0;0
293000030;100;32;32;4;36;64;0;36;2;0;34;0;0;0
293200001;500;535;536;5;208;337;1;162;6;3;153;46;1;45
293200002;600;626;627;2;208;432;1;167;3;1;163;41;2;39
293200003;700;801;803;3;233;526;1;173;2;5;166;60;2;58
293200004;500;539;539;0;200;358;1;141;3;5;133;59;2;57
293200005;500;578;579;0;227;328;2;170;1;7;162;57;1;56
293200006;500;555;555;1;212;338;1;161;2;5;154;51;0;51
293200007;700;826;826;4;408;345;2;353;10;3;340;55;3;52
293200009;100;97;97;5;61;38;1;61;2;0;59;0;0;0
293200010;100;67;68;7;22;77;1;22;0;1;21;0;0;0
293200011;100;60;60;7;21;78;1;21;2;1;18;0;0;0
293200012;100;30;30;6;20;79;1;20;0;0;20;0;0;0
293200013;200;157;157;5;61;138;1;61;2;0;59;0;0;0
293200014;200;263;263;5;126;73;1;126;7;2;117;0;0;0
293200015;400;418;420;1;146;277;1;122;7;1;114;24;0;24
293200016;300;336;336;6;152;159;1;140;9;0;131;12;1;11
293200017;400;460;460;4;176;223;1;176;6;3;167;0;0;0
293200018;100;66;66;6;52;47;1;52;2;0;50;0;0;0
293200019;300;338;339;4;127;182;1;117;4;1;112;10;0;10
293200020;300;295;295;2;155;144;1;155;3;3;149;0;0;0
293200021;300;373;373;3;145;163;1;136;2;3;131;9;0;9
293200022;300;149;372;4;153;146;1;153;1;9;143;0;0;0
293200023;300;367;367;5;150;167;1;132;2;2;128;18;1;17
293300001;600;687;687;5;237;436;1;163;1;6;156;74;2;72
293300002;700;766;768;3;261;601;1;98;8;3;87;163;11;152
293300003;600;734;734;5;299;412;1;187;2;7;178;112;5;107
293300004;700;754;755;3;269;532;1;167;4;5;158;102;7;95
293300005;600;767;767;7;218;422;1;177;7;3;167;41;3;38
293300006;800;908;908;8;206;593;1;206;18;0;188;0;0;0
293300007;700;719;721;6;176;528;3;169;20;1;148;7;1;6
293300008;600;615;616;10;137;478;1;121;8;0;113;16;0;16
293300009;700;804;806;8;264;499;1;200;12;6;182;64;3;61
293300010;800;868;868;6;334;475;1;324;7;10;307;10;0;10
293300011;700;782;782;2;265;544;1;155;7;5;143;110;3;107
293300012;700;770;770;3;297;544;2;154;4;4;146;143;5;138
293300013;700;736;736;0;303;493;5;202;4;7;191;101;6;95
293300014;500;540;540;6;232;366;1;133;4;4;125;99;6;93
293300015;800;760;763;10;296;643;1;156;6;3;147;140;8;132
293300016;500;525;525;9;199;390;1;109;2;3;104;90;4;86
293300017;700;732;733;4;283;531;1;168;3;0;165;115;6;109
293300018;650;638;638;6;224;532;1;117;6;1;110;107;9;98
293300019;700;807;808;8;307;538;1;161;6;3;152;146;5;141
293300020;700;847;848;3;297;497;1;202;17;4;181;95;5;90
293300021;752;752;752;7;233;592;1;159;33;0;126;74;1;73
293300022;300;346;347;3;136;228;1;71;1;2;68;65;2;63
293300023;600;620;621;6;349;282;1;317;15;9;293;32;3;29
293300024;300;313;313;4;103;196;1;103;12;0;91;0;0;0
293300025;100;92;92;7;52;47;1;52;5;0;47;0;0;0
293300026;300;310;311;3;181;118;1;181;3;3;175;0;0;0
293300027;300;280;280;5;100;199;1;100;1;1;98;0;0;0
293300028;250;255;255;6;133;116;1;133;5;6;122;0;0;0
293300029;250;247;248;6;101;148;1;101;5;4;92;0;0;0
293300030;150;147;147;6;75;74;1;75;4;0;71;0;0;0
293300031;70;59;59;6;42;27;1;42;0;1;41;0;0;0
293300032;250;243;243;5;84;165;1;84;1;4;79;0;0;0
293300033;100;80;80;5;47;52;1;47;3;1;43;0;0;0
293300034;150;152;152;5;89;60;1;89;5;1;83;0;0;0
293300035;100;90;91;5;57;42;1;57;0;1;56;0;0;0
293300036;170;162;164;3;75;94;1;75;3;0;72;0;0;0
293300037;200;230;230;7;86;113;1;86;1;1;84;0;0;0
293300038;100;108;108;8;61;38;1;61;1;0;60;0;0;0
293300039;600;569;570;6;161;449;1;150;2;4;144;11;0;11
293300040;140;122;122;4;70;69;1;70;0;0;70;0;0;0
293300041;150;124;125;6;73;76;1;73;5;1;67;0;0;0
293300042;70;21;61;8;29;40;1;29;0;0;29;0;0;0
293300043;700;813;813;11;353;346;1;353;4;0;349;0;0;0
293400001;700;845;847;6;295;482;1;217;3;4;210;78;1;77
293400002;800;927;928;8;329;549;1;250;4;3;243;79;4;75
293400003;800;947;948;8;388;531;1;268;3;6;259;120;0;120
293400004;800;921;923;6;326;586;2;212;6;7;199;114;8;106
293400005;700;906;908;6;343;476;1;223;2;4;217;120;6;114
293400006;800;967;970;7;373;561;1;238;7;5;226;135;4;131
293400007;700;860;860;8;359;489;1;210;7;2;201;149;3;146
293400008;600;705;707;7;324;424;1;175;3;5;167;149;10;139
293400009;800;992;996;8;447;569;2;229;2;6;221;218;7;211
293400010;600;768;768;8;304;443;1;156;0;3;153;148;6;142
293400011;600;650;655;7;304;432;1;167;3;6;158;137;4;133
293400012;700;802;803;6;371;494;1;205;2;13;190;166;7;159
293400013;400;502;502;9;203;287;3;110;2;4;104;93;2;91
293400014;500;596;596;9;274;354;2;144;1;2;141;130;6;124
293400015;400;470;470;7;244;264;1;135;2;2;131;109;3;106
293400016;500;531;531;6;247;366;1;133;0;4;129;114;2;112
293400017;400;461;464;5;181;320;1;79;1;4;74;102;4;98
293400018;500;497;498;5;208;404;1;95;2;6;87;113;8;105
293400019;500;558;564;8;209;407;1;92;0;2;90;117;4;113
293400020;700;825;829;9;368;523;1;176;2;5;169;192;7;185
293400021;300;343;345;3;126;226;3;71;2;0;69;55;8;47
293400022;400;510;511;8;245;296;1;103;3;5;95;142;10;132
293400023;300;352;355;5;150;224;1;75;1;0;74;75;1;74
293400024;400;456;458;6;217;305;1;94;1;5;88;123;8;115
293400025;500;589;591;8;254;366;1;133;2;1;130;121;5;116
293400026;700;801;801;4;325;517;1;182;3;6;173;143;3;140
293400027;500;592;595;8;260;344;1;155;3;5;147;105;8;97
293400028;600;716;720;7;320;415;2;183;0;1;182;137;5;132
293400029;400;465;466;6;203;287;1;112;4;1;107;91;2;89
293400030;300;310;313;7;156;205;1;94;1;2;91;62;4;58
293400031;600;677;677;10;278;428;1;171;7;2;162;107;4;103
293400032;500;562;562;8;242;260;2;238;1;6;231;4;0;4
293400033;300;363;363;7;133;223;2;75;1;1;73;58;3;55
293400034;500;495;495;10;213;402;1;97;1;3;93;116;7;109
293400035;400;459;462;5;182;304;1;95;1;3;91;87;5;82
293400036;400;448;453;7;179;283;1;116;4;4;108;63;4;59
293400037;400;384;387;6;169;308;2;90;4;2;84;79;10;69
293400038;500;618;619;4;237;350;1;149;3;0;146;88;1;87
293400039;400;388;388;6;144;326;2;72;0;2;70;72;1;71
293400040;400;449;450;7;153;285;1;114;11;2;101;39;4;35
293400041;400;491;492;10;166;287;1;112;3;0;109;54;4;50
293400042;500;531;531;9;189;379;1;120;7;1;112;69;0;69
293400043;600;638;638;9;235;400;1;199;7;2;190;36;3;33
293400044;300;357;357;8;112;218;1;81;7;0;74;31;0;31
293400045;600;761;764;7;244;411;1;188;9;3;176;56;8;48
293400046;500;536;532;5;163;383;2;115;9;1;105;48;2;46
293400047;600;635;637;7;213;417;4;179;4;2;173;34;0;34
293400048;400;506;509;9;181;285;1;114;2;4;108;67;3;64
293400049;500;582;583;4;186;384;1;115;2;2;111;71;2;69
293400050;500;552;552;5;220;370;2;128;2;10;116;92;8;84
293400051;700;820;820;6;334;498;1;201;1;4;196;133;3;130
293400052;700;795;795;6;323;505;1;194;5;3;186;129;6;123
293400053;700;794;794;5;275;525;1;174;3;4;167;101;7;94
293400054;600;647;649;4;238;475;1;124;3;1;120;114;4;110
293400055;800;910;913;7;260;591;3;206;13;4;189;54;0;54
293400056;500;596;596;6;216;357;1;142;5;7;130;74;3;71
293400057;600;663;663;6;203;462;1;137;3;1;133;66;2;64
293400058;500;629;629;7;210;370;1;129;2;2;125;81;5;76
293400059;500;631;632;8;224;349;3;148;5;2;141;76;2;74
293400060;700;862;866;4;349;350;1;349;34;2;313;0;0;0
293400061;800;944;947;7;296;554;2;244;15;3;226;52;3;49
293400062;800;884;885;5;342;474;1;325;19;3;303;17;0;17
293400063;600;657;661;7;208;430;2;168;8;3;157;40;1;39
293400064;800;1075;1076;9;356;444;1;355;23;1;331;1;0;1
293400065;800;934;934;8;328;481;1;318;15;0;303;10;0;10
293400066;400;481;481;5;188;273;1;126;2;3;121;62;4;58
293400067;500;607;607;10;234;335;1;164;0;0;164;70;0;70
293400068;800;854;855;4;239;593;2;205;1;2;202;34;1;33
293400069;600;692;694;5;265;423;2;175;2;4;169;90;7;83
293400070;700;797;798;8;336;510;1;189;2;6;181;147;4;143
293400071;600;643;643;10;290;424;1;175;1;5;169;115;1;114
293400072;500;608;610;8;269;342;1;157;3;4;150;112;7;105
293400073;500;569;571;8;235;368;1;131;0;6;125;104;4;100
293400074;500;626;627;9;290;337;1;162;5;8;149;128;10;118
293400075;600;633;634;8;257;483;1;116;0;3;113;141;4;137
293400076;600;637;638;6;299;420;1;179;6;5;168;120;9;111
293400077;500;589;590;5;209;344;1;155;7;2;146;54;4;50
293400078;500;576;577;6;264;365;1;134;1;0;133;130;7;123
293400079;600;663;667;26;346;262;2;336;5;18;313;10;0;10
293400080;700;806;807;6;304;490;1;209;1;10;198;95;4;91
293400081;600;735;735;9;292;414;2;184;2;5;177;108;3;105
293400082;600;725;726;6;266;435;2;163;5;1;157;103;2;101
293400083;500;582;583;5;187;372;1;127;5;2;120;60;1;59
293400084;600;649;650;10;256;417;1;182;3;3;176;74;0;74
293400085;600;644;644;6;205;446;1;153;3;3;147;52;1;51
293400086;700;834;834;8;222;506;1;193;0;9;184;29;2;27
293400087;700;842;844;3;234;478;1;221;8;5;208;13;0;13
293400088;700;879;880;5;295;429;2;269;4;5;260;26;0;26
293400089;600;715;715;9;191;434;1;165;2;4;159;26;0;26
293400090;600;730;730;7;207;421;1;178;9;6;163;29;1;28
293400091;700;751;751;9;201;526;1;173;4;2;167;28;1;27
293400092;300;359;359;6;155;213;1;86;0;3;83;69;4;65
293400093;400;421;421;8;207;292;1;107;3;2;102;100;5;95
293400094;500;492;492;8;230;389;1;110;1;3;106;120;5;115
293400095;400;374;376;8;206;310;1;89;2;2;85;117;4;113
293400096;400;435;436;7;221;287;1;112;0;3;109;109;4;105
293400097;400;437;440;8;199;289;1;110;2;2;106;89;2;87
293400098;600;671;671;6;290;359;1;240;8;3;229;50;6;44
293400099;500;601;601;3;282;369;1;130;3;2;125;152;4;148
293400100;400;431;433;6;190;299;1;100;2;2;96;90;1;89
293400101;700;835;837;8;419;437;1;262;5;6;251;157;3;154
293400102;700;793;797;6;334;490;1;209;2;3;204;125;2;123
293400103;700;763;768;5;283;516;1;183;1;6;176;100;5;95
293400104;800;999;1000;7;374;522;1;277;6;2;269;97;7;90
293400105;800;862;864;5;296;586;1;213;1;5;207;83;4;79
293400106;800;885;887;6;317;603;1;196;6;4;186;121;3;118
293400107;800;974;974;8;379;480;2;318;8;0;310;61;3;58
293400108;400;426;433;4;199;298;1;101;1;0;100;98;2;96
293400109;400;390;390;6;160;292;1;107;0;3;104;53;2;51
293400110;300;358;358;3;139;208;1;91;1;2;88;48;2;46
293400111;300;320;324;34;188;110;2;188;16;5;167;0;0;0
293400112;200;167;169;6;106;93;1;106;1;0;105;0;0;0
293400113;600;238;581;12;250;349;1;250;3;3;244;0;0;0
293400114;400;431;431;4;256;176;1;223;7;4;212;33;0;33
293400115;500;563;566;5;302;238;1;261;4;2;255;41;1;40
293400116;500;450;450;6;183;324;1;175;2;2;171;8;0;8
293400117;700;769;776;4;292;456;2;242;12;1;229;50;2;48
293400118;200;206;206;7;113;86;1;113;3;1;109;0;0;0
293400119;700;731;731;6;395;328;1;371;27;1;343;24;1;23
293400120;600;591;592;4;339;278;2;320;5;3;312;19;0;19
293400121;200;181;181;5;126;70;4;126;2;0;124;0;0;0
293400122;600;693;693;6;247;365;1;234;19;0;215;13;0;13
293400123;400;382;383;5;149;249;2;149;5;0;144;0;0;0
293400124;400;368;369;7;96;308;1;91;6;3;82;5;0;5
293400125;200;94;124;7;94;105;1;94;0;0;94;0;0;0
293400126;500;575;575;5;222;300;1;199;9;0;190;23;0;23
293400127;200;170;171;5;98;101;1;98;1;1;96;0;0;0
293400128;100;50;50;6;39;60;1;39;0;0;39;0;0;0
293400129;700;740;740;4;301;402;1;297;12;2;283;4;0;4
293400130;400;394;401;4;205;194;1;205;6;1;198;0;0;0
293400131;500;449;449;4;206;316;2;182;6;1;175;24;0;24
293400132;500;504;504;6;223;287;1;212;5;5;202;11;0;11
293400133;400;411;413;5;201;221;2;177;7;4;166;24;4;20
293400134;300;241;241;5;126;172;2;126;2;0;124;0;0;0
293400135;300;310;310;4;137;161;2;137;2;0;135;0;0;0
293400136;200;93;208;4;93;106;1;93;5;1;87;0;0;0
293400137;300;271;271;5;88;211;1;88;2;0;86;0;0;0
293400138;500;526;535;6;242;259;1;240;12;1;227;2;0;2
293400139;600;669;670;6;171;441;1;158;1;2;155;13;0;13
293400140;600;644;645;9;134;466;2;132;8;0;124;2;0;2
293400141;400;421;425;5;187;249;1;150;7;2;141;37;0;37
293400142;400;363;363;4;170;269;2;129;1;0;128;41;1;40
293400143;600;624;625;10;227;372;1;227;3;1;223;0;0;0
293400144;600;657;657;7;272;333;1;266;1;0;265;6;0;6
293400145;600;659;660;9;185;414;1;185;6;0;179;0;0;0
293400146;600;602;603;6;196;427;1;172;10;3;159;24;2;22
293400147;600;589;592;5;302;341;1;258;4;3;251;44;2;42
293400148;800;820;823;7;355;444;1;355;12;3;340;0;0;0
293400149;500;475;475;8;215;284;1;215;6;3;206;0;0;0
293400150;100;60;60;9;68;32;0;68;2;1;65;0;0;0
293400151;100;51;51;7;57;43;0;57;2;1;54;0;0;0
293400152;100;11;11;15;24;75;1;24;3;0;21;0;0;0
293400153;200;98;98;23;40;159;1;40;0;2;38;0;0;0
293400154;100;21;21;18;36;62;2;36;1;0;35;0;0;0
300700001;1000;979;979;2;243;777;1;222;5;6;211;21;0;21
300700002;600;691;694;6;155;462;1;137;3;0;134;18;0;18
300700003;600;510;519;2;99;521;1;78;6;1;71;21;1;20
300700004;1000;1185;1220;6;326;690;1;309;9;5;295;16;0;16
300700005;500;573;587;8;140;359;1;140;7;1;132;0;0;0
300700006;300;225;225;7;64;235;1;64;0;0;64;0;0;0
300700007;500;484;484;2;114;385;1;114;5;3;106;0;0;0
300700008;1000;1243;1254;3;263;744;1;255;14;1;240;8;0;8
300700009;800;815;832;5;215;590;3;207;10;1;196;8;0;8
300700010;600;620;623;4;205;395;1;204;6;1;197;1;0;1
300700011;100;97;97;5;43;56;1;43;0;0;43;0;0;0
300700012;700;683;697;5;218;481;1;218;18;2;198;0;0;0
300700013;700;707;740;3;246;453;1;246;16;5;225;0;0;0
300700014;1000;905;936;4;308;694;1;305;7;1;297;3;0;3
300700015;800;820;848;3;288;511;1;288;2;7;279;0;0;0
300700016;150;127;127;1;124;26;0;124;6;0;118;0;0;0
300700017;150;105;105;1;104;46;0;104;3;3;98;0;0;0
301000001;400;436;450;6;131;350;2;48;0;0;48;83;1;82
301000002;600;562;606;6;249;502;1;97;5;1;91;151;0;151
301000003;700;727;781;6;276;487;1;212;5;2;205;59;1;58
301000004;800;779;810;2;301;581;1;218;16;4;198;82;2;80
301000005;900;1234;1234;8;344;600;2;298;8;1;289;46;0;46
301000006;800;1109;1225;6;236;792;1;7;0;0;7;229;0;229
301000007;400;382;411;5;158;276;2;122;4;0;118;36;0;36
301000008;300;266;266;6;112;187;1;112;1;0;111;0;0;0
301000009;300;364;377;4;119;214;1;85;4;1;80;34;0;34
301000010;200;96;96;5;36;163;1;36;2;0;34;0;0;0
301000011;400;426;451;5;152;383;1;16;1;0;15;136;0;136
301000012;400;387;420;5;253;258;1;141;4;2;135;112;0;112
301000013;500;519;578;5;174;495;1;4;0;0;4;170;2;168
301000014;400;481;518;6;130;312;1;87;2;1;84;43;2;41
301000015;500;445;472;3;273;344;1;155;5;0;150;118;1;117
301000016;700;784;816;6;230;483;1;216;12;4;200;14;0;14
301000017;300;326;358;4;129;260;1;39;9;3;27;90;0;90
301000018;700;790;889;5;247;671;1;28;0;0;28;219;2;217
301000019;600;615;656;6;223;474;1;125;0;0;125;98;0;98
301000020;300;196;196;6;198;100;2;198;0;0;198;0;0;0
301000021;200;149;149;5;152;47;1;152;0;0;152;0;0;0
301000022;300;191;191;8;193;105;2;193;0;0;193;0;0;0
301000023;300;216;216;7;220;79;1;220;0;0;220;0;0;0
301100001;400;411;411;5;104;295;1;104;1;2;101;0;0;0
301100002;300;282;283;5;102;197;1;102;7;3;92;0;0;0
301100003;600;606;606;7;128;530;1;69;3;0;66;59;1;58
301100004;400;365;370;0;97;327;1;72;8;1;63;25;1;24
301100005;1000;1098;1104;5;275;769;1;230;6;6;218;45;3;42
301100006;400;413;413;7;111;288;1;111;3;0;108;0;0;0
301100007;400;377;377;9;109;290;1;109;5;3;101;0;0;0
301100008;400;456;456;5;110;289;1;110;3;0;107;0;0;0
301100009;800;809;830;3;248;548;4;248;16;4;228;0;0;0
301100010;500;553;554;9;125;374;1;125;7;1;117;0;0;0
301100011;300;366;366;4;107;195;1;104;11;2;91;3;0;3
301100012;300;237;238;6;94;205;1;94;0;1;93;0;0;0
301100013;400;440;455;5;203;200;1;199;12;8;179;4;0;4
301100014;1200;1491;1546;4;373;843;1;356;23;2;331;17;0;17
301100015;300;368;368;5;112;186;6;108;3;2;103;4;0;4
301100016;300;312;312;3;84;215;1;84;0;1;83;0;0;0
301100018;700;721;726;4;214;489;1;210;3;0;207;4;0;4
301100019;500;472;476;4;124;392;1;107;7;3;97;17;0;17
301100020;800;843;844;7;228;568;4;228;2;0;226;0;0;0
301100021;500;438;438;5;132;367;1;132;6;3;123;0;0;0
301100022;100;52;52;2;53;47;0;53;3;0;50;0;0;0
301100023;100;69;69;3;71;29;0;71;0;0;71;0;0;0
301800001;800;763;770;4;217;585;3;212;2;1;209;5;0;5
301800002;900;1062;1062;1;341;558;1;341;13;3;325;0;0;0
301800003;700;784;797;6;324;373;3;324;8;3;313;0;0;0
301800004;500;521;528;5;190;338;3;159;5;1;153;31;0;31
301800005;500;459;466;5;149;352;1;147;4;0;143;2;0;2
301800006;1000;1063;1069;3;497;502;1;497;5;5;487;0;0;0
301800007;800;875;876;4;202;650;1;149;4;0;145;53;4;49
301800008;700;683;684;5;193;520;1;179;6;2;171;14;0;14
301800009;900;924;926;7;292;607;1;292;5;1;286;0;0;0
301800010;1000;1027;1027;5;270;756;1;243;9;2;232;27;1;26
301800011;1000;1008;1028;7;237;800;1;199;11;4;184;38;1;37
301800012;50;21;21;4;19;30;1;19;1;0;18;0;0;0
301800013;600;694;705;4;235;388;1;211;2;0;209;24;1;22
301800014;800;771;779;5;234;589;1;210;2;3;205;24;1;23
301800015;50;13;16;4;17;32;1;17;0;0;17;0;0;0
301800016;900;881;883;3;248;660;2;238;8;1;229;10;0;10
301800017;800;824;827;3;216;584;1;215;1;2;212;1;0;1
301800018;500;572;572;1;195;344;1;155;5;1;149;40;0;40
301800019;900;861;883;5;310;589;1;310;7;1;302;0;0;0
301800020;1000;1059;1062;2;277;745;11;244;10;1;233;33;4;29
301800021;1000;1039;1042;1;224;775;1;224;11;1;212;0;0;0
301800022;1000;1008;1007;2;334;665;1;334;12;2;320;0;0;0
301800023;900;979;983;5;384;567;3;330;12;1;317;54;0;54
301800024;200;168;168;0;168;32;0;168;0;0;168;0;0;0
301900001;400;395;395;2;135;323;1;76;0;2;74;59;3;56
301900002;500;483;483;2;183;375;1;124;2;5;117;59;2;57
301900003;600;722;723;2;202;466;2;132;2;2;128;70;2;68
301900004;600;754;754;4;243;421;1;178;2;12;164;65;4;61
301900005;600;599;599;3;85;525;1;74;7;2;65;11;0;11
301900006;600;676;676;5;131;476;1;123;10;1;112;8;0;8
301900007;200;186;186;1;56;143;1;56;1;0;55;0;0;0
301900008;200;232;232;5;84;115;1;84;2;6;76;0;0;0
301900009;400;370;370;0;96;329;1;70;4;2;64;26;2;24
301900010;300;355;355;2;129;208;1;91;2;6;83;38;1;37
301900011;500;535;535;3;108;402;1;97;7;0;90;11;0;11
301900012;300;306;306;5;95;204;1;95;0;2;93;0;0;0
301900013;200;222;222;7;114;85;1;114;0;3;111;0;0;0
301900014;400;425;425;5;97;310;1;89;2;0;87;8;0;8
301900015;200;157;157;4;47;152;1;47;2;0;45;0;0;0
301900016;300;261;263;7;120;176;4;120;8;0;112;0;0;0
302100001;60;45;45;2;27;31;2;27;0;0;27;0;0;0
302100002;800;997;997;5;385;414;1;385;14;4;367;0;0;0
302100003;800;864;864;2;425;374;1;425;9;2;414;0;0;0
302100004;500;483;484;6;215;284;1;215;2;4;209;0;0;0
302100005;100;103;103;3;59;40;1;59;5;3;51;0;0;0
302100006;500;494;494;2;232;268;1;231;2;3;226;1;0;1
302100007;700;797;797;3;358;412;1;287;8;1;278;71;0;71
302100008;600;710;710;5;265;334;1;265;19;8;238;0;0;0
302100009;500;537;537;2;214;285;1;214;20;0;194;0;0;0
302100010;500;513;515;8;212;285;3;212;6;0;206;0;0;0
302100011;400;355;355;3;210;193;1;206;3;0;203;4;0;4
302100012;400;373;373;1;139;265;1;134;1;0;133;5;0;5
302100013;700;701;701;4;266;433;1;266;2;1;263;0;0;0
302100014;40;22;22;1;23;17;0;23;0;0;23;0;0;0
302200001;700;798;800;7;162;586;1;113;6;1;106;49;1;48
302200002;700;798;798;9;258;441;1;258;24;1;233;0;0;0
302200003;500;496;496;0;105;425;1;74;2;3;69;31;2;29
302200004;500;513;515;6;150;405;1;94;5;0;89;56;0;56
302200005;700;696;700;7;178;578;1;121;5;4;112;57;3;54
302200006;600;576;576;3;178;501;2;97;2;2;93;80;6;74
302200007;500;513;517;7;160;407;1;92;2;1;89;68;4;64
302200008;600;621;625;6;171;506;1;93;4;2;87;78;3;75
302200009;500;490;494;4;106;426;1;73;1;3;69;33;2;31
302200010;500;577;577;3;134;412;1;87;5;4;78;47;2;45
302200011;700;741;743;7;218;566;1;133;5;3;125;85;5;80
302200012;500;473;474;8;134;418;2;80;1;3;76;54;2;52
302200013;500;491;491;0;155;412;1;87;6;3;78;68;4;64
302200014;500;588;588;5;137;396;1;103;1;8;94;34;1;33
302200015;500;581;582;6;183;402;2;96;4;1;91;87;5;82
302200016;400;448;448;6;130;322;1;77;4;2;71;53;5;48
302200017;600;644;644;7;166;500;1;99;0;0;99;67;9;58
302200018;500;589;590;8;178;417;1;82;0;3;79;96;2;94
302200019;700;708;719;3;236;467;1;232;6;0;226;4;1;3
302200020;100;60;37;12;49;50;1;49;9;1;39;0;0;0
302200021;900;1044;1044;6;197;720;1;179;5;1;173;18;0;18
302200022;500;507;508;4;143;365;1;134;2;1;131;9;0;9
302200023;300;332;333;4;113;218;1;81;1;2;78;32;2;30
302200024;200;147;148;6;42;157;1;42;4;1;37;0;0;0
302200025;200;141;142;4;81;118;1;81;0;5;76;0;0;0
302200026;400;418;418;5;115;301;1;98;9;0;89;17;1;16
302200027;300;291;291;8;47;252;1;47;2;0;45;0;0;0
302200028;700;673;675;11;137;583;3;115;3;2;110;22;0;22
302200029;700;801;801;7;147;552;1;147;6;2;139;0;0;0
302200030;100;12;27;6;18;81;1;18;0;0;18;0;0;0
302200031;400;378;377;4;120;279;1;120;1;1;118;0;0;0
302200032;200;168;168;5;80;119;1;80;5;0;75;0;0;0
302200033;100;98;99;6;39;60;1;39;1;0;38;0;0;0
302200034;300;318;318;6;123;192;3;105;1;2;102;18;0;18
302200035;100;64;64;3;29;70;1;29;0;1;28;0;0;0
302200036;100;10;10;0;9;90;1;9;0;0;9;0;0;0
302300001;600;665;665;3;166;514;1;85;2;2;81;81;3;78
302300002;700;772;774;2;172;585;1;114;0;2;112;58;1;57
302300003;700;700;701;5;212;586;1;113;7;4;102;99;2;97
302300004;600;608;610;1;188;508;1;91;1;2;88;97;5;92
302300005;800;791;795;3;192;674;1;125;8;2;115;67;2;65
302300006;800;1016;1017;5;132;704;2;94;7;1;86;38;2;36
302300007;400;481;483;6;112;321;1;78;4;3;71;33;2;31
302300008;700;776;776;7;183;596;1;103;3;0;100;80;1;79
302300009;500;507;507;5;98;422;1;77;4;2;71;21;1;20
302300010;800;822;824;12;225;647;1;152;1;7;144;73;5;68
302300011;600;676;677;2;240;411;1;188;3;7;178;52;4;48
302300012;800;942;948;6;124;694;1;105;16;0;89;19;1;18
302300013;300;286;288;3;71;228;1;71;1;3;67;0;0;0
302300014;500;602;604;4;143;377;1;122;7;2;113;21;1;20
302300015;600;625;627;6;175;464;1;135;2;1;132;40;1;39
302300016;300;310;310;5;106;203;1;96;4;0;92;10;1;9
302300017;300;285;286;5;74;225;1;74;4;0;70;0;0;0
302300018;300;218;219;1;117;182;1;117;4;1;112;0;0;0
302300019;100;81;81;4;35;64;1;35;2;0;33;0;0;0
302300020;600;636;641;3;138;502;1;97;7;0;90;41;7;34
302300021;300;244;246;3;130;169;1;130;3;1;126;0;0;0
302300022;100;36;36;16;38;60;2;38;6;1;31;0;0;0
302300023;100;19;19;2;20;79;1;20;0;0;20;0;0;0
302500001;800;827;829;8;183;686;1;113;7;2;104;70;3;67
302500002;600;718;718;8;182;467;1;132;7;2;123;50;3;47
302500003;900;930;929;4;253;746;1;153;5;9;139;100;5;94
302500004;600;698;698;0;222;452;1;147;2;3;142;75;5;70
302500005;100;34;34;6;21;78;1;21;1;0;20;0;0;0
302500006;200;197;197;6;69;130;1;69;3;1;65;0;0;0
302500007;400;493;494;4;86;320;1;79;6;3;70;7;0;7
302500008;100;45;45;7;24;75;1;24;2;1;21;0;0;0
302500009;100;82;82;5;61;38;1;61;2;1;58;0;0;0
302500010;100;106;106;7;54;44;2;54;4;2;48;0;0;0
302500011;500;619;622;3;154;372;2;126;8;1;117;28;0;28
302500012;100;27;27;8;16;83;1;16;0;0;16;0;0;0
302500013;500;589;590;8;133;380;1;119;9;3;107;14;0;14
303000001;700;820;820;7;218;605;1;94;1;5;88;124;6;118
303000002;700;807;807;10;194;602;2;96;0;3;93;98;6;92
303000003;700;759;761;13;197;574;1;125;3;4;118;72;8;64
303000004;700;835;836;6;166;610;1;89;0;1;88;77;4;73
303000005;800;919;922;9;185;702;1;97;0;2;95;88;2;86
303000006;700;780;780;7;139;634;1;65;1;1;63;74;2;72
303000007;700;857;858;7;165;609;1;90;3;3;84;75;0;75
303000008;800;959;961;6;171;716;1;83;2;6;75;88;7;81
303000009;800;900;900;11;102;740;1;59;0;2;57;43;1;42
303000010;700;815;818;8;84;652;1;47;1;0;46;37;2;35
303000011;700;838;839;8;196;584;2;114;1;1;112;82;5;77
303000012;700;836;838;8;175;602;1;97;5;2;90;78;1;77
303000013;700;805;805;6;168;608;1;91;1;3;87;77;7;70
303000014;700;847;847;10;195;593;3;104;4;2;98;91;7;84
303000015;800;978;978;6;174;707;1;92;6;3;83;82;4;78
303000016;700;810;810;7;226;578;7;115;6;2;107;111;2;109
303000017;800;1013;1017;6;129;742;1;57;1;0;56;72;4;68
303000018;700;670;670;9;225;593;1;106;0;6;100;119;6;113
303000019;700;690;690;7;225;580;2;118;2;0;116;107;3;104
303000020;700;779;780;8;227;578;1;121;3;7;111;106;9;97
303000021;700;743;744;8;253;566;1;133;1;1;131;120;4;116
303000022;700;706;706;5;210;598;3;99;0;6;93;111;3;108
303000023;700;812;812;3;261;563;1;136;4;5;127;125;7;118
303000024;700;803;804;4;262;542;1;157;2;9;146;105;9;96
303000025;700;682;682;6;194;603;2;95;1;4;90;99;7;92
303000026;700;772;772;5;204;609;1;90;4;1;85;114;9;105
303000027;700;168;753;6;168;626;1;73;1;2;70;95;4;91
303000028;700;745;747;5;228;587;2;111;3;6;102;117;3;114
303000029;700;763;763;4;215;580;1;119;5;2;112;96;6;90
303000030;600;639;643;4;176;502;2;96;3;3;90;80;3;77
303000031;800;998;1002;4;266;635;2;163;6;8;149;99;3;96
303000032;700;894;897;4;317;380;3;317;2;14;301;0;0;0
303000033;700;904;905;8;312;533;1;166;3;8;155;146;7;139
303000034;700;881;882;8;318;540;2;158;4;7;147;160;5;155
303000035;500;562;562;3;224;381;2;117;3;3;111;107;5;102
303000036;500;542;545;8;170;391;1;108;8;3;97;62;4;58
303000037;800;941;944;7;77;757;1;42;2;0;40;35;2;33
303000038;800;888;891;7;192;706;1;93;3;3;87;99;6;93
303000039;700;818;818;9;159;613;1;86;1;1;84;73;2;71
303000040;700;757;758;9;186;602;1;97;3;3;91;89;3;86
303000041;700;781;781;5;176;606;1;93;3;1;89;83;1;82
303000042;800;916;917;8;124;741;3;56;7;0;49;68;4;64
303000043;800;878;878;7;265;665;2;133;7;5;121;132;11;121
303000044;800;818;818;9;283;652;2;146;8;2;136;137;9;127
303000045;800;790;791;8;273;673;1;126;1;6;119;147;8;138
303000046;800;974;975;7;334;655;1;144;4;4;136;190;15;175
303000047;800;881;884;7;246;670;3;127;4;1;122;119;7;112
303000048;800;968;970;8;338;634;2;164;5;6;153;174;6;168
303000049;600;571;572;8;200;514;1;85;4;1;80;115;10;105
303000050;800;874;874;7;330;636;1;163;6;5;152;167;10;157
303000051;800;816;818;2;293;653;7;140;6;3;131;153;9;144
303000052;700;813;813;7;84;615;1;84;9;0;75;0;0;0
303000053;500;512;512;6;156;416;1;83;3;5;75;73;5;68
303000054;800;862;862;7;302;655;1;144;3;2;139;158;5;153
303000055;800;784;785;9;305;496;1;303;2;6;295;2;0;2
303000056;700;712;714;6;243;575;1;124;2;1;121;119;1;118
303000057;800;824;824;9;266;645;1;154;1;3;150;112;5;107
303000058;800;980;981;8;336;636;1;163;4;3;156;173;8;165
303000059;800;765;768;10;297;665;1;134;3;7;124;163;14;149
303000060;800;760;760;7;280;662;1;137;5;3;129;143;6;137
303000061;800;768;768;7;263;680;1;119;6;2;111;144;7;137
303000062;800;747;747;8;233;685;1;114;4;4;106;119;4;115
303000063;800;738;738;6;288;653;1;146;1;5;140;142;5;137
303000064;800;763;763;4;259;675;1;124;1;4;119;135;13;122
303000065;800;843;844;8;342;672;1;127;3;4;120;215;10;205
303000066;800;788;792;9;303;625;1;174;3;6;165;129;4;125
303000067;800;761;761;7;303;656;1;143;1;3;139;160;8;152
303000068;700;691;693;10;268;590;1;109;0;6;103;159;6;153
303000069;800;838;840;8;338;643;1;156;2;2;152;182;11;171
303000070;700;686;690;10;287;561;1;138;5;1;132;149;10;139
303000071;800;785;787;9;368;641;1;158;6;3;149;210;5;205
303000072;700;664;666;10;227;564;2;134;6;7;121;93;6;87
303000073;800;791;792;5;294;651;1;148;4;3;141;146;5;141
303000074;800;857;857;6;316;655;1;144;5;8;131;172;12;160
303000075;800;837;838;9;335;663;2;135;4;1;130;200;10;190
303000076;800;899;899;7;358;633;2;165;4;4;157;193;7;186
303000077;800;837;840;8;298;651;1;148;3;6;139;150;7;143
303000078;700;698;700;8;286;581;2;117;2;2;113;169;3;166
303000079;800;725;726;9;259;665;1;134;2;4;128;125;9;116
303000080;700;660;660;9;270;586;1;113;5;2;106;157;8;149
303000081;600;648;648;8;257;479;1;120;1;3;116;137;4;133
303000082;700;668;670;7;294;540;1;159;1;5;153;135;2;133
303000083;700;673;677;8;241;595;1;104;2;1;101;137;6;131
303000084;700;672;672;9;232;587;1;112;2;4;106;120;7;113
303000085;700;780;782;9;223;582;1;117;6;5;106;106;4;102
303000086;800;936;939;9;276;661;3;136;2;5;129;140;12;128
303000087;800;760;763;9;316;630;1;169;3;7;159;147;10;137
303000088;800;830;831;7;316;637;1;162;1;4;157;154;10;144
303000089;700;656;658;12;213;589;1;110;1;8;101;103;6;97
303000090;500;481;482;4;177;426;1;73;1;5;67;104;4;100
303000091;800;752;754;8;252;680;1;119;2;2;115;133;6;127
303000092;800;755;756;8;271;686;1;113;4;2;107;158;6;152
303000093;800;753;754;8;264;671;1;128;3;6;119;136;11;125
303000094;700;652;654;9;223;621;1;78;4;1;73;145;9;136
303000095;100;35;37;7;30;69;1;30;6;1;23;0;0;0
303000096;200;114;117;6;80;119;1;80;0;4;76;0;0;0
303000097;200;102;102;6;38;161;1;38;0;0;38;0;0;0
303000098;200;152;153;5;88;111;1;88;0;1;87;0;0;0
303000099;200;186;186;5;91;108;1;91;4;4;83;0;0;0
303000100;300;233;233;6;99;200;1;99;1;4;94;0;0;0
303000101;600;530;530;6;96;522;1;77;4;1;72;19;1;18
303000102;900;834;834;4;171;731;1;168;3;2;163;3;1;2
303000103;800;749;750;10;272;627;1;172;4;3;165;96;10;86
303000104;900;1002;1004;4;302;612;1;287;6;9;272;15;0;15
303000105;600;529;529;4;127;480;1;119;4;1;114;8;0;8
303000106;700;629;631;4;168;562;1;137;7;4;126;31;0;31
303000107;400;325;325;7;110;289;1;110;5;1;104;0;0;0
303000108;200;95;97;5;43;156;1;43;0;1;42;0;0;0
303000109;400;329;329;6;103;296;1;103;3;1;99;0;0;0
303000110;100;23;23;6;22;77;1;22;0;1;21;0;0;0
303000111;200;181;181;5;110;89;1;110;1;3;106;0;0;0
303000112;400;368;368;5;117;320;1;79;1;1;77;38;2;36
303000113;500;441;443;6;122;402;1;97;4;4;89;25;1;24
303000114;400;376;376;5;127;325;1;74;3;4;67;53;2;51
303000115;500;496;496;5;112;400;1;99;5;1;93;13;0;13
303000116;100;89;90;7;66;33;1;66;0;5;61;0;0;0
303000117;300;230;230;6;125;174;1;125;0;3;122;0;0;0
303000118;200;184;185;4;105;93;2;105;4;2;99;0;0;0
303000119;600;600;602;8;147;472;3;125;3;2;120;22;0;22
303000120;500;470;471;6;86;434;1;65;2;0;63;21;0;21
303000121;400;382;390;6;96;316;1;83;6;4;73;13;0;13
303000122;600;528;531;3;171;488;1;111;4;4;103;60;5;55
303000123;600;574;577;4;137;501;4;95;3;1;91;42;3;39
303000124;500;504;505;7;82;436;1;63;5;0;58;19;2;17
303000125;200;37;37;49;63;136;1;63;1;2;60;0;0;0
303000126;200;66;66;10;42;154;4;42;3;1;38;0;0;0
303000127;100;23;23;13;27;72;1;27;3;2;22;0;0;0
303000128;100;18;18;0;18;81;1;18;1;0;17;0;0;0
303000129;100;21;21;0;21;78;1;21;0;0;21;0;0;0
303000130;100;21;21;0;19;80;1;19;0;0;19;0;0;0
303000131;100;12;12;3;15;84;1;15;1;0;14;0;0;0
310300001;300;277;281;5;158;141;1;158;6;14;138;0;0;0
310300002;600;621;621;3;319;341;1;258;7;8;243;61;7;54
310300003;100;46;46;6;33;66;1;33;0;0;33;0;0;0
310300004;100;17;18;6;17;82;1;17;1;0;16;0;0;0
310300005;100;28;29;6;27;72;1;27;0;1;26;0;0;0
310300006;200;134;135;4;82;117;1;82;4;4;74;0;0;0
310300007;400;344;350;2;192;207;1;192;5;1;186;0;0;0
310300008;100;39;39;6;32;67;1;32;1;1;30;0;0;0
310300009;100;36;36;5;32;67;1;32;1;3;28;0;0;0
310300010;50;15;16;6;16;33;1;16;0;2;14;0;0;0
310300011;50;14;14;6;11;38;1;11;1;1;9;0;0;0
310300012;200;191;195;5;88;111;1;88;8;2;78;0;0;0
310300013;100;17;17;7;18;81;1;18;1;1;16;0;0;0
310300014;300;253;257;3;147;152;1;147;6;4;137;0;0;0
310300015;100;84;84;6;45;53;2;45;0;2;43;0;0;0
310300016;100;83;83;5;46;53;1;46;3;1;42;0;0;0
310300017;100;60;60;6;38;61;1;38;2;0;36;0;0;0
310300018;100;21;21;4;21;78;1;21;0;0;21;0;0;0
310300019;200;186;217;6;99;100;1;99;3;7;89;0;0;0
310300020;100;21;22;7;17;82;1;17;0;0;17;0;0;0
310300021;50;22;22;4;26;23;1;26;1;0;25;0;0;0
310300022;50;29;29;4;29;20;1;29;2;1;26;0;0;0
310700001;600;616;618;1;224;462;1;137;1;4;132;87;3;84
310700002;600;670;670;5;239;441;1;158;7;7;144;81;5;76
310700003;700;666;667;7;226;554;1;145;0;1;144;81;2;79
310700004;900;857;857;4;247;730;1;169;11;4;154;78;2;76
310700005;700;741;741;0;251;547;2;151;7;4;140;100;6;94
310700006;800;861;861;0;213;666;2;132;6;2;124;81;3;78
310700007;700;749;749;0;198;575;1;124;3;3;118;72;6;66
310700008;800;871;871;0;235;623;1;176;10;9;157;59;1;58
310700009;800;805;807;6;232;649;1;150;3;3;144;82;2;80
310700010;900;877;877;0;190;800;2;98;6;6;86;92;4;88
310700011;800;822;824;0;205;626;1;173;5;5;163;32;0;32
310700012;400;461;462;2;119;298;1;101;1;4;96;18;1;17
310700013;100;56;56;6;31;68;1;31;1;0;30;0;0;0
310700014;100;88;89;5;44;55;1;44;0;0;44;0;0;0
310700015;100;54;54;7;24;75;1;24;1;5;18;0;0;0
310700016;100;48;48;6;27;72;1;27;1;0;26;0;0;0
310700017;300;287;287;5;88;211;1;88;3;2;83;0;0;0
310700018;200;140;140;3;61;138;1;61;0;0;61;0;0;0
310700019;100;57;57;4;35;64;1;35;3;0;32;0;0;0
310700020;100;54;54;4;37;62;1;37;0;0;37;0;0;0
310700021;200;191;192;2;87;112;1;87;2;3;82;0;0;0
310700022;400;412;412;3;88;326;1;73;5;1;67;15;0;15
310700023;300;310;310;4;76;223;1;76;6;0;70;0;0;0
310700024;300;343;343;3;147;187;2;111;5;1;105;36;0;36
310700025;200;108;108;6;51;148;1;51;1;0;50;0;0;0
310700026;400;437;437;5;106;314;1;85;8;2;75;21;0;21
310700027;200;189;189;3;59;140;1;59;1;0;58;0;0;0
310700028;400;408;409;3;119;289;1;110;7;2;101;9;2;7
310700029;100;39;39;6;22;77;1;22;0;0;22;0;0;0
310700030;200;10;10;9;18;181;1;18;2;1;15;0;0;0
312200001;500;466;466;8;170;400;1;99;5;6;88;71;4;67
312200002;900;837;837;2;235;759;1;140;8;7;125;95;5;90
312200003;700;702;702;4;170;574;1;125;9;1;115;45;1;44
312200004;900;841;841;5;205;744;1;155;16;2;137;50;1;49
312200005;500;552;553;5;177;350;1;149;12;4;133;28;1;27
312200006;500;532;533;5;131;413;1;86;7;3;76;45;2;43
312200007;800;844;846;1;255;544;1;255;24;2;229;0;0;0
312200008;100;94;94;4;52;44;4;52;0;5;47;0;0;0
312200009;200;142;142;5;53;146;1;53;3;1;49;0;0;0
312200010;100;49;49;3;35;64;1;35;1;0;34;0;0;0
312200011;300;292;292;2;128;170;2;128;2;2;124;0;0;0
312200012;200;194;195;3;81;118;1;81;1;3;77;0;0;0
312200013;200;207;208;3;111;88;1;111;8;1;102;0;0;0
312200014;400;472;473;6;177;276;1;123;5;6;112;54;3;51
312200015;800;819;819;3;274;563;2;235;16;4;215;39;3;36
312200016;300;268;268;5;120;179;1;120;5;2;113;0;0;0
312200017;300;290;291;1;77;221;2;77;1;0;76;0;0;0
312200018;100;22;22;4;20;79;1;20;0;2;18;0;0;0
312200019;400;436;436;5;210;223;1;176;12;1;163;34;1;33
312200020;200;134;134;5;72;127;1;72;1;3;68;0;0;0
312200021;200;172;172;3;55;144;1;55;1;2;52;0;0;0
312200022;200;153;153;3;69;128;3;69;3;0;66;0;0;0
312200023;100;75;75;4;47;52;1;47;0;1;46;0;0;0
312200024;200;138;140;3;73;126;1;73;2;5;66;0;0;0
312200025;100;50;50;2;37;60;3;37;2;1;34;0;0;0
312200026;200;127;127;4;68;131;1;68;1;1;66;0;0;0
312200027;100;97;97;6;54;45;1;54;2;1;51;0;0;0
312200028;200;117;118;6;46;153;1;46;1;1;44;0;0;0
312200029;300;214;215;2;95;204;1;95;1;0;94;0;0;0
312500001;100;75;76;5;43;56;1;43;0;0;43;0;0;0
312500002;400;417;417;0;151;288;1;111;2;2;107;40;2;38
312500003;400;430;432;1;156;298;1;101;3;5;93;55;2;53
312500004;600;626;626;3;194;446;2;152;8;4;140;42;1;41
312500005;200;204;202;6;113;86;1;113;4;3;106;0;0;0
312500006;400;482;483;4;133;289;1;110;1;0;109;23;1;22
312500007;400;430;430;2;140;299;1;100;2;1;97;40;1;39
312500008;800;898;898;3;330;544;7;249;6;8;235;81;2;79
312500009;100;18;18;6;19;80;1;19;0;0;19;0;0;0
312500010;500;530;532;4;192;339;1;160;6;1;153;32;1;31
312500011;200;194;195;1;97;102;1;97;1;0;96;0;0;0
312500012;200;219;219;3;94;105;1;94;5;0;89;0;0;0
312500013;200;198;198;3;98;101;1;98;4;1;93;0;0;0
312500014;500;583;584;3;187;311;2;187;4;7;176;0;0;0
312500015;100;45;46;3;24;75;1;24;0;0;24;0;0;0
312500016;100;59;60;7;35;64;1;35;0;1;34;0;0;0
312500017;700;793;793;4;199;527;1;172;9;4;159;27;1;26
312500018;100;98;98;3;60;39;1;60;1;0;59;0;0;0
312500019;700;782;783;3;378;378;1;321;14;10;297;57;2;55
312500020;300;378;382;3;180;158;1;141;4;2;135;39;1;38
312500021;200;179;180;5;85;114;1;85;9;2;74;0;0;0
312500022;300;313;313;2;125;174;1;125;1;4;120;0;0;0
312500023;200;130;131;4;87;112;1;87;4;2;81;0;0;0
312500024;300;397;399;7;136;158;10;132;7;0;125;4;0;4
312500025;500;549;550;4;196;363;2;135;4;2;129;61;1;60
312500026;700;758;758;3;249;513;2;185;5;4;176;64;2;62
312500027;400;489;496;2;193;223;2;175;8;3;164;18;0;18
312500028;200;154;154;4;81;118;1;81;3;3;75;0;0;0
312500029;100;105;106;1;53;46;1;53;0;2;51;0;0;0
312500030;200;162;162;4;67;132;1;67;1;0;66;0;0;0
312500031;300;338;338;3;113;198;1;101;3;0;98;12;0;12
312500032;300;287;287;2;127;172;1;127;6;3;118;0;0;0
312500033;500;482;482;3;153;401;1;98;7;3;88;55;2;53
312500034;400;427;428;5;132;334;1;65;2;2;61;67;6;61
312500035;100;78;78;6;28;71;1;28;0;0;28;0;0;0
312500036;400;439;439;0;142;297;1;102;6;6;90;40;1;39
312500037;400;449;448;3;127;320;1;79;14;2;63;48;2;46
312500038;100;101;102;2;38;61;1;38;1;0;37;0;0;0
312500039;200;176;176;6;92;107;1;92;1;8;83;0;0;0
312500040;400;420;420;3;174;248;1;151;4;1;146;23;1;22
312500041;200;118;118;5;66;131;3;66;2;2;62;0;0;0
312500042;300;300;300;4;162;137;1;162;3;6;153;0;0;0
312500043;500;600;600;4;175;365;1;134;4;5;125;41;0;41
312500044;500;576;576;4;146;396;1;103;3;2;98;43;6;37
312500045;200;126;126;4;80;119;1;80;1;2;77;0;0;0
312500046;500;505;500;5;184;321;1;178;20;1;157;6;0;6
312500047;400;433;437;2;150;296;2;102;3;3;96;48;1;47
312500048;400;420;420;4;145;293;4;103;2;2;99;42;0;42
312500049;200;222;223;3;83;116;1;83;1;0;82;0;0;0
312500050;100;12;12;3;15;84;1;15;0;1;14;0;0;0
312600001;500;622;624;6;240;391;2;107;3;3;101;133;6;127
312600002;500;576;579;6;202;398;1;101;0;7;94;101;4;97
312600003;400;421;422;4;148;316;1;83;2;0;81;65;1;64
312600004;400;512;512;7;180;300;1;99;3;2;94;81;2;79
312600005;500;522;527;4;169;413;1;86;3;0;83;83;4;79
312600006;600;640;645;5;220;480;1;119;4;5;110;101;4;97
312600007;600;692;694;7;271;467;2;131;3;4;124;140;5;135
312600008;700;721;725;4;259;584;3;113;2;3;108;146;8;138
312600009;500;497;499;9;210;376;1;123;4;4;115;87;3;84
312600010;500;576;576;9;247;401;2;97;1;1;95;150;6;144
312600011;500;567;568;5;208;388;1;111;2;5;104;97;5;92
312600012;400;501;501;7;169;309;2;89;0;2;87;80;4;76
312600013;500;530;533;9;214;383;2;115;2;0;113;99;1;98
312600014;900;915;916;6;380;714;1;185;4;5;176;195;6;189
312600015;500;559;561;10;233;372;5;123;0;5;118;110;9;101
312600016;400;461;463;6;181;310;7;83;8;2;73;98;5;93
312600017;700;728;732;9;265;571;1;128;5;3;120;137;8;129
312600018;500;548;553;8;195;352;1;147;3;4;140;48;1;47
312600019;600;658;660;8;289;481;1;118;4;1;113;171;7;164
312600020;700;741;745;8;276;558;1;141;1;3;137;135;5;130
312600021;500;529;532;7;170;399;1;100;5;3;92;70;7;63
312600022;600;643;644;5;222;464;3;133;4;5;124;89;3;86
312600023;600;594;595;4;173;493;1;106;1;3;102;67;2;65
312600024;700;693;694;3;185;599;2;99;3;1;95;86;3;83
312600025;600;708;709;6;221;437;1;162;3;5;154;59;1;58
312600026;600;678;671;6;170;504;2;94;2;2;90;76;8;68
312600027;600;622;625;7;214;490;1;109;2;4;103;105;3;102
312600028;600;632;632;9;222;489;1;110;2;7;101;111;4;107
312600029;600;701;701;5;241;511;1;88;3;5;80;153;3;150
312600030;500;490;467;7;92;440;1;59;1;1;57;33;1;32
312600031;400;371;343;7;137;262;1;137;7;7;123;0;0;0
312600032;500;516;518;7;199;412;1;87;1;3;83;112;7;105
312600033;400;442;449;6;150;328;1;71;4;2;65;79;3;76
312600034;500;586;586;5;241;389;1;110;0;3;107;131;1;130
312600035;500;552;554;7;188;404;1;95;1;2;92;93;5;88
312600036;400;506;508;7;187;299;1;100;2;5;93;87;4;83
312600037;700;759;761;8;281;556;2;142;9;5;128;139;2;137
312600038;600;667;671;7;187;494;2;104;1;1;102;83;4;79
312600039;500;532;536;5;139;407;1;92;2;2;88;47;3;44
312600040;500;566;568;8;195;408;2;90;2;0;88;105;2;103
312600041;700;732;732;8;112;613;1;86;11;1;74;26;0;26
312600042;800;843;843;9;175;645;1;154;11;0;143;21;0;21
312600043;900;1006;1006;9;181;732;2;166;26;0;140;15;0;15
312600044;900;993;995;9;202;715;2;183;28;2;153;19;1;18
312600045;800;807;808;9;130;682;2;116;23;0;93;14;0;14
312600046;1000;1030;1030;7;168;831;1;168;20;1;147;0;0;0
312600047;900;986;986;8;122;787;3;110;19;0;91;12;0;12
312600048;1000;1006;1009;8;155;837;8;155;10;1;144;0;0;0
312600049;800;894;894;6;208;591;2;207;22;1;184;1;0;1
312600050;600;691;693;5;137;519;1;80;7;0;73;57;6;51
312600051;600;678;680;3;118;527;3;70;1;2;67;48;4;44
312600052;700;726;728;6;144;602;1;97;5;1;91;47;1;46
312600053;600;652;653;3;124;528;1;71;5;2;64;53;5;48
312600054;400;475;476;5;102;332;1;67;2;2;63;35;3;32
312600055;500;590;592;5;116;428;1;71;1;4;66;45;2;43
312600056;500;513;513;7;122;421;1;78;7;3;68;44;0;44
312600057;400;504;506;8;120;344;1;55;0;0;55;65;0;65
312600058;500;558;559;6;135;432;1;67;5;2;60;68;0;68
312600059;600;650;651;5;232;424;1;175;2;5;168;57;1;56
312600060;700;734;735;6;258;585;2;113;0;5;108;145;7;138
312600061;500;533;536;5;175;401;1;98;2;2;94;77;5;72
312600062;500;523;525;15;200;400;1;99;4;2;93;101;0;101
312600063;600;622;627;7;212;491;3;106;0;6;100;106;6;100
312600064;400;414;419;6;153;316;1;83;1;3;79;70;1;69
312600065;400;457;458;4;157;336;1;63;3;0;60;94;3;91
312600066;500;576;578;3;184;403;1;96;3;3;90;88;5;83
312600067;700;758;758;6;230;566;2;132;2;4;126;98;5;93
312600068;600;600;604;7;194;408;5;187;4;5;178;7;0;7
312600069;400;437;437;4;136;312;1;87;2;1;84;49;2;47
312600070;600;599;599;6;181;500;1;99;1;2;96;82;2;80
312600071;500;569;569;6;136;425;1;74;2;4;68;62;3;59
312600072;600;644;648;5;235;491;1;108;2;3;103;127;6;121
312600073;700;686;686;5;229;573;2;125;3;4;118;104;6;98
312600074;600;604;604;8;184;496;3;101;0;2;99;83;5;78
312600075;400;387;390;5;149;335;2;63;1;1;61;86;4;82
312600076;600;681;681;6;168;512;2;86;5;2;79;82;6;76
312600077;600;652;653;5;207;506;1;93;3;6;84;114;6;108
312600078;500;506;506;7;188;394;1;105;3;6;96;83;3;80
312600079;600;663;665;6;227;488;1;111;5;4;102;116;1;115
312600080;700;726;728;1;259;575;2;123;1;2;120;136;9;127
312600081;700;710;711;5;223;590;1;109;0;2;107;114;7;107
312600082;700;750;753;4;227;605;2;93;2;2;89;134;6;128
312600083;600;591;594;4;169;515;1;84;1;1;82;85;5;80
312600084;600;604;606;9;241;497;1;102;2;1;99;139;8;131
312600085;600;626;628;9;220;488;1;111;3;1;107;109;13;96
312600086;500;551;552;4;174;405;1;94;2;0;92;80;3;77
312600087;600;662;662;6;243;468;1;131;4;5;122;112;5;107
312600088;700;719;721;7;228;575;2;123;3;4;116;105;7;98
312600089;700;730;731;7;291;557;1;142;1;6;135;149;3;146
312600090;500;567;570;5;225;391;3;106;3;2;101;119;6;113
312600091;600;657;661;8;221;500;1;99;2;2;95;122;8;114
312600092;600;649;651;6;250;488;2;110;5;3;102;140;7;133
312600093;500;581;581;7;179;410;1;89;1;6;82;90;5;85
312600094;600;639;641;3;196;476;1;123;8;7;108;73;9;64
312600095;600;619;620;5;225;482;2;116;5;5;106;109;4;105
312600096;600;619;620;4;220;459;1;140;2;3;135;80;4;76
312600097;500;575;581;5;160;396;1;103;4;2;97;57;3;54
312600098;700;775;779;6;232;576;1;123;8;1;114;109;7;102
312600099;500;539;541;4;173;412;1;87;1;3;83;86;7;79
312600100;400;414;415;3;141;325;1;74;3;0;71;67;1;66
312600101;500;526;528;3;198;390;2;108;0;3;105;90;5;85
312600102;100;69;69;5;67;33;0;67;3;2;62;0;0;0
312600103;100;24;24;4;28;72;0;28;0;0;28;0;0;0
312600104;100;15;15;37;50;49;1;50;1;0;49;0;0;0
312600105;100;12;12;12;16;83;1;16;2;0;14;0;0;0
312600106;100;22;22;23;25;74;1;25;2;3;20;0;0;0
320010001;200;0;0;24;24;175;1;24;2;1;21;0;0;0
320010002;200;47;47;12;43;156;1;43;2;2;39;0;0;0
320010003;300;3;3;86;88;211;1;88;0;2;86;0;0;0
320010004;200;16;16;47;63;136;1;63;1;1;61;0;0;0
320010005;300;25;25;109;126;171;3;126;2;1;123;0;0;0
320020006;400;5;5;208;212;187;1;212;5;11;196;0;0;0
320020007;300;47;47;10;24;275;1;24;0;1;23;0;0;0
320020008;300;1;1;93;93;206;1;93;6;3;84;0;0;0
320020009;800;74;74;535;595;599;2;199;4;19;176;397;18;379
320020010;600;15;15;265;273;320;7;273;8;15;250;0;0;0
320020011;600;22;22;317;333;514;4;85;3;5;77;248;11;237
320020012;600;8;8;314;321;278;1;321;13;4;304;0;0;0
320020013;600;34;34;296;322;478;1;121;2;1;118;201;8;193
320020014;600;26;26;376;397;484;1;115;2;4;109;282;11;271
320020015;600;18;18;284;300;299;1;300;1;11;288;0;0;0
320020016;600;11;11;463;470;506;1;93;2;4;87;377;18;359
320020017;400;13;13;166;174;225;1;174;3;3;168;0;0;0
320020018;600;25;25;276;296;303;1;296;3;14;279;0;0;0
320020019;600;35;35;249;276;322;2;276;2;10;264;0;0;0
320020020;300;0;0;74;74;225;1;74;1;4;69;0;0;0
320020021;500;15;15;219;228;270;2;228;3;9;216;0;0;0
320040022;300;5;5;63;67;232;1;67;14;0;53;0;0;0
320040023;200;69;69;131;166;33;1;166;1;138;27;0;0;0
320040024;200;48;48;25;66;133;1;66;0;6;60;0;0;0
320040025;200;52;52;26;30;186;2;30;5;1;24;0;0;0
320050026;100;3;3;28;31;67;2;31;1;0;30;0;0;0
320090027;200;11;11;39;49;150;1;49;1;2;46;0;0;0
320130028;300;13;13;21;34;265;1;34;0;0;34;0;0;0
320140029;400;16;16;300;312;87;1;312;9;11;292;0;0;0
320140030;400;6;6;200;206;193;1;206;5;9;192;0;0;0
320140031;300;12;12;174;183;116;1;183;6;1;176;0;0;0
320140032;300;34;34;150;184;114;2;184;4;2;178;0;0;0
320140033;300;0;0;143;143;156;1;143;4;9;130;0;0;0
320140034;600;46;46;408;442;472;1;127;3;2;122;315;13;302
320140035;600;41;41;255;288;521;1;78;2;1;75;210;6;204
320140036;500;14;14;513;523;301;3;196;11;5;180;327;14;313
320140037;400;6;6;319;323;76;10;323;9;7;307;0;0;0
320140038;300;10;10;140;150;147;3;150;1;4;145;0;0;0
320140039;400;0;0;110;110;288;2;110;2;4;104;0;0;0
320140040;400;3;3;233;235;164;1;235;1;2;232;0;0;0
320140041;400;5;5;251;256;142;2;256;10;6;240;0;0;0
320140042;400;22;22;189;210;188;2;210;4;6;200;0;0;0
320140043;200;0;0;42;42;157;1;42;1;2;39;0;0;0
320140044;300;9;9;151;159;140;1;159;1;1;157;0;0;0
320180045;200;18;18;13;30;169;1;30;1;1;28;0;0;0
320270046;1000;124;124;482;567;769;1;230;12;6;212;337;10;327
320270047;1000;0;0;766;766;688;3;309;11;7;291;457;9;448
320270048;1000;0;0;420;419;805;4;191;7;4;180;228;9;219
320270049;1000;0;0;270;270;861;9;138;9;5;124;132;7;125
320270050;1000;34;34;166;188;914;1;85;4;2;79;103;4;99
320270051;500;20;20;341;357;347;1;152;10;1;141;205;11;194
320270052;600;22;22;249;269;330;1;269;3;3;263;0;0;0
320270053;600;34;34;178;207;392;1;207;5;5;197;0;0;0
320270054;600;0;0;166;166;432;2;166;3;7;156;0;0;0
320270055;600;5;5;219;223;375;2;223;54;10;159;0;0;0
320270056;600;11;11;189;198;401;1;198;6;4;188;0;0;0
320270057;500;276;276;192;276;223;1;276;8;13;255;0;0;0
320270058;500;22;22;198;219;274;7;219;3;8;208;0;0;0
320270059;500;22;22;232;252;243;5;252;9;2;241;0;0;0
320270060;500;47;47;211;187;311;2;187;4;5;178;0;0;0
320270061;400;46;46;294;305;90;5;305;9;9;287;0;0;0
320270062;600;22;22;335;355;241;4;355;11;4;340;0;0;0
320270063;600;54;54;178;211;388;1;211;0;7;204;0;0;0
320270064;600;4;4;210;214;382;4;214;3;2;209;0;0;0
320270065;600;34;34;283;310;288;2;310;7;5;298;0;0;0
320270066;600;0;0;302;302;296;2;302;6;5;291;0;0;0
320270067;500;8;8;153;159;340;1;159;0;1;158;0;0;0
320270068;500;10;10;315;325;349;1;150;7;2;141;175;11;164
320270069;500;66;66;291;351;148;1;351;7;23;321;0;0;0
320270070;500;0;0;315;315;183;2;315;6;9;300;0;0;0
320270071;600;8;8;307;313;281;6;313;10;5;298;0;0;0
320270072;500;9;9;176;185;313;2;185;3;5;177;0;0;0
320270073;500;47;47;319;366;378;1;121;3;5;113;245;1;244
320270074;500;0;0;403;401;352;3;145;5;3;137;256;4;252
320270075;800;31;31;362;389;406;5;389;10;5;374;0;0;0
320270076;400;29;29;278;307;91;2;307;2;6;299;0;0;0
320270077;500;6;6;330;333;163;4;333;15;4;314;0;0;0
320270078;500;11;11;103;111;385;4;111;3;3;105;0;0;0
320270079;500;28;28;442;467;30;3;467;11;15;441;0;0;0
320270080;600;39;39;386;413;441;1;158;7;8;143;255;7;248
320270081;400;16;16;202;217;179;4;217;6;8;203;0;0;0
320270082;1000;75;75;679;720;673;4;323;12;8;303;397;13;384
320270083;700;92;92;426;491;533;2;165;2;4;159;326;7;319
320270084;700;77;77;472;528;513;1;186;4;8;174;342;7;335
320270085;700;30;30;438;454;539;5;156;3;1;152;298;11;287
320270086;600;23;23;274;295;303;2;295;9;11;275;0;0;0
320270087;400;16;16;153;169;228;3;169;1;10;158;0;0;0
320270088;600;52;52;296;339;259;2;339;9;14;316;0;0;0
320270089;500;0;0;388;388;108;4;388;10;9;369;0;0;0
320270090;600;22;22;192;212;387;1;212;3;6;203;0;0;0
320270091;400;8;8;247;255;144;1;255;5;10;240;0;0;0
320270092;600;42;42;151;188;411;1;188;4;5;179;0;0;0
320270093;400;13;13;118;131;268;1;131;1;1;129;0;0;0
320270094;700;59;59;437;481;478;2;220;11;2;207;261;9;252
320270095;500;27;27;227;251;247;2;251;3;3;245;0;0;0
320270096;500;22;22;251;271;225;4;271;15;18;238;0;0;0
320270097;500;13;13;227;238;260;2;238;4;6;228;0;0;0
320270098;500;26;26;192;216;283;1;216;0;7;209;0;0;0
320270099;500;32;32;337;362;357;1;142;3;6;133;220;12;208
320270100;600;90;90;301;350;247;3;350;10;9;331;0;0;0
320270101;500;0;0;507;507;495;1;4;0;0;4;503;12;491
320270102;600;0;0;305;305;292;3;305;3;5;297;0;0;0
320270103;500;34;34;268;300;199;1;300;7;10;283;0;0;0
320270104;600;69;69;367;421;343;6;256;5;6;245;165;7;158
320270105;700;62;62;356;407;684;1;15;0;0;15;392;10;382
320270106;700;0;0;215;215;482;3;215;5;6;204;0;0;0
320270107;700;0;0;231;231;467;2;231;6;5;220;0;0;0
320270108;600;38;38;209;245;352;3;245;11;13;221;0;0;0
320270109;600;0;0;214;214;378;8;214;8;5;201;0;0;0
320270110;600;55;55;365;408;447;2;151;3;2;146;257;11;246
320270111;500;0;0;372;372;338;2;160;5;1;154;211;11;200
320280112;100;14;14;25;39;60;1;39;0;1;38;0;0;0
320290113;200;1;1;54;55;143;2;55;1;1;53;0;0;0
320290114;500;10;10;102;108;391;1;108;0;3;105;0;0;0
320290115;500;3;3;83;85;414;1;85;4;3;78;0;0;0
320290116;600;22;22;463;485;299;1;300;26;2;272;185;3;182
320290117;600;21;21;313;332;432;2;166;18;4;144;166;3;163
320290118;600;18;18;143;153;446;1;153;1;1;151;0;0;0
320290119;200;46;46;38;56;143;1;56;3;6;47;0;0;0
320290120;200;9;9;48;53;146;1;53;1;1;51;0;0;0
320290121;200;42;42;26;59;140;1;59;1;0;58;0;0;0
320290122;500;14;14;131;139;457;1;42;3;0;39;97;1;96
320290123;200;15;15;44;57;142;1;57;0;5;52;0;0;0
320290124;300;20;20;31;47;252;1;47;1;3;43;0;0;0
320290125;300;4;4;59;62;237;1;62;4;3;55;0;0;0
320290126;200;5;5;35;40;159;1;40;6;1;33;0;0;0
320290127;200;0;0;21;21;178;1;21;0;2;19;0;0;0
320290128;200;8;8;62;68;131;1;68;0;4;64;0;0;0
320290129;300;4;4;43;47;252;1;47;6;0;41;0;0;0
320290130;200;28;28;31;43;155;2;43;0;5;38;0;0;0
320290131;300;8;8;44;50;249;1;50;2;1;47;0;0;0
320290132;300;1;1;69;70;229;1;70;3;1;66;0;0;0
320290133;300;18;18;63;81;218;1;81;5;2;74;0;0;0
320290134;800;24;24;257;266;689;4;107;8;3;96;159;4;155
320290135;500;11;11;241;250;289;3;208;4;9;195;39;2;37
320300136;600;27;27;239;259;338;3;259;14;8;237;0;0;0
320300137;600;30;30;286;314;284;2;314;5;15;294;0;0;0
320300138;300;9;9;71;78;221;1;78;1;3;74;0;0;0
320300139;200;7;7;63;68;130;2;68;0;3;65;0;0;0
320300140;400;17;17;140;157;242;1;157;3;10;144;0;0;0
320300141;300;11;11;129;139;159;2;139;0;5;134;0;0;0
320300142;300;4;4;196;197;103;1;196;3;7;186;0;0;0
320300143;200;8;8;80;88;110;2;88;0;2;86;0;0;0
320300144;300;15;15;111;126;171;3;126;0;1;125;0;0;0
320320145;300;1;1;37;38;260;2;38;0;1;37;0;0;0
320460146;800;42;42;209;239;556;5;239;2;6;231;0;0;0
320460147;500;14;14;170;184;315;1;184;0;5;179;0;0;0
320460148;400;53;53;23;52;347;1;52;1;1;50;0;0;0
320460149;400;19;19;64;83;315;2;83;0;3;80;0;0;0
320460150;400;39;39;80;119;280;1;119;0;12;107;0;0;0
320470151;300;9;9;92;101;197;2;101;2;6;93;0;0;0
320480152;600;44;44;276;313;283;4;313;2;8;303;0;0;0
320480153;600;1;1;258;258;341;1;258;5;5;248;0;0;0
320480154;600;0;0;284;284;309;7;284;5;7;272;0;0;0
320480155;200;21;21;73;89;110;1;89;0;4;85;0;0;0
320480156;300;38;38;196;221;76;3;221;1;6;214;0;0;0
320480157;500;9;9;216;225;273;2;225;6;2;217;0;0;0
320480158;200;4;4;110;114;85;1;114;1;2;111;0;0;0
320480159;400;6;6;99;105;294;1;105;3;2;100;0;0;0
320480160;200;3;3;38;41;157;2;41;0;1;40;0;0;0
320480161;500;94;94;262;343;419;1;80;2;3;75;263;8;255
320480162;500;19;19;358;375;392;1;107;7;7;93;268;10;258
320480163;400;19;19;105;118;279;3;118;0;1;117;0;0;0
320480164;400;20;20;150;169;229;2;169;8;2;159;0;0;0
320480165;600;66;66;351;406;192;2;406;10;7;389;0;0;0
320480166;600;25;25;329;349;291;5;304;5;3;296;45;0;45
320480167;600;13;13;282;291;495;3;102;5;0;97;189;3;186
320480168;300;47;47;5;34;265;1;34;3;1;30;0;0;0
320480169;300;62;62;61;62;237;1;62;0;0;62;0;0;0
320480170;600;23;23;202;220;380;2;220;2;7;211;0;0;0
320480171;248;23;23;247;248;349;7;248;5;9;234;0;0;0
320480172;200;2;2;81;83;115;2;83;3;1;79;0;0;0
320480173;300;14;14;102;116;183;1;116;0;6;110;0;0;0
320480174;200;7;7;150;157;41;2;157;2;5;150;0;0;0
320480175;200;2;2;104;106;93;1;106;1;11;94;0;0;0
320480176;300;14;14;79;89;210;1;89;2;3;84;0;0;0
320480177;200;0;0;59;59;140;1;59;0;0;59;0;0;0
320480178;400;23;23;175;197;200;3;197;7;7;183;0;0;0
320480179;300;0;0;31;31;268;1;31;0;6;25;0;0;0
320480180;200;65;65;104;153;46;1;153;1;7;145;0;0;0
320480181;600;28;28;290;317;281;2;317;7;2;308;0;0;0
320480182;300;6;6;66;72;227;1;72;3;2;67;0;0;0
320480183;300;46;46;36;65;234;1;65;4;0;61;0;0;0
320480184;300;26;26;38;60;239;1;60;0;3;57;0;0;0
320480185;300;141;141;131;141;158;1;141;3;3;135;0;0;0
320480186;400;21;21;147;165;233;2;165;3;3;159;0;0;0
320480187;600;26;26;278;298;300;1;299;5;12;282;0;0;0
320480188;600;29;29;232;258;333;9;258;5;4;249;0;0;0
320480189;400;10;10;126;131;266;3;131;3;6;122;0;0;0
320480190;500;6;6;206;211;284;5;211;3;1;207;0;0;0
320480191;300;12;12;119;129;169;2;129;1;4;124;0;0;0
320480192;200;1;1;59;59;140;1;59;0;0;59;0;0;0
320480193;300;27;27;61;85;214;1;85;1;2;82;0;0;0
320480194;600;48;48;294;332;267;1;332;9;5;318;0;0;0
320480195;600;1;1;274;275;324;1;275;6;3;266;0;0;0
320480196;500;37;37;268;301;197;2;301;10;5;286;0;0;0
320480197;500;1;1;191;192;305;11;192;8;3;181;0;0;0
320480198;200;3;3;101;102;96;2;102;2;0;100;0;0;0
320480199;800;45;45;198;238;560;2;238;7;5;226;0;0;0
320480200;200;4;4;91;95;104;1;95;0;6;89;0;0;0
320480201;400;53;53;109;153;246;5;153;4;11;138;0;0;0
320480202;300;12;12;65;74;225;1;74;1;2;71;0;0;0
320480203;300;11;11;74;83;214;3;83;0;3;80;0;0;0
320480204;400;5;5;172;175;224;1;175;3;1;171;0;0;0
320480205;200;0;0;18;18;181;1;18;0;1;17;0;0;0
320480206;300;3;3;76;79;220;1;79;3;4;72;0;0;0
320480207;300;28;28;143;166;133;1;166;1;6;159;0;0;0
320480208;500;274;274;0;274;355;2;143;1;2;140;131;4;127
320480209;300;49;49;51;85;213;2;85;1;3;81;0;0;0
320480210;300;3;3;106;108;191;1;108;2;8;98;0;0;0
320480211;300;58;58;32;67;232;1;67;1;1;65;0;0;0
320480212;300;8;8;54;61;238;1;61;8;1;52;0;0;0
320480213;400;15;15;175;188;210;2;188;4;4;180;0;0;0
320480214;400;1;1;173;174;225;1;174;4;1;169;0;0;0
320480215;700;31;31;380;411;487;5;208;12;6;190;203;8;195
320490216;1000;38;38;140;166;833;1;166;3;5;158;0;0;0
320490217;1000;1;1;162;162;837;1;162;3;4;155;0;0;0
320490218;200;51;51;15;30;168;2;30;0;0;30;0;0;0
320490219;300;44;44;40;74;225;1;74;1;3;70;0;0;0
320490220;300;45;45;35;63;237;1;63;0;1;62;0;0;0
320490221;500;28;28;137;162;335;3;162;4;6;152;0;0;0
320490222;500;22;22;110;128;370;2;128;1;3;124;0;0;0
320490223;400;11;11;101;112;287;1;112;3;0;109;0;0;0
320490224;300;0;0;40;40;259;1;40;0;2;38;0;0;0
320490225;600;59;59;270;317;281;2;317;15;10;292;0;0;0
320490226;600;20;20;264;283;315;2;283;12;9;262;0;0;0
320490227;600;12;12;320;332;265;3;332;11;11;310;0;0;0
320490228;200;43;43;33;57;141;2;57;0;0;57;0;0;0
320490229;400;34;34;98;126;271;3;126;4;5;117;0;0;0
320490230;600;15;15;133;148;449;3;148;1;5;142;0;0;0
320490231;400;15;15;62;76;323;1;76;1;4;71;0;0;0
320490232;300;25;25;43;68;231;1;68;0;0;68;0;0;0
320490233;400;7;7;79;86;312;2;86;0;0;86;0;0;0
320490234;600;5;5;58;62;537;1;62;0;0;62;0;0;0
320490235;200;45;45;30;45;154;1;45;1;2;42;0;0;0
320490236;300;14;14;55;65;234;1;65;2;7;56;0;0;0
320490237;400;84;84;76;84;315;1;84;0;6;78;0;0;0
320490238;400;33;33;54;83;316;4;83;3;1;79;0;0;0
320490239;400;16;16;113;128;271;1;128;1;3;124;0;0;0
320490240;300;7;7;64;68;231;1;68;3;1;64;0;0;0
320490241;200;49;49;18;48;151;1;48;0;2;46;0;0;0
320490242;500;34;34;122;149;349;2;149;2;5;142;0;0;0
320500243;100;10;10;29;38;61;1;38;3;0;35;0;0;0
320540244;400;18;18;210;225;173;2;225;4;0;221;0;0;0
320540245;600;12;12;297;307;302;3;295;6;6;283;12;0;12
320540246;600;13;13;233;245;351;4;245;8;2;235;0;0;0
320540247;500;5;5;199;203;296;1;203;1;6;196;0;0;0
320540248;300;3;3;61;63;236;1;63;1;0;62;0;0;0
320540249;400;6;6;121;127;272;1;127;2;0;125;0;0;0
320540250;200;3;3;57;60;139;1;60;0;2;58;0;0;0
320540251;600;43;43;336;369;457;1;142;1;2;139;227;3;224
320540252;500;35;35;221;245;251;4;245;3;4;238;0;0;0
320540253;400;18;18;157;175;222;4;175;1;0;174;0;0;0
320540254;200;15;15;111;119;80;1;119;1;0;118;0;0;0
320540255;200;14;14;106;120;79;1;120;2;1;117;0;0;0
320540256;200;0;0;98;98;101;1;98;1;2;95;0;0;0
320540257;700;21;21;173;189;509;2;189;6;1;182;0;0;0
320540258;500;6;6;214;220;277;3;220;7;5;208;0;0;0
320550259;200;6;6;56;61;138;1;61;2;1;58;0;0;0
320560260;600;13;13;257;270;468;1;131;12;2;117;139;2;137
320560261;300;5;5;80;85;214;1;85;1;3;81;0;0;0
320560262;300;0;0;83;83;216;1;83;2;0;81;0;0;0
320560263;600;6;6;247;247;343;10;247;7;8;232;0;0;0
320560264;600;25;25;242;263;473;1;126;8;1;117;137;2;135
320560265;600;28;28;223;247;352;1;247;17;4;226;0;0;0
320560266;600;14;14;240;253;343;4;253;6;3;244;0;0;0
320560267;300;7;7;48;55;244;1;55;0;2;53;0;0;0
320570268;100;9;9;54;61;38;1;61;1;2;58;0;0;0
320570269;100;15;15;32;46;53;1;46;0;5;41;0;0;0
320610270;300;81;81;46;121;178;1;121;0;4;117;0;0;0
320640271;200;9;9;58;67;132;1;67;3;3;61;0;0;0
320710272;600;39;39;360;388;455;1;144;2;9;133;244;6;238
320710273;400;247;247;229;247;152;1;247;1;1;245;0;0;0
320760274;600;19;19;187;205;395;0;205;5;5;195;0;0;0
320760275;600;22;22;236;254;345;1;254;0;13;241;0;0;0
320770276;100;4;4;29;33;66;1;33;0;1;32;0;0;0
320800277;1000;5;5;89;94;905;1;94;4;1;89;0;0;0
320800278;1000;0;0;162;162;837;1;162;19;0;143;0;0;0
320800279;500;10;10;70;80;418;2;80;2;0;78;0;0;0
320800280;500;0;0;44;44;455;1;44;4;0;40;0;0;0
320800281;500;0;0;31;31;468;1;31;1;0;30;0;0;0
320800282;500;0;0;59;59;440;1;59;7;0;52;0;0;0
320800283;500;0;0;53;53;446;1;53;2;0;51;0;0;0
320870284;1200;32;32;320;347;852;1;347;8;10;329;0;0;0
320870285;400;1;1;240;240;159;1;240;6;8;226;0;0;0
320870286;400;2;2;269;271;127;2;271;8;16;247;0;0;0
320870287;500;45;45;381;380;147;8;345;20;3;322;35;2;33
320870288;800;111;111;564;655;656;1;143;1;14;128;512;44;468
320870289;600;68;68;419;467;574;1;25;0;1;24;442;12;430
320870290;600;7;7;383;389;206;5;389;10;12;367;0;0;0
320870291;300;7;7;105;111;188;1;111;1;4;106;0;0;0
320870292;500;53;53;294;335;162;3;335;3;24;308;0;0;0
320870293;600;42;42;342;382;216;2;382;6;23;353;0;0;0
320870294;500;4;4;157;161;338;1;161;0;9;152;0;0;0
320870295;500;31;31;226;252;245;3;252;2;25;225;0;0;0
320870296;400;44;44;74;85;312;3;85;2;0;83;0;0;0
320870297;300;53;53;140;190;108;2;190;1;5;184;0;0;0
320870298;300;35;35;130;160;139;1;160;3;15;142;0;0;0
320870299;300;71;71;67;71;228;1;71;0;1;70;0;0;0
320870300;300;17;17;72;84;214;2;84;0;14;70;0;0;0
320870301;400;32;32;122;147;252;1;147;1;4;142;0;0;0
320870302;200;38;38;56;75;123;2;75;0;1;74;0;0;0
320870303;400;46;46;82;80;317;3;80;1;3;76;0;0;0
320870304;500;44;44;337;373;384;2;114;6;6;102;259;15;244
320870305;400;45;45;129;164;235;1;164;2;10;152;0;0;0
320870306;400;40;40;208;238;161;1;238;4;3;231;0;0;0
320870307;400;13;13;149;156;243;1;156;3;6;147;0;0;0
320870308;300;10;10;101;108;191;1;108;1;10;97;0;0;0
320890309;300;19;19;71;84;214;2;84;0;2;82;0;0;0
320900310;500;62;62;277;339;338;2;160;2;4;154;179;2;177
320900311;300;12;12;78;90;209;1;90;0;6;84;0;0;0
320900312;300;4;4;47;51;248;1;51;1;5;45;0;0;0
320900313;300;5;5;84;87;211;2;87;2;1;84;0;0;0
320900314;300;24;24;179;200;96;4;200;1;5;194;0;0;0
320900315;300;44;44;25;58;241;1;58;2;9;47;0;0;0
320900316;300;13;13;50;62;237;1;62;0;0;62;0;0;0
320900317;300;5;5;58;62;236;2;62;1;3;58;0;0;0
320910318;300;3;3;81;84;215;1;84;0;6;78;0;0;0
320910319;600;24;24;226;249;349;2;249;7;6;236;0;0;0
320920320;300;11;11;80;88;211;1;88;0;4;84;0;0;0
320920321;300;9;9;119;128;171;1;128;3;3;122;0;0;0
320920322;300;2;2;158;160;139;1;160;2;7;151;0;0;0
320920323;200;11;11;74;84;115;1;84;1;4;79;0;0;0
320920324;300;22;22;72;91;208;1;91;1;5;85;0;0;0
320920325;200;8;8;58;66;132;2;66;2;7;57;0;0;0
320920326;600;16;16;220;233;362;5;233;6;11;216;0;0;0
320920327;300;18;18;103;121;177;2;121;3;7;111;0;0;0
320920328;300;23;23;101;121;178;1;121;1;8;112;0;0;0
320920329;300;16;16;133;148;150;2;148;1;8;139;0;0;0
320920330;300;3;3;119;122;177;1;122;4;6;112;0;0;0
320920331;300;23;23;114;132;164;4;132;2;1;129;0;0;0
320920332;600;60;60;220;269;329;12;269;10;5;254;0;0;0
320920333;200;3;3;51;54;145;1;54;1;2;51;0;0;0
320920334;300;16;16;101;117;182;1;117;1;7;109;0;0;0
320920335;300;12;12;190;201;95;4;201;3;4;194;0;0;0
320920336;500;32;32;217;244;250;6;244;6;12;226;0;0;0
320920337;300;12;12;149;161;138;1;161;1;4;156;0;0;0
320920338;300;11;11;129;139;159;2;139;5;0;134;0;0;0
320920339;300;42;42;36;55;244;1;55;1;3;51;0;0;0
320920340;200;8;8;97;103;95;2;103;2;4;97;0;0;0
320920341;600;47;47;284;321;278;1;321;6;10;305;0;0;0
320920342;300;28;28;114;138;161;1;138;1;6;131;0;0;0
320920343;200;12;12;37;46;153;1;46;0;3;43;0;0;0
320920344;200;8;8;78;85;114;1;85;0;7;78;0;0;0
320920345;200;7;7;108;114;85;1;114;0;13;101;0;0;0
320920346;300;8;8;113;119;180;1;119;6;3;110;0;0;0
320920347;400;18;18;142;159;240;1;159;3;12;144;0;0;0
320920348;500;54;54;252;260;206;4;290;5;4;281;0;0;0
320920349;400;12;12;189;199;198;3;199;10;7;182;0;0;0
320920350;500;24;24;225;247;252;1;247;10;8;229;0;0;0
320920351;200;13;13;33;46;153;1;46;1;2;43;0;0;0
320920352;400;46;46;144;181;218;1;181;1;4;176;0;0;0
320920353;200;14;14;60;72;127;1;72;4;0;68;0;0;0
320920354;300;13;13;101;114;184;2;114;1;3;110;0;0;0
320920355;300;16;16;143;154;145;1;154;2;2;150;0;0;0
320920356;400;22;22;167;182;217;1;182;3;4;175;0;0;0
320920357;200;0;0;73;73;127;4;73;3;6;64;0;0;0
320920358;500;25;25;420;433;356;1;143;7;4;132;290;12;278
320920359;400;0;0;297;297;102;9;297;8;4;285;0;0;0
320920360;500;1;1;349;349;421;1;78;0;0;78;271;9;262
320920361;400;5;5;125;129;270;1;129;11;3;115;0;0;0
320920362;500;41;41;299;334;394;7;105;6;4;95;229;6;223
320920363;700;25;25;424;446;249;5;446;12;6;428;0;0;0
320920364;600;41;41;339;372;435;1;164;4;10;150;208;5;202
320920365;300;5;5;143;145;153;2;145;3;1;141;0;0;0
320920366;500;9;9;284;290;207;3;290;10;9;271;0;0;0
320920367;400;16;16;215;231;165;4;231;7;5;219;0;0;0
320920368;400;4;4;219;221;178;1;221;2;3;216;0;0;0
320920369;400;3;3;173;174;224;2;174;8;7;159;0;0;0
320920370;600;25;25;345;336;262;2;336;15;7;314;0;0;0
320920371;500;6;6;396;401;458;1;41;1;2;38;360;12;348
320920372;300;24;24;145;165;134;1;165;2;2;161;0;0;0
320920373;700;25;25;490;513;185;2;513;7;22;484;0;0;0
320920374;600;15;15;418;430;593;0;7;0;1;6;423;22;401
320920375;500;0;0;268;268;224;8;268;9;5;254;0;0;0
320920376;600;32;32;353;380;504;1;95;5;4;86;285;11;274
320920377;300;9;9;95;103;196;1;103;4;2;97;0;0;0
320920378;400;7;7;223;227;169;4;227;6;3;218;0;0;0
320920379;500;36;36;339;370;484;0;16;0;0;16;354;9;345
320920380;300;4;4;106;107;192;1;107;3;3;101;0;0;0
320920381;400;4;4;203;207;190;3;207;14;11;182;0;0;0
320920382;600;16;16;412;425;528;2;72;5;1;66;353;9;344
320920383;500;3;3;241;242;257;1;242;4;12;226;0;0;0
320920384;600;15;15;273;280;319;1;280;12;6;262;0;0;0
320920385;400;13;13;236;249;148;3;249;6;6;237;0;0;0
320920386;400;16;16;248;262;135;3;262;13;5;244;0;0;0
320920387;400;8;8;159;165;232;3;165;5;4;156;0;0;0
320920388;700;79;79;397;457;580;1;120;10;6;104;336;10;326
320920389;700;13;13;367;379;450;3;247;9;8;230;132;4;128
320920390;700;11;11;421;427;578;1;121;5;1;115;306;11;295
320920391;700;6;6;198;201;642;2;57;1;2;54;144;6;138
320920392;300;17;17;133;145;154;1;145;2;9;134;0;0;0
320920393;500;17;17;174;187;311;2;187;3;3;181;0;0;0
320920394;300;3;3;166;168;129;3;168;3;5;160;0;0;0
320920395;500;12;12;296;306;193;1;306;7;20;279;0;0;0
320920396;500;23;23;216;239;259;2;239;6;7;226;0;0;0
320920397;400;22;22;193;206;192;2;206;7;4;195;0;0;0
320920398;500;75;75;217;280;219;1;280;6;14;260;0;0;0
320920399;300;18;18;91;105;194;1;105;3;2;100;0;0;0
320920400;300;17;17;154;167;132;1;167;3;10;154;0;0;0
320920401;400;29;29;211;235;163;2;235;10;10;215;0;0;0
320920402;300;15;15;83;97;201;2;97;3;9;85;0;0;0
320920403;400;14;14;154;164;235;1;164;1;3;160;0;0;0
320920404;200;3;3;61;64;135;1;64;0;1;63;0;0;0
320920405;300;15;15;156;167;131;2;167;6;1;160;0;0;0
320920406;400;8;8;158;166;232;2;166;2;6;158;0;0;0
320920407;300;9;9;91;100;199;1;100;0;7;93;0;0;0
320920408;500;33;33;245;271;227;2;271;1;9;261;0;0;0
320920409;400;12;12;127;137;262;1;137;4;6;127;0;0;0
320920410;400;8;8;223;228;171;1;228;3;8;217;0;0;0
320920411;300;11;11;58;67;231;2;67;0;4;63;0;0;0
320920412;400;51;51;209;256;140;4;256;4;17;235;0;0;0
320920413;200;6;6;85;90;107;3;90;2;4;84;0;0;0
320920414;300;9;9;65;71;228;1;71;4;3;64;0;0;0
320920415;300;24;24;103;126;173;1;126;1;21;104;0;0;0
320920416;300;21;21;96;110;189;1;110;2;4;104;0;0;0
320920417;300;24;24;63;87;212;1;87;0;7;80;0;0;0
320920418;400;19;19;108;121;277;2;121;2;6;113;0;0;0
320920419;300;9;9;160;169;130;1;169;3;8;158;0;0;0
320920420;300;14;14;153;161;138;1;161;8;6;147;0;0;0
320920421;300;11;11;154;162;137;1;162;5;5;152;0;0;0
320920422;300;6;6;160;164;134;2;164;5;6;153;0;0;0
320920423;300;16;16;164;180;118;2;180;1;15;164;0;0;0
320920424;300;7;7;96;103;196;1;103;1;4;98;0;0;0
320920425;400;18;18;221;234;164;2;234;1;15;218;0;0;0
320920426;300;5;5;79;84;215;1;84;0;8;76;0;0;0
320920427;300;11;11;101;111;188;1;111;3;12;96;0;0;0
320920428;500;25;25;294;315;409;2;89;1;1;87;226;14;212
320920429;200;1;1;60;60;139;1;60;1;2;57;0;0;0
320920430;400;13;13;156;169;230;1;169;3;5;161;0;0;0
320920431;300;42;42;72;95;204;1;95;1;7;87;0;0;0
320990432;500;28;28;163;189;309;2;189;4;1;184;0;0;0
320990433;300;20;20;59;77;222;1;77;0;7;70;0;0;0
321000434;600;26;26;226;249;350;1;249;4;1;244;0;0;0
321000435;200;11;11;38;47;152;2;46;1;2;43;0;0;0
321000436;300;9;9;46;52;247;1;52;3;2;47;0;0;0
321010437;200;6;6;27;32;167;1;32;0;2;30;0;0;0
321020438;500;33;33;172;200;299;1;200;2;13;185;0;0;0
321030439;700;28;28;185;204;494;2;204;7;8;189;0;0;0
321030440;200;24;24;35;54;145;1;54;4;1;49;0;0;0
321040441;300;3;3;40;43;256;1;43;1;1;41;0;0;0
321040442;400;28;28;35;60;338;2;60;0;0;60;0;0;0
321040443;500;22;22;162;179;319;2;179;2;4;173;0;0;0
321060444;100;6;6;16;21;78;1;21;0;2;19;0;0;0
321070445;300;15;15;132;144;155;3;144;2;2;140;0;0;0
321070446;500;34;34;504;532;331;2;167;1;1;165;365;10;355
321070447;700;34;34;357;390;307;3;390;9;5;376;0;0;0
321070448;200;16;16;67;82;117;1;82;0;1;81;0;0;0
321070449;400;18;18;180;194;200;6;194;0;2;192;0;0;0
321070450;400;27;27;227;249;148;3;249;4;2;243;0;0;0
321070451;300;19;19;110;128;167;5;128;1;1;126;0;0;0
321070452;200;54;54;22;62;137;1;62;1;2;59;0;0;0
321070453;700;40;40;414;449;547;3;150;1;2;147;299;7;292
321070454;200;50;50;27;62;137;1;62;3;0;59;0;0;0
321070455;300;5;5;100;105;193;2;105;2;2;101;0;0;0
321070456;400;9;9;140;147;251;2;147;4;3;140;0;0;0
321070457;600;16;16;638;650;221;3;376;6;2;368;268;10;258
321070458;600;6;6;155;159;437;4;159;2;1;156;0;0;0
321070459;600;1;1;185;185;413;2;185;0;3;182;0;0;0
321070460;300;0;0;138;138;162;6;138;4;3;131;0;0;0
321070461;200;49;49;36;63;136;1;63;0;1;62;0;0;0
321070462;200;43;43;39;69;130;1;69;0;2;67;0;0;0
321070463;300;6;6;111;117;182;4;117;3;3;111;0;0;0
321070464;600;13;13;372;380;546;1;53;0;0;53;327;10;317
321070465;400;10;10;205;214;184;2;214;4;3;207;0;0;0
321070466;500;1;1;444;445;335;4;164;3;3;158;281;10;271
321070467;500;16;16;167;178;321;1;178;2;2;174;0;0;0
321070468;200;51;51;17;51;148;1;51;1;1;49;0;0;0
321070469;300;6;6;85;91;208;1;91;1;1;89;0;0;0
321070470;300;59;59;56;59;240;1;59;0;5;54;0;0;0
321070471;200;48;48;11;45;154;1;45;2;0;43;0;0;0
321070472;300;6;6;97;103;196;1;103;0;0;103;0;0;0
321070473;300;29;29;103;130;169;1;130;2;7;121;0;0;0
321070474;300;21;21;104;121;177;2;121;1;0;120;0;0;0
321070475;700;52;52;474;517;494;3;203;8;6;189;314;4;310
321070476;400;21;21;106;124;275;1;124;2;0;122;0;0;0
321070477;300;7;7;87;94;205;1;94;2;1;91;0;0;0
321070478;200;57;57;34;79;120;1;79;1;2;76;0;0;0
321070479;300;54;54;58;92;207;1;92;0;2;90;0;0;0
321070480;300;56;56;24;72;226;2;72;2;1;69;0;0;0
321070481;300;1;1;83;83;216;1;83;2;2;79;0;0;0
321070482;300;14;14;106;120;121;1;120;3;1;116;0;0;0
321070483;300;24;24;111;130;169;1;130;0;1;129;0;0;0
321070484;300;30;30;109;133;166;1;133;2;4;127;0;0;0
321070485;500;3;3;224;224;274;2;224;11;1;212;0;0;0
321070486;600;45;45;213;257;341;2;257;5;3;249;0;0;0
321070487;400;31;31;52;83;316;3;83;2;0;81;0;0;0
321070488;300;44;44;32;59;239;2;59;1;3;55;0;0;0
321070489;600;8;8;195;200;397;3;200;2;1;197;0;0;0
321070490;400;12;12;137;143;255;2;143;3;2;138;0;0;0
321070491;300;6;6;95;101;198;1;101;2;3;96;0;0;0
321070492;300;10;10;109;119;179;2;119;7;4;108;0;0;0
321070493;300;9;9;107;115;185;7;115;6;0;109;0;0;0
321070494;300;5;5;86;91;207;2;91;0;0;91;0;0;0
321070495;300;28;28;121;145;154;1;145;1;6;138;0;0;0
321070496;200;0;0;60;60;139;1;60;2;0;58;0;0;0
321070497;300;14;14;130;141;157;2;141;0;4;137;0;0;0
321080498;500;10;10;149;9;341;1;158;7;4;147;0;0;0
321080499;300;4;4;36;40;259;1;40;5;4;31;0;0;0
321080500;300;45;45;35;40;259;1;40;3;1;36;0;0;0
321080501;300;0;0;51;51;248;1;51;6;2;43;0;0;0
321080502;300;1;1;37;38;260;2;38;2;2;34;0;0;0
321090503;200;18;18;62;76;123;1;76;1;3;72;0;0;0
321110504;700;28;28;123;146;553;1;146;3;4;139;0;0;0
321120505;300;29;29;81;102;196;2;102;2;2;98;0;0;0
321150506;400;8;8;135;142;257;1;142;0;3;139;0;0;0
321150507;600;51;51;211;228;371;1;228;27;5;196;0;0;0
321150508;500;1;1;82;83;416;1;83;6;1;76;0;0;0
321150509;700;2;2;600;602;432;2;266;33;5;228;336;7;329
321160510;200;4;4;19;22;177;1;22;0;2;20;0;0;0
321180511;300;28;28;99;115;184;1;115;5;3;107;0;0;0
321180512;600;251;251;231;344;567;1;32;1;0;31;312;0;312
321180513;300;102;102;70;111;187;2;111;5;0;106;0;0;0
321180514;400;98;98;29;90;308;2;90;2;0;88;0;0;0
321180515;400;21;21;37;53;346;1;53;1;0;52;0;0;0
321180516;600;118;118;139;208;391;1;208;8;4;196;0;0;0
321180517;1000;166;166;110;276;999;1;0;0;0;0;276;0;276
321180518;500;97;97;86;141;357;2;141;10;0;131;0;0;0
321180519;1000;71;71;141;175;824;1;175;12;0;163;0;0;0
321180520;1000;154;154;49;136;862;2;136;5;2;129;0;0;0
321180521;1000;41;41;335;360;766;4;230;29;0;201;130;1;129
321180522;1000;43;43;48;69;929;2;69;1;0;68;0;0;0
321180523;1000;41;41;105;119;879;2;119;7;0;112;0;0;0
321180524;1000;41;41;41;67;932;1;67;3;0;64;0;0;0
321180525;1000;130;130;313;414;600;3;397;28;1;368;17;1;16
321180526;1200;70;70;150;187;1141;1;58;6;0;52;129;0;129
321180527;1000;87;87;274;296;703;1;296;20;0;276;0;0;0
321180528;1000;61;61;185;210;789;1;210;14;1;195;0;0;0
321180529;1000;50;50;250;260;994;1;5;0;0;5;255;0;255
321180530;1000;48;48;173;178;819;3;178;16;1;161;0;0;0
321180531;1000;62;62;411;440;999;1;0;0;0;0;440;1;439
321180532;1000;50;50;307;318;682;0;318;29;0;289;0;0;0
321180533;1000;84;84;391;421;824;1;175;21;1;153;246;0;246
321180534;1000;61;61;223;244;755;1;244;13;0;231;0;0;0
321180535;1000;46;46;113;130;869;1;130;12;0;118;0;0;0
321180536;1000;61;61;306;330;663;7;330;34;0;296;0;0;0
321180537;1000;51;51;505;556;976;1;23;0;0;23;533;0;533
321180538;1200;80;80;345;425;1187;1;12;0;0;12;413;1;412
321180539;1000;57;57;393;405;998;1;1;0;0;1;404;1;403
321180540;1200;69;69;411;441;1197;1;2;0;0;2;439;0;439
321180541;1000;14;14;551;565;999;1;0;0;0;0;565;1;564
321180542;1000;49;49;440;450;917;1;82;9;0;73;368;0;368
321180543;1000;67;67;231;264;735;1;264;30;0;234;0;0;0
321180544;1000;64;64;297;319;680;1;319;15;0;304;0;0;0
321180545;1200;61;61;281;306;999;2;199;17;0;182;107;1;106
321180546;1000;58;58;356;384;955;1;44;6;0;38;340;2;338
321180547;1000;60;60;294;311;987;1;12;0;0;12;299;0;299
321180548;1000;55;55;350;371;627;2;371;41;0;330;0;0;0
321180549;1000;68;68;414;445;699;2;299;20;0;279;146;0;146
321180550;1000;51;51;293;308;690;2;308;29;0;279;0;0;0
321180551;1000;42;42;169;181;818;1;181;15;0;166;0;0;0
321180552;1000;66;66;262;275;976;1;23;3;0;20;252;1;251
321180553;1000;51;51;165;172;827;1;172;10;0;162;0;0;0
321180554;1000;66;66;391;403;682;1;317;54;0;263;86;0;86
321180555;1000;56;56;393;436;913;1;86;7;0;79;350;0;350
321180556;1000;55;55;294;314;999;1;0;0;0;0;314;0;314
321180557;1000;57;57;392;421;819;3;178;15;0;163;243;2;241
321180558;1000;56;56;202;258;738;4;258;5;6;247;0;0;0
321180559;1000;98;98;217;284;714;2;284;9;0;275;0;0;0
321180560;1000;45;45;151;162;836;2;162;10;1;151;0;0;0
321180561;1000;67;67;300;338;827;1;172;24;0;148;166;1;165
321180562;1000;48;48;354;377;620;3;377;35;2;340;0;0;0
321180563;1200;47;47;242;256;943;1;256;12;0;244;0;0;0
321180564;1000;94;94;420;488;928;1;71;2;0;69;417;2;415
321180565;1000;83;83;321;357;995;1;4;0;0;4;353;0;353
321180566;1000;85;85;313;344;997;1;2;0;0;2;342;0;342
321180567;300;16;16;24;36;263;1;36;0;0;36;0;0;0
321180568;400;223;223;122;149;249;2;149;10;2;137;0;0;0
321180569;400;181;181;136;190;209;1;190;15;1;174;0;0;0
321180570;800;476;476;247;399;798;1;1;0;0;1;398;1;398
321180571;400;102;102;80;141;258;1;141;1;0;140;0;0;0
321180572;1000;253;253;514;544;467;1;532;54;0;478;12;0;12
321180573;1000;188;188;362;425;981;1;18;1;0;17;407;0;407
321180574;1000;161;161;397;475;610;1;389;30;0;359;86;1;85
321180575;400;35;35;106;113;286;1;113;11;0;102;0;0;0
321180576;1000;253;253;308;375;920;2;78;6;0;72;297;0;297
321180577;1000;306;306;163;237;875;2;123;5;0;118;114;0;114
321180578;1000;124;124;342;363;917;5;78;5;0;73;285;0;285
321180579;600;180;180;231;302;296;2;302;10;0;292;0;0;0
321180580;600;180;180;204;284;315;1;284;20;1;263;0;0;0
321180581;600;25;25;228;242;522;1;77;0;2;75;165;0;165
321180582;600;20;20;236;243;546;2;52;4;0;48;191;0;191
321180583;1000;126;126;361;414;979;2;19;1;0;18;395;2;393
321180584;1000;124;124;629;691;319;3;678;31;0;647;13;0;13
321180585;800;154;154;308;394;799;1;0;0;0;0;394;0;394
321180586;1000;186;186;312;429;993;1;6;0;0;6;423;0;423
321180587;1000;89;89;539;574;999;1;0;0;0;0;574;0;574
321180588;400;37;37;71;85;313;2;85;1;1;83;0;0;0
321180589;1000;17;17;115;126;873;1;126;10;2;114;0;0;0
321180590;1000;56;56;151;171;827;2;171;12;0;159;0;0;0
321180591;1000;50;50;131;146;854;1;146;21;1;124;0;0;0
321180592;1000;59;59;183;220;778;2;220;10;0;210;0;0;0
321180593;1000;95;95;226;300;912;1;87;3;0;84;213;0;213
321180594;1200;113;113;497;553;1081;2;117;4;0;113;436;0;436
321180595;1000;102;102;278;314;973;1;26;5;0;21;288;0;288
321180596;1200;78;78;287;327;1043;2;155;21;0;134;172;0;172
321180597;1000;60;60;330;355;838;1;161;23;0;138;194;0;194
321180598;1200;61;61;420;438;1199;1;0;0;0;0;438;0;438
321180599;1200;65;65;323;357;1070;2;128;15;0;113;229;0;229
321180600;1000;44;44;214;218;781;1;218;8;1;209;0;0;0
321180601;1000;43;43;393;406;977;1;22;2;0;20;384;2;382
321180602;1200;71;71;306;336;1049;1;150;10;0;140;186;1;185
321180603;1000;81;81;246;294;800;2;198;9;1;188;96;1;95
321180604;1000;81;81;247;299;700;1;299;12;0;287;0;0;0
321180605;1000;46;46;318;337;659;4;337;28;0;309;0;0;0
321180606;1000;44;44;217;235;764;1;235;26;0;209;0;0;0
321180607;1000;75;75;192;229;915;1;84;10;0;74;145;0;145
321180608;1000;75;75;277;322;999;1;0;0;0;0;322;0;322
321180609;1200;44;44;187;196;1000;4;196;16;0;180;0;0;0
321180610;1200;48;48;186;201;998;1;201;7;0;194;0;0;0
321180611;1000;45;45;121;130;868;2;130;8;1;121;0;0;0
321180612;1000;56;56;178;202;797;1;202;14;1;187;0;0;0
321180613;1000;45;45;128;145;852;3;145;14;0;131;0;0;0
321180614;1000;13;13;204;217;782;1;217;5;1;211;0;0;0
321180615;1500;114;114;222;303;1444;1;55;4;1;50;248;0;248
321180616;1000;57;57;60;83;916;1;83;6;0;77;0;0;0
321180617;1500;109;109;195;263;1232;5;263;36;0;227;0;0;0
321180618;1000;93;93;287;341;657;2;341;21;0;320;0;0;0
321180619;1000;59;59;347;374;955;1;44;3;1;40;331;1;330
321180620;1000;61;61;210;240;759;1;240;22;0;218;0;0;0
321180621;1000;63;63;218;247;751;2;247;17;1;229;0;0;0
321180622;1000;65;65;41;88;910;2;88;5;1;82;0;0;0
321180623;1000;62;62;300;315;684;1;315;32;2;281;0;0;0
321180624;1000;56;56;265;277;722;1;277;19;0;258;0;0;0
321180625;1000;7;7;189;195;804;1;195;6;0;189;0;0;0
321180626;1200;94;94;210;230;969;1;230;36;1;193;0;0;0
321180627;1000;86;86;230;243;754;3;243;44;0;199;0;0;0
321180628;800;44;44;133;147;652;1;147;12;1;134;0;0;0
321180629;300;70;70;25;85;213;2;85;1;0;84;0;0;0
321180630;1000;467;467;162;401;628;1;371;27;1;343;30;1;29
321180631;1000;79;79;116;145;855;3;145;17;0;128;0;0;0
321180632;1000;182;182;166;262;733;5;262;31;0;231;0;0;0
321180633;1000;54;54;111;136;862;2;136;12;0;124;0;0;0
321180634;200;45;45;30;58;140;2;58;2;1;55;0;0;0
321180635;1500;109;109;601;617;900;2;598;43;0;555;19;1;18
321180636;1000;100;100;382;396;679;5;316;30;0;286;80;0;80
321180637;600;70;70;159;206;393;1;206;15;0;191;0;0;0
321180638;600;33;33;133;156;443;1;156;13;0;143;0;0;0
321180639;600;11;11;191;202;432;1;167;1;0;166;35;1;34
321180640;300;47;47;51;89;210;1;89;4;2;83;0;0;0
321180641;400;104;104;15;86;313;1;86;2;0;84;0;0;0
321180642;1000;469;469;120;330;999;1;0;0;0;0;330;0;330
321180643;1000;129;129;243;342;999;1;0;0;0;0;342;0;342
321180644;1000;63;63;183;216;783;1;216;3;0;213;0;0;0
321180645;1000;33;33;105;119;880;1;119;5;0;114;0;0;0
321180646;1000;57;57;10;32;967;1;32;1;0;31;0;0;0
321180647;1000;56;56;64;103;896;1;103;3;0;100;0;0;0
321180648;1000;16;16;302;312;968;1;31;0;0;31;281;0;281
321180649;1000;1;1;287;288;711;1;288;24;1;263;0;0;0
321180650;1000;96;96;265;333;999;1;0;0;0;0;333;0;333
321180651;1000;51;51;75;99;899;2;99;4;0;95;0;0;0
321180652;1000;359;359;251;364;966;1;33;1;0;32;331;1;330
321180653;800;300;300;304;404;516;1;283;34;0;249;121;0;121
321180654;500;108;108;171;220;279;1;220;10;0;210;0;0;0
321180655;1200;248;248;152;243;954;3;243;21;1;221;0;0;0
321180656;800;0;0;195;195;603;2;195;25;2;168;0;0;0
321180657;1000;105;105;210;238;760;2;238;12;1;225;0;0;0
321180658;800;15;15;93;105;694;1;105;4;7;94;0;0;0
321180659;1500;63;63;549;562;1133;3;364;34;0;330;198;4;194
321180660;1000;92;92;300;327;671;2;327;40;0;287;0;0;0
321180661;1000;331;331;349;496;831;3;166;27;0;139;330;1;329
321180662;500;56;56;5;40;459;1;40;0;0;40;0;0;0
321180663;1000;40;40;141;181;818;1;181;1;0;180;0;0;0
321180664;1000;65;65;104;126;872;2;126;6;1;119;0;0;0
321180665;1000;91;91;266;293;998;1;1;0;0;1;294;0;292
321180666;1500;230;230;428;479;1218;4;278;23;1;254;201;1;200
321180667;1500;246;246;280;368;1262;5;233;31;0;202;135;1;134
321180668;1500;238;238;264;339;1153;8;339;40;0;299;0;0;0
321180669;1500;235;235;535;593;1474;1;25;1;0;24;568;0;568
321180670;1500;489;489;551;678;879;2;619;71;0;548;59;1;58
321180671;1500;454;454;440;569;1000;4;496;60;0;436;73;0;73
321180672;1500;445;445;333;460;1198;18;284;12;0;272;176;0;176
321180673;1500;116;116;339;455;1070;2;428;40;1;387;27;0;27
321180674;1500;441;441;149;242;1321;2;177;21;0;156;65;0;65
321180675;1000;255;255;185;326;996;1;3;0;0;3;323;0;323
321180676;1000;274;274;76;242;998;1;1;0;0;1;241;0;241
321180677;1000;72;72;40;96;902;2;96;0;1;95;0;0;0
321180678;1000;115;115;234;320;999;1;0;0;0;0;320;0;320
321210679;700;17;17;196;211;485;4;211;2;5;204;0;0;0
321240680;200;13;13;63;75;124;1;75;2;3;70;0;0;0
321240681;400;30;30;218;246;153;1;246;7;9;230;0;0;0
321240682;200;24;24;63;84;115;1;84;0;8;76;0;0;0
321250683;700;79;79;359;426;587;2;111;11;2;98;314;10;304
321250684;700;9;9;397;404;609;1;90;2;0;88;314;8;306
321250685;700;6;6;343;349;347;4;349;11;9;329;0;0;0
321250686;400;49;49;62;107;291;2;107;1;9;97;0;0;0
321250687;400;20;20;118;132;267;1;132;3;9;120;0;0;0
321250688;400;21;21;47;66;332;2;66;0;1;65;0;0;0
321250689;400;11;11;82;92;307;1;92;1;4;87;0;0;0
321250690;700;48;48;240;278;421;1;278;7;8;263;0;0;0
321250691;400;49;49;99;134;265;1;134;13;1;120;0;0;0
321250692;400;20;20;100;120;279;1;120;4;3;113;0;0;0
321250693;300;15;15;102;116;182;2;116;1;6;109;0;0;0
321250694;700;31;31;269;292;585;2;113;3;6;104;179;7;172
321250695;300;8;8;66;72;227;1;72;1;3;68;0;0;0
321250696;300;27;27;106;129;170;1;129;4;5;120;0;0;0
321250697;500;20;20;171;189;310;1;189;1;5;183;0;0;0
321250698;400;9;9;53;61;338;1;61;0;3;58;0;0;0
321250699;400;23;23;130;149;248;3;149;2;6;141;0;0;0
321270700;600;24;24;60;82;517;1;82;1;3;78;0;0;0
321290701;100;3;3;13;16;83;1;16;1;0;15;0;0;0
321300702;700;95;95;161;244;664;2;34;0;0;34;210;6;204
321300703;700;6;6;281;286;651;1;48;3;2;43;238;6;232
321300704;700;2;2;230;232;465;3;232;5;4;223;0;0;0
321320705;400;24;24;221;244;151;5;244;5;5;234;0;0;0
321320706;400;19;19;235;254;145;1;254;3;4;247;0;0;0
321320707;500;52;52;268;317;417;1;82;5;0;77;235;6;229
321320708;400;2;2;154;156;243;1;156;4;8;144;0;0;0
321320709;300;8;8;141;148;151;1;148;0;0;148;0;0;0
321320710;300;2;2;37;39;260;1;39;1;0;38;0;0;0
321320711;300;15;15;82;94;205;1;94;3;3;88;0;0;0
321320712;300;13;13;68;75;224;1;75;1;3;71;0;0;0
321320713;300;0;0;160;160;138;2;160;1;8;151;0;0;0
321320714;500;66;66;442;499;464;1;35;1;0;34;464;16;448
321320715;500;0;0;227;227;272;1;227;10;5;212;0;0;0
321330716;700;41;41;330;362;337;1;362;10;8;344;0;0;0
321330717;500;12;12;155;166;333;1;166;1;5;160;0;0;0
321330718;500;16;16;124;137;362;1;137;0;3;134;0;0;0
321360719;200;18;18;80;98;100;2;98;0;5;93;0;0;0
