section_id;distributed_ballots;pre_registered_voters;registered_voters;onsite_listed_voters;voted_voters;unused_paper_ballots;destroyed_paper_ballots;urn_paper_ballots;invalid_paper_ballots;support_noone_paper_ballots;valid_paper_votes_for_parties;urn_machine_ballots;support_noone_machine_ballots;valid_machine_votes_for_parties
010100001;600;609;609;5;344;600;0;0;0;0;0;344;7;337
010100002;500;559;559;5;334;499;1;0;0;0;0;334;7;327
010100003;500;513;515;4;300;499;1;0;0;0;0;300;8;292
010100004;600;596;596;2;359;599;1;0;0;0;0;359;11;348
010100005;500;483;483;8;294;499;1;0;0;0;0;294;3;291
010100006;500;473;473;5;291;499;1;0;0;0;0;291;4;287
010100007;600;579;579;5;321;599;1;0;0;0;0;321;8;313
010100008;500;498;498;1;293;500;0;0;0;0;0;293;6;287
010100009;600;570;571;6;319;599;1;0;0;0;0;319;5;314
010100010;600;314;647;2;314;599;1;0;0;0;0;314;9;305
010100011;600;660;660;9;226;599;1;0;0;0;0;226;2;224
010100012;600;661;663;5;374;599;1;0;0;0;0;374;7;367
010100013;800;800;800;1;416;799;1;0;0;0;0;416;7;409
010100014;600;661;662;6;394;600;0;0;0;0;0;394;8;386
010100015;600;609;605;3;326;600;0;0;0;0;0;326;3;323
010100016;500;449;449;3;238;500;0;0;0;0;0;238;2;236
010100017;600;604;604;2;323;599;1;0;0;0;0;323;5;318
010100018;100;24;35;3;27;72;1;27;1;0;26;0;0;0
010100019;100;44;44;3;23;76;1;23;2;0;21;0;0;0
010100020;100;69;69;4;54;45;1;54;0;0;54;0;0;0
010100021;200;143;143;7;97;102;1;97;5;0;92;0;0;0
010100022;200;199;199;4;125;74;1;125;3;1;121;0;0;0
010100023;500;508;508;3;277;499;1;0;0;0;0;277;1;276
010200001;600;591;595;1;237;599;1;0;0;0;0;237;5;232
010200002;800;807;808;1;321;799;1;0;0;0;0;321;1;320
010200003;700;721;721;2;401;699;1;0;0;0;0;401;3;398
010200004;500;577;578;0;331;499;1;0;0;0;0;331;1;330
010200005;600;608;618;5;394;599;1;0;0;0;0;394;4;390
010200006;700;733;733;3;387;699;1;0;0;0;0;387;0;387
010200007;700;679;692;4;382;699;1;0;0;0;0;382;4;378
010200008;600;629;649;3;318;599;1;0;0;0;0;318;0;318
010200009;400;452;959;4;290;399;1;0;0;0;0;290;1;289
010200010;400;449;449;1;278;121;1;278;1;2;275;0;0;0
010200011;200;169;169;3;145;53;2;145;1;0;144;0;0;0
010200012;500;575;612;1;499;499;1;0;0;0;0;499;0;499
010200013;100;30;30;5;23;76;1;23;0;0;23;0;0;0
010200014;200;191;191;5;161;37;2;161;2;0;159;0;0;0
010200015;200;162;162;3;132;67;1;132;3;0;129;0;0;0
010200016;300;213;213;3;191;105;4;191;3;0;188;0;0;0
010200017;200;132;132;3;88;111;1;88;0;0;88;0;0;0
010200018;100;66;66;5;37;62;1;37;1;0;36;0;0;0
010200019;200;169;169;2;168;30;2;168;0;0;168;0;0;0
010300001;600;228;552;8;236;600;0;0;0;0;0;236;5;231
010300002;400;363;363;6;156;399;1;0;0;0;0;156;2;154
010300003;500;486;486;6;205;499;1;0;0;0;0;205;4;201
010300004;500;548;548;9;209;499;1;0;0;0;0;209;5;204
010300005;700;612;612;5;264;699;1;0;0;0;0;264;3;261
010300006;600;617;618;10;198;599;1;0;0;0;0;198;5;193
010300007;600;626;627;8;150;599;1;0;0;0;0;150;0;150
010300008;700;671;671;6;171;699;1;0;0;0;0;171;1;170
010300009;700;678;678;5;172;699;1;0;0;0;0;172;6;166
010300010;700;706;708;6;207;699;1;0;0;0;0;207;3;204
010300011;600;589;590;2;240;599;1;0;0;0;0;240;1;239
010300012;600;577;577;3;230;599;1;0;0;0;0;230;3;227
010300013;600;575;575;2;236;599;1;0;0;0;0;236;2;234
010300014;500;545;545;4;234;499;1;0;0;0;0;234;4;230
010300015;600;586;587;5;197;599;1;0;0;0;0;197;0;197
010300016;600;576;578;7;277;599;1;0;0;0;0;277;5;272
010300017;500;523;523;8;220;499;1;0;0;0;0;220;5;215
010300018;600;595;597;7;266;599;1;0;0;0;0;266;3;263
010300019;500;535;536;9;169;499;1;0;0;0;0;169;3;166
010300020;600;547;548;2;218;599;1;0;0;0;0;218;2;216
010300021;400;376;376;5;168;399;1;0;0;0;0;168;2;166
010300022;500;525;526;5;207;499;1;0;0;0;0;207;5;202
010300023;600;581;581;8;247;599;1;0;0;0;0;247;3;244
010300024;500;512;512;7;224;499;1;0;0;0;0;224;4;220
010300025;600;597;597;7;261;598;2;0;0;0;0;261;2;259
010300026;700;712;714;5;283;699;1;0;0;0;0;283;3;280
010300027;700;657;657;9;279;699;1;0;0;0;0;279;4;275
010300028;600;614;614;9;271;599;1;0;0;0;0;271;2;269
010300029;600;600;601;5;280;599;1;0;0;0;0;280;4;276
010300030;700;673;673;5;238;699;1;0;0;0;0;238;5;233
010300031;700;650;650;8;255;699;1;0;0;0;0;255;5;250
010300032;400;333;334;8;127;399;1;0;0;0;0;127;2;125
010300033;700;733;733;5;333;700;0;0;0;0;0;333;5;328
010300034;600;611;612;6;272;599;1;0;0;0;0;272;4;268
010300035;600;576;580;9;224;599;1;0;0;0;0;224;5;219
010300036;700;674;674;5;292;699;1;0;0;0;0;292;4;288
010300037;700;668;669;6;262;551;1;148;0;2;146;114;0;114
010300038;500;469;469;10;208;499;1;0;0;0;0;208;1;207
010300039;500;540;540;6;256;499;1;0;0;0;0;256;1;255
010300040;700;706;707;6;301;699;1;0;0;0;0;301;11;290
010300041;700;647;648;6;195;699;1;0;0;0;0;195;3;192
010300042;600;621;622;5;270;599;1;0;0;0;0;270;6;264
010300043;700;705;706;7;280;699;1;0;0;0;0;280;6;274
010300044;500;459;459;4;191;499;1;0;0;0;0;191;6;185
010300045;500;432;432;11;179;499;1;0;0;0;0;179;1;178
010300046;600;610;610;9;273;599;1;0;0;0;0;273;1;272
010300047;600;647;647;7;236;600;0;0;0;0;0;236;2;234
010300048;600;641;641;1;253;598;2;0;0;0;0;253;3;250
010300049;600;607;608;7;221;599;1;0;0;0;0;221;3;218
010300050;400;452;452;5;213;399;1;0;0;0;0;213;1;212
010300051;600;622;622;9;260;599;1;0;0;0;0;260;6;254
010300052;400;411;411;5;165;399;1;0;0;0;0;165;2;163
010300053;600;561;561;3;217;599;1;0;0;0;0;217;7;210
010300054;600;598;601;7;249;599;1;0;0;0;0;249;1;248
010300055;500;532;532;5;193;499;1;0;0;0;0;193;7;186
010300056;600;584;584;4;218;599;1;0;0;0;0;218;3;215
010300057;600;632;633;0;263;599;1;0;0;0;0;263;3;260
010300058;600;603;603;6;237;599;1;0;0;0;0;237;5;232
010300059;600;612;614;7;231;599;1;0;0;0;0;231;0;231
010300060;600;546;547;8;177;599;1;0;0;0;0;177;4;173
010300061;500;490;491;5;209;499;1;0;0;0;0;209;4;205
010300062;500;452;452;4;161;499;1;0;0;0;0;161;1;160
010300063;500;466;466;4;169;499;1;0;0;0;0;169;1;168
010300064;600;602;602;6;205;599;1;0;0;0;0;205;6;199
010300065;500;463;463;6;152;499;1;0;0;0;0;152;2;150
010300066;500;513;513;7;188;499;1;0;0;0;0;188;2;186
010300067;600;571;571;5;213;599;1;0;0;0;0;213;1;212
010300068;500;543;543;6;215;499;1;0;0;0;0;215;0;215
010300069;600;605;605;4;236;599;1;0;0;0;0;236;8;228
010300070;600;630;630;6;216;599;1;0;0;0;0;216;0;216
010300071;600;616;616;6;243;599;1;0;0;0;0;243;5;238
010300072;500;539;539;3;214;499;1;0;0;0;0;214;2;212
010300073;600;563;563;5;240;599;1;0;0;0;0;240;1;239
010300074;600;552;552;4;217;599;1;0;0;0;0;217;7;210
010300075;600;575;576;5;243;599;1;0;0;0;0;243;0;243
010300076;400;414;414;10;187;399;1;0;0;0;0;187;4;183
010300077;600;610;611;0;229;599;1;0;0;0;0;229;1;228
010300078;500;532;532;7;225;499;1;0;0;0;0;225;0;225
010300079;600;554;554;6;225;599;1;0;0;0;0;225;3;222
010300080;500;499;500;5;207;499;1;0;0;0;0;207;1;206
010300081;500;461;461;4;146;499;1;0;0;0;0;146;3;143
010300082;600;602;602;7;219;599;1;0;0;0;0;219;2;217
010300083;600;602;602;6;200;599;1;0;0;0;0;200;2;198
010300084;600;614;614;10;254;600;0;0;0;0;0;254;4;250
010300085;500;514;514;5;191;499;1;0;0;0;0;191;1;190
010300086;500;531;531;5;224;499;1;0;0;0;0;224;3;221
010300087;500;529;529;6;185;499;1;0;0;0;0;185;3;182
010300088;600;608;608;5;208;594;1;5;0;0;5;203;5;198
010300089;600;560;560;3;200;599;1;0;0;0;0;200;2;198
010300090;500;540;540;2;171;499;1;0;0;0;0;171;2;169
010300091;500;477;477;4;165;499;1;0;0;0;0;165;3;162
010300092;600;607;607;8;223;599;1;0;0;0;0;223;2;221
010300093;600;627;627;7;235;599;1;0;0;0;0;235;2;233
010300094;500;522;522;6;188;499;1;0;0;0;0;188;3;185
010300095;700;694;694;6;317;700;0;0;0;0;0;317;5;312
010300096;900;873;873;6;371;900;0;0;0;0;0;371;3;368
010300097;400;398;398;5;142;398;2;0;0;0;0;142;1;141
010300098;600;630;631;5;238;599;1;0;0;0;0;238;3;235
010300099;500;552;552;9;121;499;1;0;0;0;0;121;1;120
010300100;700;661;662;6;181;699;1;0;0;0;0;181;3;178
010300101;500;530;530;7;261;499;1;0;0;0;0;261;2;259
010300102;500;547;547;5;198;499;1;0;0;0;0;198;3;195
010300103;400;380;380;3;126;399;1;0;0;0;0;126;3;123
010300104;700;689;690;5;339;699;1;0;0;0;0;339;5;334
010300105;500;496;496;8;218;499;1;0;0;0;0;218;1;217
010300106;400;396;396;8;138;399;1;0;0;0;0;138;2;136
010300107;400;374;374;8;173;399;1;0;0;0;0;173;1;172
010300108;500;538;538;9;237;499;1;0;0;0;0;237;1;236
010300109;500;517;517;6;206;499;1;0;0;0;0;206;4;202
010300110;500;448;449;7;175;499;1;0;0;0;0;175;2;173
010300111;600;590;590;4;233;599;1;0;0;0;0;233;5;228
010300112;700;664;664;4;271;699;1;0;0;0;0;271;0;271
010300113;600;546;547;9;190;599;1;0;0;0;0;190;4;186
010300114;500;521;521;6;201;499;1;0;0;0;0;201;1;200
010300115;600;555;555;5;241;599;1;0;0;0;0;241;6;235
010300116;600;556;556;5;29;599;1;0;0;0;0;29;0;29
010300117;500;498;498;7;25;499;1;0;0;0;0;25;0;25
010300118;500;59;59;6;14;499;1;0;0;0;0;14;0;14
010300119;600;636;635;5;263;599;1;0;0;0;0;263;4;259
010300120;600;597;597;3;304;599;1;0;0;0;0;304;2;302
010300121;3000;2971;2971;6;276;3000;0;0;0;0;0;276;3;273
010300122;100;33;33;7;28;71;1;28;0;0;28;0;0;0
010300123;500;465;464;5;156;499;1;0;0;0;0;156;1;155
010300124;600;553;552;7;34;599;1;0;0;0;0;34;0;34
010300125;700;709;709;8;18;699;1;0;0;0;0;18;0;18
010300126;100;53;53;6;13;86;1;13;0;1;12;0;0;0
010300127;600;614;614;7;49;599;1;0;0;0;0;49;0;49
010300128;700;734;734;7;32;699;1;0;0;0;0;32;0;32
010300129;7092;7092;7092;4;210;7091;1;0;0;0;0;210;1;209
010300130;4500;3314;3315;7;277;4499;1;0;0;0;0;277;2;275
010300131;600;591;591;8;69;599;1;0;0;0;0;69;2;67
010300132;200;190;190;8;81;117;2;81;2;0;79;0;0;0
010300133;600;586;586;10;104;599;1;0;0;0;0;104;0;104
010300134;200;127;127;9;23;176;1;23;0;0;23;0;0;0
010300135;300;89;257;7;89;211;0;89;0;0;89;0;0;0
010300136;100;63;63;8;44;55;1;44;0;0;44;0;0;0
010300137;4500;4848;4844;5;104;4500;0;0;0;0;0;104;1;103
010300138;100;69;69;6;34;65;1;34;0;0;34;0;0;0
010300139;500;453;453;8;107;499;1;0;0;0;0;107;3;104
010300140;100;17;17;15;27;72;1;27;2;0;25;0;0;0
010300146;100;15;15;2;17;82;1;17;0;0;17;0;0;0
010300147;100;54;54;3;41;58;1;41;4;0;37;0;0;0
011100001;900;937;937;0;422;899;1;0;0;0;0;422;6;416
011100002;900;876;881;0;318;899;1;0;0;0;0;318;2;316
011100003;900;923;923;2;407;899;1;0;0;0;0;407;6;401
011100004;700;721;721;8;332;699;1;0;0;0;0;332;5;327
011100005;700;675;679;4;285;699;1;0;0;0;0;285;1;284
011100006;733;759;759;5;331;733;0;0;0;0;0;331;2;329
011100007;500;553;556;3;236;500;0;0;0;0;0;236;2;234
011100008;800;832;835;3;411;799;1;0;0;0;0;411;6;405
011100009;700;698;697;1;341;368;1;331;3;7;321;10;0;10
011100010;500;587;587;4;258;499;1;0;0;0;0;258;1;257
011100011;600;614;614;0;277;599;1;0;0;0;0;277;6;271
011100012;761;347;761;3;350;760;1;0;0;0;0;350;4;346
011100013;700;696;696;0;295;699;1;0;0;0;0;295;1;294
011100014;900;862;863;0;291;899;1;0;0;0;0;291;2;289
011100015;900;853;853;5;269;899;1;0;0;0;0;269;4;265
011100016;800;788;788;5;291;799;1;0;0;0;0;291;3;288
011100017;900;937;937;6;328;899;1;0;0;0;0;328;6;322
011100018;1000;979;979;3;259;999;1;0;0;0;0;259;6;253
011100019;1000;1085;1086;4;182;999;1;0;0;0;0;182;3;179
011100020;700;697;700;2;300;699;1;0;0;0;0;300;6;294
011100021;800;835;835;2;398;799;1;0;0;0;0;398;7;391
011100022;800;852;852;0;376;799;1;0;0;0;0;376;12;364
011100023;100;14;14;19;23;76;1;23;0;1;22;0;0;0
011100024;600;665;657;2;296;599;1;0;0;0;0;296;4;292
011100025;600;618;620;1;253;599;1;0;0;0;0;253;1;252
011100026;500;471;473;0;214;499;1;0;0;0;0;214;0;214
011100027;500;437;437;4;182;499;1;0;0;0;0;182;0;182
011100028;425;425;424;3;185;424;1;0;0;0;0;185;4;181
011100029;500;480;480;9;182;499;1;0;0;0;0;182;3;179
011100030;500;394;394;1;103;500;0;0;0;0;0;103;0;103
011100031;900;819;840;5;542;899;1;0;0;0;0;542;1;541
011100032;800;735;735;3;341;800;0;0;0;0;0;341;1;340
011100033;700;668;674;2;266;700;0;0;0;0;0;266;9;257
011100034;800;800;804;3;359;799;1;0;0;0;0;359;2;357
011100035;800;811;811;5;394;799;1;0;0;0;0;394;1;393
011100036;505;505;511;5;179;505;0;0;0;0;0;179;2;177
011100037;600;552;556;0;180;599;1;0;0;0;0;180;0;180
011100038;700;661;661;6;205;699;1;0;0;0;0;205;2;203
011100039;800;811;819;3;321;800;0;0;0;0;0;321;1;320
011100040;800;714;721;3;278;799;1;0;0;0;0;278;0;278
011100041;100;24;24;7;16;83;1;16;2;0;14;0;0;0
011100042;100;35;35;8;27;72;1;27;1;1;25;0;0;0
011100043;200;66;66;0;66;134;0;66;1;1;64;0;0;0
011100044;200;76;76;0;66;134;0;66;0;0;66;0;0;0
011300001;700;785;785;2;218;700;0;0;0;0;0;218;2;216
011300002;700;718;719;2;358;699;1;0;0;0;0;358;5;353
011300003;150;149;150;0;71;78;1;71;1;1;69;0;0;0
011300004;800;853;853;2;337;799;1;0;0;0;0;337;0;337
011300005;800;766;766;0;444;800;0;0;0;0;0;444;1;443
011300006;700;631;631;1;356;700;0;0;0;0;0;356;2;354
011300007;600;603;603;0;281;600;0;0;0;0;0;281;4;277
011300008;575;575;1011;2;229;575;0;0;0;0;0;229;1;228
011300009;500;436;436;2;202;297;1;202;0;4;198;0;0;0
011300010;800;955;955;2;351;799;1;0;0;0;0;351;1;350
011300011;800;855;855;3;346;799;1;0;0;0;0;346;3;343
011300012;50;28;47;3;31;17;2;31;0;1;30;0;0;0
011300013;200;104;209;4;108;92;0;108;3;1;104;0;0;0
011300014;200;130;129;1;80;119;1;80;2;3;75;0;0;0
011300015;700;661;661;1;239;700;0;0;0;0;0;239;2;237
011300016;800;720;720;1;281;799;1;0;0;0;0;281;0;281
011300017;200;186;186;4;109;90;1;109;4;0;105;0;0;0
011300018;500;449;449;3;245;500;0;0;0;0;0;245;1;244
011300019;900;896;896;6;496;900;0;0;0;0;0;496;3;493
011300020;800;780;730;5;409;800;0;0;0;0;0;409;1;408
011300021;700;674;674;10;350;700;0;0;0;0;0;350;1;349
011300022;300;229;229;2;148;151;1;148;1;1;146;0;0;0
011300023;1000;1075;1075;0;306;1000;0;0;0;0;0;306;0;306
012800001;550;598;598;3;298;549;1;0;0;0;0;298;3;295
012800002;550;601;601;1;252;549;1;0;0;0;0;252;2;250
012800003;500;527;537;1;306;499;1;0;0;0;0;306;5;301
012800004;600;596;606;2;365;599;1;0;0;0;0;365;4;361
012800005;600;601;610;0;290;599;1;0;0;0;0;290;5;285
012800006;400;411;414;3;190;399;1;0;0;0;0;190;0;190
012800007;500;514;522;3;275;499;1;0;0;0;0;275;1;274
012800008;500;480;482;2;198;499;1;0;0;0;0;198;0;198
012800009;100;68;68;3;49;49;2;49;1;1;47;0;0;0
012800010;100;76;76;3;60;39;1;60;2;0;58;0;0;0
012800011;100;59;59;0;55;44;1;55;0;0;55;0;0;0
013300001;900;884;885;6;358;899;1;0;0;0;0;358;4;354
013300002;900;851;851;7;327;900;0;0;0;0;0;327;2;325
013300003;900;928;928;3;303;900;0;0;0;0;0;303;3;300
013300004;900;903;903;7;294;899;1;0;0;0;0;294;2;292
013300005;951;951;951;1;305;950;1;0;0;0;0;305;9;296
013300006;900;898;898;1;341;899;1;0;0;0;0;341;8;333
013300007;900;896;897;4;337;899;1;0;0;0;0;337;1;336
013300008;900;918;918;0;349;899;1;0;0;0;0;349;6;343
013300009;900;917;917;0;373;900;0;0;0;0;0;373;5;368
013300010;900;986;986;5;310;900;0;0;0;0;0;310;7;303
013300011;900;996;996;2;306;899;1;0;0;0;0;306;1;305
013300012;1000;1009;1010;0;266;1000;0;0;0;0;0;266;4;262
013300013;900;883;883;3;326;899;1;0;0;0;0;326;5;321
013300014;900;895;895;1;292;898;2;0;0;0;0;292;0;292
013300015;900;935;935;0;207;900;0;0;0;0;0;207;3;204
013300016;900;897;898;5;361;900;0;0;0;0;0;361;7;354
013300017;900;885;885;0;304;900;0;0;0;0;0;304;5;299
013300018;900;975;975;3;280;899;1;0;0;0;0;280;2;278
013300019;900;966;967;7;195;899;1;0;0;0;0;195;0;195
013300020;1000;1054;1056;6;370;999;1;0;0;0;0;370;4;366
013300021;1000;997;997;4;266;999;1;0;0;0;0;266;6;260
013300022;1000;984;984;5;304;1000;0;0;0;0;0;304;2;302
013300023;900;809;809;0;335;899;1;0;0;0;0;335;2;333
013300024;812;812;812;5;308;811;1;0;0;0;0;308;0;308
013300025;900;932;933;6;309;900;0;0;0;0;0;309;4;305
013300026;900;959;959;5;349;899;1;0;0;0;0;349;1;348
013300027;900;976;976;1;263;899;1;0;0;0;0;263;2;261
013300028;900;944;944;1;343;899;1;0;0;0;0;343;5;338
013300029;821;821;821;6;290;821;0;0;0;0;0;290;9;281
013300030;900;889;889;1;41;899;1;0;0;0;0;41;0;41
013300031;800;746;746;6;59;799;1;0;0;0;0;59;0;59
013300032;800;829;831;3;93;799;1;0;0;0;0;93;0;93
013300033;900;927;929;1;226;899;1;0;0;0;0;226;2;224
013300034;900;890;890;3;317;899;1;0;0;0;0;317;0;317
013300035;900;942;942;3;265;899;1;0;0;0;0;265;1;264
013300036;800;789;789;2;243;799;1;0;0;0;0;243;3;240
013300037;500;443;440;3;243;499;1;0;0;0;0;243;7;236
013300038;600;607;607;4;280;600;0;0;0;0;0;280;0;280
013300039;400;348;348;0;122;399;1;0;0;0;0;122;1;121
013300040;200;219;219;6;95;104;1;95;2;2;91;0;0;0
013300041;500;494;494;2;219;499;1;0;0;0;0;219;2;217
013300042;500;550;550;4;279;499;1;0;0;0;0;279;0;279
013300043;100;109;109;5;71;22;7;71;3;1;67;0;0;0
013300044;200;136;136;2;68;131;1;68;1;0;67;0;0;0
013300045;200;123;123;4;62;136;2;62;1;0;61;0;0;0
013300046;500;565;565;4;268;500;0;0;0;0;0;268;1;267
013300047;600;660;660;4;342;599;1;0;0;0;0;342;3;339
013300048;100;77;77;4;56;43;1;56;2;0;54;0;0;0
013300049;300;270;270;4;130;168;2;130;1;2;127;0;0;0
013300050;200;103;176;5;107;92;1;107;3;0;104;0;0;0
013300051;800;839;841;0;363;799;1;0;0;0;0;363;2;361
013300052;600;614;614;1;254;599;1;0;0;0;0;254;1;253
013300053;500;436;436;4;188;499;1;0;0;0;0;188;5;183
013300054;400;399;399;1;165;399;1;0;0;0;0;165;0;165
013300055;500;463;463;3;189;499;1;0;0;0;0;189;0;189
013300056;500;454;456;2;175;499;1;0;0;0;0;175;0;175
013300057;500;453;453;3;150;499;1;0;0;0;0;150;0;150
013300058;100;116;116;3;49;50;1;49;0;0;49;0;0;0
013300059;600;625;625;7;290;599;1;0;0;0;0;290;4;286
013300060;600;613;613;5;268;600;0;0;0;0;0;268;0;268
013300061;600;579;580;0;261;600;0;0;0;0;0;261;2;259
013300062;600;576;576;0;230;600;0;0;0;0;0;230;0;230
013300063;600;586;586;0;229;600;0;0;0;0;0;229;0;229
013300064;704;704;704;5;215;704;0;0;0;0;0;215;1;214
013300065;500;554;554;7;208;500;0;0;0;0;0;208;1;207
013300066;300;339;339;4;140;300;0;0;0;0;0;140;0;140
013300067;200;127;127;5;66;131;3;66;2;0;64;0;0;0
013300068;100;87;87;4;46;52;2;46;1;0;45;0;0;0
013300069;100;41;41;6;28;71;1;28;0;0;28;0;0;0
013300070;200;86;144;6;86;106;8;86;6;0;80;0;0;0
013300071;200;208;208;4;105;90;5;105;4;1;100;0;0;0
013300072;100;56;56;5;34;66;0;34;1;0;33;0;0;0
013300073;100;41;41;4;22;77;1;22;2;0;20;0;0;0
013300074;100;34;34;4;15;84;1;15;1;1;13;0;0;0
013300075;500;322;323;1;126;500;0;0;0;0;0;126;1;125
013300076;100;94;89;5;26;73;1;26;0;0;26;0;0;0
013300077;100;81;81;4;57;42;1;57;1;0;56;0;0;0
013300078;200;43;43;7;30;169;1;30;2;0;28;0;0;0
013300079;100;99;101;9;72;27;1;72;2;0;70;0;0;0
013300080;100;89;89;4;35;62;3;35;2;0;33;0;0;0
013300081;500;507;508;1;251;500;0;0;0;0;0;251;2;249
013300082;500;484;484;1;248;500;0;0;0;0;0;248;3;245
013300083;600;605;605;3;228;600;0;0;0;0;0;228;5;223
013300084;500;548;548;1;279;500;0;0;0;0;0;279;4;275
013300085;500;552;552;0;196;500;0;0;0;0;0;196;1;195
013300086;700;748;748;2;328;700;0;0;0;0;0;328;2;326
013300087;300;268;268;3;173;126;1;173;0;1;172;0;0;0
013300088;900;844;845;3;302;899;1;0;0;0;0;302;0;302
013300089;800;837;837;1;299;799;1;0;0;0;0;299;3;296
013300090;700;733;733;1;199;700;0;0;0;0;0;199;2;197
013300091;500;482;482;1;165;500;0;0;0;0;0;165;0;165
013300092;800;814;814;1;213;800;0;0;0;0;0;213;1;212
013700001;700;673;673;2;368;699;1;0;0;0;0;368;4;364
013700002;600;597;599;4;314;599;1;0;0;0;0;314;3;311
013700003;700;697;700;2;402;699;1;0;0;0;0;402;4;398
013700004;700;730;730;3;442;699;1;0;0;0;0;442;3;439
013700005;600;642;642;1;342;599;1;0;0;0;0;342;1;341
013700006;700;664;664;3;396;699;1;0;0;0;0;396;3;393
013700007;600;568;568;3;340;599;1;0;0;0;0;340;2;338
013700008;700;721;721;5;389;700;0;0;0;0;0;389;6;383
013700009;700;707;708;1;399;698;2;0;0;0;0;399;7;392
013700010;800;753;753;4;352;799;1;0;0;0;0;352;2;350
013700011;600;546;547;2;293;599;1;0;0;0;0;293;5;288
013700012;700;666;666;4;388;699;1;0;0;0;0;388;4;384
013700013;500;509;508;1;271;499;1;0;0;0;0;271;1;270
013700014;600;603;603;2;347;599;1;0;0;0;0;347;2;345
013700015;800;759;761;3;230;799;1;0;0;0;0;230;1;229
013700016;700;673;673;0;232;700;0;0;0;0;0;232;2;230
013700017;700;657;657;1;316;699;1;0;0;0;0;316;3;313
013700018;700;665;666;1;314;699;1;0;0;0;0;314;5;309
013700019;400;429;429;1;242;399;1;0;0;0;0;242;0;242
013700020;800;790;792;2;396;799;1;0;0;0;0;396;1;395
013700021;800;746;748;1;413;799;1;0;0;0;0;413;3;410
013700022;800;772;775;1;303;799;1;0;0;0;0;303;4;299
013700023;500;485;516;4;261;499;1;0;0;0;0;261;3;258
013700024;800;767;767;2;384;799;1;0;0;0;0;384;1;383
013700025;500;487;487;2;260;499;1;0;0;0;0;260;1;259
013700026;600;615;615;1;345;599;1;0;0;0;0;345;3;342
013700027;500;517;517;3;241;499;1;0;0;0;0;241;2;239
013700028;100;38;38;0;37;62;1;37;2;1;34;0;0;0
013700029;100;14;14;17;19;80;1;19;2;0;17;0;0;0
014000001;700;775;776;7;329;699;1;0;0;0;0;329;5;324
014000002;800;766;766;6;304;800;0;0;0;0;0;304;4;300
014000003;800;823;824;7;352;800;0;0;0;0;0;352;2;350
014000004;800;890;891;5;386;799;1;0;0;0;0;386;3;383
014000005;800;793;793;5;366;800;0;0;0;0;0;366;6;360
014000006;800;865;866;3;345;800;0;0;0;0;0;345;3;342
014000007;800;378;820;4;378;799;1;0;0;0;0;378;2;376
014000008;700;288;703;6;294;699;1;0;0;0;0;294;0;294
014000009;500;456;456;6;200;500;0;0;0;0;0;200;3;197
014000010;500;490;490;5;193;499;1;0;0;0;0;193;5;188
014000011;800;792;792;0;346;799;1;0;0;0;0;346;4;342
014000012;700;746;746;5;333;700;0;0;0;0;0;333;2;331
014000013;800;867;869;1;414;799;1;0;0;0;0;414;8;406
014000014;800;841;841;4;361;799;1;0;0;0;0;361;2;359
014000015;700;688;689;4;295;699;1;0;0;0;0;295;2;293
014000016;800;801;801;2;327;799;1;0;0;0;0;327;2;325
014000017;800;770;770;11;353;799;1;0;0;0;0;353;2;351
014000018;800;893;894;6;414;800;0;0;0;0;0;414;6;408
014000019;800;833;834;8;384;800;0;0;0;0;0;384;6;378
014000020;800;800;802;0;349;799;1;0;0;0;0;349;3;346
014000021;700;707;707;6;326;699;1;0;0;0;0;326;2;324
014000022;500;524;524;7;265;499;1;0;0;0;0;265;2;263
014000023;700;725;725;9;293;699;1;0;0;0;0;293;2;291
014000024;600;618;618;8;242;600;0;0;0;0;0;242;1;241
014000025;800;871;871;7;329;799;1;0;0;0;0;329;2;327
014000026;800;835;835;5;277;799;1;0;0;0;0;277;4;273
014000027;800;922;922;3;439;799;1;0;0;0;0;439;6;433
014000028;800;939;939;5;255;799;1;0;0;0;0;255;2;253
014000029;944;944;945;9;275;943;1;0;0;0;0;275;0;275
014000030;800;945;945;7;169;798;2;0;0;0;0;169;1;168
014000031;800;947;947;0;166;799;1;0;0;0;0;166;2;164
014000032;500;559;559;4;329;500;0;0;0;0;0;329;1;328
014000033;400;324;324;3;155;399;1;0;0;0;0;155;1;154
014000034;500;509;509;1;244;251;5;244;5;0;239;0;0;0
014000035;400;330;330;3;174;400;0;0;0;0;0;174;0;174
014000036;300;232;232;5;118;181;1;118;3;2;113;0;0;0
014000037;100;44;44;7;25;74;1;25;1;0;24;0;0;0
014000038;600;270;573;1;271;599;1;0;0;0;0;271;3;268
014000039;500;212;449;3;215;500;0;0;0;0;0;215;0;215
014000040;600;592;594;6;190;600;0;0;0;0;0;190;1;189
014000041;700;638;638;4;315;699;1;0;0;0;0;315;4;311
014000042;500;149;439;0;149;499;1;0;0;0;0;149;1;148
014000043;600;198;560;2;200;599;1;0;0;0;0;200;0;200
014000044;500;502;504;3;272;499;1;0;0;0;0;272;2;270
014000045;400;409;409;1;202;399;1;0;0;0;0;202;1;201
014000046;700;640;640;5;251;699;1;0;0;0;0;251;0;251
014000047;500;511;511;3;262;500;0;0;0;0;0;262;1;261
014000048;200;159;159;7;89;110;1;89;0;1;88;0;0;0
014000049;100;25;25;5;22;74;4;22;3;0;19;0;0;0
014000050;100;81;81;6;52;47;1;52;1;0;51;0;0;0
014000051;100;84;84;7;59;40;1;59;0;2;57;0;0;0
014000052;100;57;57;7;37;62;1;37;3;0;34;0;0;0
014000053;100;71;71;8;36;63;1;36;1;0;35;0;0;0
014000054;100;50;50;6;42;51;7;42;6;0;36;0;0;0
014000055;200;162;162;5;80;119;1;80;2;0;78;0;0;0
014000056;600;584;584;4;277;599;1;0;0;0;0;277;0;277
014000057;200;174;174;6;128;71;1;128;2;2;124;0;0;0
014000058;100;31;31;8;28;71;1;28;2;0;26;0;0;0
014000059;100;21;21;6;22;77;1;22;0;0;22;0;0;0
014000060;100;31;31;6;29;70;1;29;0;0;29;0;0;0
014000061;100;21;21;6;19;80;1;19;1;0;18;0;0;0
014000062;100;18;18;7;21;78;1;21;1;0;20;0;0;0
014000063;600;614;615;5;281;599;1;0;0;0;0;281;4;277
014000064;500;489;489;3;251;499;1;0;0;0;0;251;0;251
014000065;200;105;105;4;62;137;1;62;3;0;59;0;0;0
014000066;500;403;403;1;181;499;1;0;0;0;0;181;1;180
014000067;100;23;23;7;19;80;1;19;0;0;19;0;0;0
014000068;200;169;169;6;114;85;1;114;3;0;111;0;0;0
014000069;100;58;58;7;32;67;1;32;1;0;31;0;0;0
014000070;146;146;146;6;68;77;1;68;5;0;63;0;0;0
014000071;100;46;46;8;36;63;1;36;1;0;35;0;0;0
014000072;100;86;86;6;52;47;1;52;0;0;52;0;0;0
014000073;100;44;44;9;29;67;4;29;2;0;27;0;0;0
014000074;100;24;24;6;14;85;1;14;0;2;12;0;0;0
014200001;300;375;376;0;145;300;0;0;0;0;0;145;0;145
014200002;500;517;526;3;215;499;1;0;0;0;0;215;1;214
014200003;500;488;509;7;209;499;1;0;0;0;0;209;2;207
014200004;700;722;737;1;263;699;1;0;0;0;0;263;2;261
014200005;700;720;750;5;292;699;1;0;0;0;0;292;0;292
014200006;700;730;739;3;272;699;1;0;0;0;0;272;2;270
014200007;700;744;776;4;287;700;0;0;0;0;0;287;1;286
014200008;300;314;314;3;160;299;1;0;0;0;0;160;3;157
014200009;300;295;300;0;154;300;0;0;0;0;0;154;2;152
014200010;800;877;877;0;310;799;1;0;0;0;0;310;1;309
014200011;800;816;830;1;278;799;1;0;0;0;0;278;2;276
014200012;900;962;975;2;382;899;1;0;0;0;0;382;7;375
014200013;300;331;331;0;210;300;0;0;0;0;0;210;0;210
014200014;500;487;498;0;205;500;0;0;0;0;0;205;1;204
014200015;1000;825;825;0;413;1000;0;0;0;0;0;413;2;411
014200016;700;396;747;4;400;700;0;0;0;0;0;400;1;399
014200017;900;978;984;2;444;899;1;0;0;0;0;444;4;440
014200018;900;943;948;1;454;899;1;0;0;0;0;454;2;452
014200019;906;906;906;4;279;906;0;0;0;0;0;279;1;278
014200020;900;920;920;2;281;900;0;0;0;0;0;281;1;280
014200021;700;726;727;1;247;699;1;0;0;0;0;247;0;247
014200022;400;391;391;2;203;399;1;0;0;0;0;203;0;203
014200023;100;51;51;0;50;50;0;50;0;0;50;0;0;0
014200024;100;78;78;0;76;24;0;76;0;0;76;0;0;0
014200025;100;33;33;0;31;69;0;31;0;0;31;0;0;0
014200026;100;42;42;0;42;58;0;42;0;0;42;0;0;0
014400001;600;322;628;2;324;599;1;0;0;0;0;324;1;323
014400002;700;727;731;2;391;699;1;0;0;0;0;391;5;386
014400003;500;552;553;4;382;499;1;0;0;0;0;382;1;381
014400004;800;847;849;6;352;799;1;0;0;0;0;352;5;347
014400005;700;748;748;4;464;699;1;0;0;0;0;464;3;461
014400006;600;635;635;4;364;599;1;0;0;0;0;364;5;359
014400007;600;695;695;1;352;599;1;0;0;0;0;352;3;349
014400008;600;631;631;5;367;599;1;0;0;0;0;367;7;360
014400009;500;562;562;1;333;499;1;0;0;0;0;333;3;330
014400010;300;306;308;0;149;299;1;0;0;0;0;149;1;148
014400011;300;351;352;2;214;299;1;0;0;0;0;214;1;213
014400012;800;831;832;2;475;799;1;0;0;0;0;475;0;475
014400013;400;404;404;0;216;399;1;0;0;0;0;216;1;215
014400014;200;145;145;3;99;99;2;99;1;1;97;0;0;0
014400015;300;258;264;2;172;125;3;172;6;0;166;0;0;0
014400016;100;35;35;4;26;73;1;26;0;1;25;0;0;0
014400017;700;675;675;3;378;699;1;0;0;0;0;378;2;376
014400018;600;645;651;1;325;599;1;0;0;0;0;325;2;323
014400019;500;295;501;1;296;499;1;0;0;0;0;296;5;291
014400020;100;24;24;3;19;80;1;19;0;0;19;0;0;0
014400021;600;612;616;1;461;599;1;0;0;0;0;461;2;459
014400022;500;558;559;1;313;499;1;0;0;0;0;313;4;309
014400023;100;92;92;3;69;30;1;69;0;0;69;0;0;0
014400024;100;26;26;0;12;87;1;12;0;0;12;0;0;0
014400025;500;319;508;3;322;499;1;0;0;0;0;322;3;319
014400026;400;392;392;1;225;399;1;0;0;0;0;225;2;223
014400027;100;46;46;1;44;55;1;44;0;0;44;0;0;0
014400028;100;37;37;0;37;62;1;37;0;0;37;0;0;0
014900001;400;355;355;2;143;399;1;0;0;0;0;143;0;143
014900002;400;368;369;0;171;399;1;0;0;0;0;171;1;170
014900003;400;392;392;0;154;399;1;0;0;0;0;154;4;150
014900004;400;333;333;3;140;399;1;0;0;0;0;140;1;139
014900005;500;499;499;0;83;499;1;0;0;0;0;83;0;83
014900006;500;506;507;3;112;499;1;0;0;0;0;112;0;112
014900007;300;309;309;1;114;299;1;0;0;0;0;114;1;113
014900008;300;339;339;0;135;299;1;0;0;0;0;135;0;135
014900009;100;35;35;4;33;66;1;33;1;0;32;0;0;0
014900010;100;107;107;5;51;48;1;51;2;0;49;0;0;0
014900011;200;154;154;2;72;127;1;72;2;0;70;0;0;0
014900012;100;66;66;5;28;71;1;28;0;0;28;0;0;0
014900013;300;273;273;3;121;177;2;121;5;1;115;0;0;0
014900014;100;69;69;4;25;74;1;25;2;0;23;0;0;0
014900015;100;132;132;6;72;26;2;72;4;0;68;0;0;0
014900016;100;130;132;4;33;65;2;33;2;0;31;0;0;0
014900017;200;157;157;4;40;159;1;40;0;0;40;0;0;0
015200001;500;748;748;0;365;499;1;0;0;0;0;365;7;358
015200002;500;753;753;2;373;499;1;0;0;0;0;373;2;371
015200003;500;819;819;2;387;499;1;0;0;0;0;387;4;383
015200004;500;670;670;0;166;499;1;0;0;0;0;166;0;166
015200005;100;140;140;0;93;6;1;93;1;2;90;0;0;0
015200006;300;383;383;2;135;300;0;0;0;0;0;135;1;134
015200007;500;621;621;4;112;500;0;0;0;0;0;112;0;112
015200008;300;329;329;4;157;299;1;0;0;0;0;157;3;154
015200009;100;47;47;4;36;63;1;36;0;0;36;0;0;0
015200010;100;57;57;5;40;59;1;40;0;0;40;0;0;0
015200011;500;638;638;2;289;499;1;0;0;0;0;289;3;286
015200012;400;471;471;3;184;399;1;0;0;0;0;184;2;182
015200013;700;854;854;0;350;699;1;0;0;0;0;350;3;347
015200014;500;749;749;2;315;499;1;0;0;0;0;315;0;315
015200015;500;704;704;0;289;499;1;0;0;0;0;289;2;287
015200016;100;69;69;5;37;62;1;37;2;0;35;0;0;0
015200017;100;35;35;6;23;76;1;23;0;0;23;0;0;0
015200018;100;134;134;4;77;22;1;77;5;0;72;0;0;0
015200019;200;454;354;0;190;199;1;0;0;0;0;190;3;187
015300001;200;702;707;2;256;199;1;0;0;0;0;256;0;256
015300002;200;473;476;2;210;199;1;0;0;0;0;210;1;209
015300003;200;621;639;5;300;199;1;0;0;0;0;300;2;298
015300004;200;826;838;6;370;199;1;0;0;0;0;370;2;368
015300005;200;646;661;2;350;199;1;0;0;0;0;350;6;344
015300006;200;667;681;1;348;199;1;0;0;0;0;348;3;345
015300007;200;672;689;1;321;199;1;0;0;0;0;321;1;320
015300008;200;573;587;5;218;199;1;0;0;0;0;218;2;216
015300009;200;457;457;5;201;199;1;0;0;0;0;201;2;199
015300010;200;452;452;4;236;199;1;0;0;0;0;236;0;236
015300011;200;200;799;4;139;199;1;0;0;0;0;139;0;139
015300012;400;155;155;3;155;244;1;155;11;1;143;0;0;0
015300013;100;364;375;6;220;99;1;0;0;0;0;220;0;220
015300014;100;345;345;1;195;99;1;0;0;0;0;195;0;195
015300015;200;475;938;4;195;199;1;0;0;0;0;195;2;193
015300016;400;449;449;5;192;206;2;192;1;4;187;0;0;0
015300017;200;130;130;0;118;82;0;118;0;0;118;0;0;0
020100001;800;799;799;0;282;799;1;0;0;0;0;282;4;278
020100002;600;617;617;3;148;599;1;0;0;0;0;148;0;148
020100003;800;895;896;6;244;799;1;0;0;0;0;244;1;243
020100004;400;388;388;6;169;399;1;0;0;0;0;169;0;169
020100005;500;464;464;0;189;499;1;0;0;0;0;189;1;188
020100006;600;624;624;1;260;599;1;0;0;0;0;260;0;260
020100007;400;417;417;0;203;399;1;0;0;0;0;203;3;200
020100008;500;496;497;0;217;499;1;0;0;0;0;217;4;213
020100009;800;792;792;3;356;799;1;0;0;0;0;356;5;351
020100010;500;513;514;2;230;499;1;0;0;0;0;230;4;226
020100011;400;436;436;0;217;399;1;0;0;0;0;217;2;215
020100012;600;603;603;3;238;599;1;0;0;0;0;238;2;236
020100013;600;624;624;6;250;599;1;0;0;0;0;250;2;248
020100014;500;485;486;3;191;499;1;0;0;0;0;191;2;189
020100015;400;402;403;6;164;399;1;0;0;0;0;164;1;163
020100016;700;690;690;6;231;699;1;0;0;0;0;231;1;230
020100017;600;632;632;3;187;599;1;0;0;0;0;187;0;187
020100018;700;723;725;0;251;699;1;0;0;0;0;251;2;249
020100019;500;497;497;3;168;499;1;0;0;0;0;168;0;168
020100020;800;815;815;7;161;799;1;0;0;0;0;161;1;160
020100021;800;795;795;1;118;799;1;0;0;0;0;118;0;118
020100022;500;563;565;5;126;499;1;0;0;0;0;126;0;126
020100023;600;615;615;0;247;599;1;0;0;0;0;247;1;246
020100024;800;774;775;0;288;799;1;0;0;0;0;288;3;285
020100025;600;683;683;3;82;599;1;0;0;0;0;82;0;82
020100026;600;636;636;5;16;599;1;0;0;0;0;16;0;16
020100027;600;593;593;0;215;599;1;0;0;0;0;215;2;213
020100028;700;742;742;3;242;699;1;0;0;0;0;242;4;238
020100029;800;836;836;1;27;799;1;0;0;0;0;27;1;26
020100030;700;789;789;8;44;699;1;0;0;0;0;44;0;44
020100031;100;120;120;6;90;5;5;90;4;1;85;0;0;0
020100032;300;229;229;7;131;168;1;131;2;1;128;0;0;0
020100033;500;489;489;7;246;499;1;0;0;0;0;246;0;246
020100034;600;722;723;8;171;599;1;0;0;0;0;171;0;171
020100035;300;347;347;7;230;64;6;230;5;0;225;0;0;0
020100036;600;650;1210;7;176;599;1;0;0;0;0;176;0;176
020100037;200;168;168;6;84;115;1;84;4;1;79;0;0;0
020100038;700;735;735;8;341;699;1;0;0;0;0;341;0;341
020100039;400;379;379;4;197;399;1;0;0;0;0;197;1;196
020100040;500;519;520;4;216;499;1;0;0;0;0;216;0;216
020100041;700;666;1377;4;240;700;0;0;0;0;0;240;1;239
020100042;400;400;400;7;229;399;1;0;0;0;0;229;2;227
020100043;500;525;526;6;154;499;1;0;0;0;0;154;4;150
020100044;500;268;534;6;274;499;1;0;0;0;0;274;1;273
020100045;200;128;128;7;80;119;1;80;2;1;77;0;0;0
020100046;400;420;845;3;205;399;1;0;0;0;0;205;1;204
020100047;100;15;14;8;21;77;2;21;1;0;20;0;0;0
020100048;700;711;711;5;294;405;1;294;5;0;289;0;0;0
020100049;600;560;560;4;147;452;1;147;2;1;144;0;0;0
020100050;400;425;425;4;218;181;1;218;7;0;211;0;0;0
020400001;500;589;589;4;278;499;1;0;0;0;0;278;2;276
020400002;500;557;557;6;296;499;1;0;0;0;0;296;2;294
020400003;500;584;584;22;301;499;1;0;0;0;0;301;4;297
020400004;500;513;514;4;217;500;0;0;0;0;0;217;3;214
020400005;600;598;599;5;283;599;1;0;0;0;0;283;2;281
020400006;500;551;551;3;254;499;1;0;0;0;0;254;5;249
020400007;500;583;584;3;287;500;0;0;0;0;0;287;8;279
020400008;500;558;559;7;257;500;0;0;0;0;0;257;4;253
020400009;600;642;642;8;319;599;1;0;0;0;0;319;6;313
020400010;600;593;593;5;281;599;1;0;0;0;0;281;5;276
020400011;600;606;606;6;277;599;1;0;0;0;0;277;6;271
020400012;560;560;560;3;261;559;1;0;0;0;0;261;5;256
020400013;600;583;583;2;256;599;1;0;0;0;0;256;7;249
020400014;600;585;587;8;242;599;1;0;0;0;0;242;5;237
020400015;600;630;630;9;309;599;1;0;0;0;0;309;5;304
020400016;600;571;571;7;253;599;1;0;0;0;0;253;4;249
020400017;600;606;606;11;312;599;1;0;0;0;0;312;6;306
020400018;500;548;548;8;254;500;0;0;0;0;0;254;9;245
020400019;500;579;580;8;270;499;1;0;0;0;0;270;9;261
020400020;400;447;447;7;218;399;1;0;0;0;0;218;6;212
020400021;600;580;580;12;335;599;1;0;0;0;0;335;4;331
020400022;500;247;494;7;247;499;1;0;0;0;0;247;4;243
020400023;500;464;463;9;241;499;1;0;0;0;0;241;4;237
020400024;500;516;516;5;253;499;1;0;0;0;0;253;1;252
020400025;400;425;425;7;227;399;1;0;0;0;0;227;1;226
020400026;500;499;499;9;227;499;1;0;0;0;0;227;2;225
020400027;400;406;407;6;197;399;1;0;0;0;0;197;3;194
020400028;500;530;530;0;267;499;1;0;0;0;0;267;7;260
020400029;500;556;556;1;272;499;1;0;0;0;0;272;2;270
020400030;500;549;551;5;261;499;1;0;0;0;0;261;2;259
020400031;600;603;603;9;309;599;1;0;0;0;0;309;8;301
020400032;600;589;590;4;299;600;0;0;0;0;0;299;1;298
020400033;400;377;377;4;184;399;1;0;0;0;0;184;3;181
020400034;500;508;508;7;237;499;1;0;0;0;0;237;3;234
020400035;400;447;447;6;212;399;1;0;0;0;0;212;3;209
020400036;400;481;484;22;243;400;0;0;0;0;0;243;5;238
020400037;500;528;528;7;263;499;1;0;0;0;0;263;2;261
020400038;600;570;570;8;294;599;1;0;0;0;0;294;2;292
020400039;500;511;511;6;243;499;1;0;0;0;0;243;9;234
020400040;400;392;392;6;204;399;1;0;0;0;0;204;4;200
020400041;400;472;473;2;226;399;1;0;0;0;0;226;1;225
020400042;600;574;574;8;267;599;1;0;0;0;0;267;4;263
020400043;500;515;517;10;246;500;0;0;0;0;0;246;6;240
020400044;500;499;501;6;260;499;1;0;0;0;0;260;4;256
020400045;500;498;498;8;216;500;0;0;0;0;0;216;1;215
020400046;500;529;529;7;282;500;0;0;0;0;0;282;6;276
020400047;500;550;551;9;274;499;1;0;0;0;0;274;1;273
020400048;600;579;579;16;278;599;1;0;0;0;0;278;2;276
020400049;600;562;562;7;281;599;1;0;0;0;0;281;2;279
020400050;600;596;596;5;300;599;1;0;0;0;0;300;1;299
020400051;602;633;633;9;305;480;3;119;2;5;112;186;0;186
020400052;600;601;601;9;277;599;1;0;0;0;0;277;5;272
020400053;600;622;623;8;333;599;1;0;0;0;0;333;1;332
020400054;500;550;550;5;282;499;1;0;0;0;0;282;4;278
020400055;600;616;616;7;292;599;1;0;0;0;0;292;9;283
020400056;600;588;590;5;274;599;1;0;0;0;0;274;5;269
020400057;500;575;576;8;258;499;1;0;0;0;0;258;3;255
020400058;500;551;551;6;258;499;1;0;0;0;0;258;2;256
020400059;500;538;539;18;257;499;1;0;0;0;0;257;7;250
020400060;600;569;570;4;258;599;1;0;0;0;0;258;1;257
020400061;600;627;627;6;338;599;1;0;0;0;0;338;4;334
020400062;600;598;600;4;298;599;1;0;0;0;0;298;8;290
020400063;600;581;581;9;272;599;1;0;0;0;0;272;2;270
020400064;500;516;516;7;259;499;1;0;0;0;0;259;5;254
020400065;600;560;560;6;256;599;1;0;0;0;0;256;5;251
020400066;600;560;561;7;272;599;1;0;0;0;0;272;5;267
020400067;500;492;494;2;233;499;1;0;0;0;0;233;7;226
020400068;379;379;379;3;181;378;1;0;0;0;0;181;0;181
020400069;500;446;447;7;227;499;1;0;0;0;0;227;5;222
020400070;500;472;472;2;212;499;1;0;0;0;0;212;3;209
020400071;500;543;543;8;258;499;1;0;0;0;0;258;4;254
020400072;400;373;373;1;202;399;1;0;0;0;0;202;6;196
020400073;400;363;364;2;204;399;1;0;0;0;0;204;4;200
020400074;400;388;388;7;107;399;1;0;0;0;0;107;2;105
020400075;400;350;350;8;108;399;1;0;0;0;0;108;5;103
020400076;700;671;671;5;83;699;1;0;0;0;0;83;0;83
020400077;600;625;625;5;120;600;0;0;0;0;0;120;0;120
020400078;700;689;689;8;90;628;1;71;10;1;60;19;0;19
020400079;600;623;623;8;105;599;1;0;0;0;0;105;2;103
020400080;600;625;625;7;78;599;1;0;0;0;0;78;0;78
020400081;600;569;569;8;77;599;1;0;0;0;0;77;0;77
020400082;600;584;583;6;91;600;0;0;0;0;0;91;0;91
020400083;500;529;526;10;68;500;0;0;0;0;0;68;0;68
020400084;400;430;432;5;177;399;1;0;0;0;0;177;0;177
020400085;400;385;385;6;167;399;1;0;0;0;0;167;3;164
020400086;800;787;787;11;293;799;1;0;0;0;0;293;6;287
020400087;200;157;157;5;76;123;1;76;0;0;76;0;0;0
020400088;600;577;575;9;220;599;1;0;0;0;0;220;1;219
020400089;600;563;564;0;145;599;1;0;0;0;0;145;3;142
020400090;600;606;607;8;85;599;1;0;0;0;0;85;2;83
020400091;500;511;511;6;169;499;1;0;0;0;0;169;2;167
020400092;500;536;536;4;233;499;1;0;0;0;0;233;7;226
020400093;600;609;609;4;203;599;1;0;0;0;0;203;4;199
020400094;500;557;558;5;188;499;1;0;0;0;0;188;5;183
020400095;600;582;583;3;237;599;1;0;0;0;0;237;7;230
020400096;500;522;522;10;167;499;1;0;0;0;0;167;3;164
020400097;600;586;586;5;238;599;1;0;0;0;0;238;5;233
020400098;600;645;645;6;252;599;1;0;0;0;0;252;4;248
020400099;500;508;508;6;205;499;1;0;0;0;0;205;4;201
020400100;500;526;526;4;181;499;1;0;0;0;0;181;2;179
020400101;600;587;587;5;209;599;1;0;0;0;0;209;1;208
020400102;600;582;582;2;211;599;1;0;0;0;0;211;6;205
020400103;500;542;542;7;236;499;1;0;0;0;0;236;3;233
020400104;500;460;460;4;163;499;1;0;0;0;0;163;2;161
020400105;500;181;475;7;188;499;1;0;0;0;0;188;1;187
020400106;600;588;587;6;202;599;1;0;0;0;0;202;5;197
020400107;600;567;567;4;206;599;1;0;0;0;0;206;2;204
020400108;600;626;626;5;207;599;1;0;0;0;0;207;1;206
020400109;600;581;581;9;221;599;1;0;0;0;0;221;4;217
020400110;500;475;475;6;194;499;1;0;0;0;0;194;2;192
020400111;500;484;484;6;205;499;1;0;0;0;0;205;2;203
020400112;500;559;556;7;220;499;1;0;0;0;0;220;3;217
020400113;500;459;459;2;219;499;1;0;0;0;0;219;4;215
020400114;500;482;484;9;210;499;1;0;0;0;0;210;1;209
020400115;600;601;601;4;224;599;1;0;0;0;0;224;3;221
020400116;500;544;544;4;189;499;1;0;0;0;0;189;2;187
020400117;500;500;499;5;207;499;1;0;0;0;0;207;9;198
020400118;500;516;518;6;206;499;1;0;0;0;0;206;2;204
020400119;600;213;551;7;220;599;1;0;0;0;0;220;4;216
020400120;600;553;555;1;221;599;1;0;0;0;0;221;3;218
020400121;500;486;487;4;220;499;1;0;0;0;0;220;9;211
020400122;600;596;596;9;239;599;1;0;0;0;0;239;10;229
020400123;600;559;559;3;221;600;0;0;0;0;0;221;1;220
020400124;500;510;510;7;224;499;1;0;0;0;0;224;3;221
020400125;500;553;553;7;254;499;1;0;0;0;0;254;4;250
020400126;500;527;529;9;233;499;1;0;0;0;0;233;6;227
020400127;500;533;533;10;229;499;1;0;0;0;0;229;5;224
020400128;500;513;513;3;221;499;1;0;0;0;0;221;2;219
020400129;600;597;597;9;226;599;1;0;0;0;0;226;4;222
020400130;600;571;571;6;257;599;1;0;0;0;0;257;5;252
020400131;600;621;621;1;257;599;1;0;0;0;0;257;6;251
020400132;600;617;619;3;251;599;1;0;0;0;0;251;2;249
020400133;700;661;661;5;269;699;1;0;0;0;0;269;5;264
020400134;600;610;611;2;255;599;1;0;0;0;0;255;4;251
020400135;600;638;638;5;301;599;1;0;0;0;0;301;2;299
020400136;600;603;603;3;214;599;1;0;0;0;0;214;3;211
020400137;600;583;583;7;213;599;1;0;0;0;0;213;2;211
020400138;600;592;593;9;187;599;1;0;0;0;0;187;0;187
020400139;700;686;686;5;214;699;1;0;0;0;0;214;2;212
020400140;600;633;631;3;213;599;1;0;0;0;0;213;2;211
020400141;600;637;637;5;226;599;1;0;0;0;0;226;3;223
020400142;600;559;559;5;190;599;1;0;0;0;0;190;3;187
020400143;600;613;613;7;187;599;1;0;0;0;0;187;5;182
020400144;615;616;616;7;238;614;1;0;0;0;0;238;4;234
020400145;600;564;564;4;201;599;1;0;0;0;0;201;1;200
020400146;800;773;773;9;292;799;1;0;0;0;0;292;3;289
020400147;600;602;602;4;205;599;1;0;0;0;0;205;1;204
020400148;600;597;597;5;95;599;1;0;0;0;0;95;2;93
020400149;600;615;616;4;129;599;1;0;0;0;0;129;0;129
020400150;600;570;570;8;127;599;1;0;0;0;0;127;1;126
020400151;500;555;556;8;253;499;1;0;0;0;0;253;4;249
020400152;600;581;583;6;247;599;1;0;0;0;0;247;2;245
020400153;500;516;516;3;214;499;1;0;0;0;0;214;5;209
020400154;500;542;546;7;247;499;1;0;0;0;0;247;4;243
020400155;600;574;575;6;246;599;1;0;0;0;0;246;8;238
020400156;600;571;568;9;263;599;1;0;0;0;0;263;6;257
020400157;600;585;584;5;230;599;1;0;0;0;0;230;6;224
020400158;600;600;614;6;253;599;1;0;0;0;0;253;2;251
020400159;500;552;553;6;272;499;1;0;0;0;0;272;3;269
020400160;600;624;625;7;265;599;1;0;0;0;0;265;5;260
020400161;600;596;596;3;233;599;1;0;0;0;0;233;3;230
020400162;600;566;566;7;259;599;1;0;0;0;0;259;3;256
020400163;600;590;590;6;278;599;1;0;0;0;0;278;12;266
020400164;500;483;484;9;258;499;1;0;0;0;0;258;5;253
020400165;600;554;554;8;261;599;1;0;0;0;0;261;3;258
020400166;600;578;578;20;283;599;1;0;0;0;0;283;3;280
020400167;600;590;589;8;278;599;1;0;0;0;0;278;5;273
020400168;500;519;521;7;202;499;1;0;0;0;0;202;3;199
020400169;500;499;500;10;228;499;1;0;0;0;0;228;5;223
020400170;500;513;513;8;206;499;1;0;0;0;0;206;5;201
020400171;500;547;549;10;248;499;1;0;0;0;0;248;2;246
020400172;500;547;547;5;213;499;1;0;0;0;0;213;6;207
020400173;600;575;575;7;289;599;1;0;0;0;0;289;6;283
020400174;500;474;475;2;205;499;1;0;0;0;0;205;5;200
020400175;500;474;474;7;205;499;1;0;0;0;0;205;3;202
020400176;600;561;562;6;246;599;1;0;0;0;0;246;6;240
020400177;600;623;625;6;262;599;1;0;0;0;0;262;6;256
020400178;600;634;635;6;250;599;1;0;0;0;0;250;6;244
020400179;600;600;601;10;260;599;1;0;0;0;0;260;6;254
020400180;600;602;604;7;242;599;1;0;0;0;0;242;6;236
020400181;600;587;587;7;222;599;1;0;0;0;0;222;2;220
020400182;500;498;498;5;205;499;1;0;0;0;0;205;3;202
020400183;500;474;476;27;220;499;1;0;0;0;0;220;3;217
020400184;500;534;535;7;223;499;1;0;0;0;0;223;0;223
020400185;500;549;549;9;219;499;1;0;0;0;0;219;4;215
020400186;600;622;620;10;267;599;1;0;0;0;0;267;5;262
020400187;600;557;559;6;255;599;1;0;0;0;0;255;3;252
020400188;500;532;532;5;207;499;1;0;0;0;0;207;3;204
020400189;600;578;578;5;210;599;1;0;0;0;0;210;3;207
020400190;600;593;596;0;250;599;1;0;0;0;0;250;5;245
020400191;600;572;571;0;243;599;1;0;0;0;0;243;8;235
020400192;600;590;591;6;235;599;1;0;0;0;0;235;3;232
020400193;500;546;546;10;222;499;1;0;0;0;0;222;2;220
020400194;500;533;533;13;240;499;1;0;0;0;0;240;2;238
020400195;600;582;582;9;264;599;1;0;0;0;0;264;3;261
020400196;500;506;507;3;206;499;1;0;0;0;0;206;4;202
020400197;500;494;494;4;254;499;1;0;0;0;0;254;2;252
020400198;500;519;520;1;238;261;1;238;3;8;227;0;0;0
020400199;600;560;560;0;206;599;1;0;0;0;0;206;9;197
020400200;500;557;558;3;257;499;1;0;0;0;0;257;2;255
020400201;400;444;444;3;202;399;1;0;0;0;0;202;6;196
020400202;700;654;660;1;241;699;1;0;0;0;0;241;4;237
020400203;700;671;673;1;293;699;1;0;0;0;0;293;10;283
020400204;600;626;627;5;301;599;1;0;0;0;0;301;3;298
020400205;200;189;189;7;119;79;2;119;0;1;118;0;0;0
020400206;500;565;565;8;243;499;1;0;0;0;0;243;4;239
020400207;500;534;534;9;223;499;1;0;0;0;0;223;2;221
020400208;600;561;562;5;222;599;1;0;0;0;0;222;3;219
020400209;400;450;451;6;182;399;1;0;0;0;0;182;6;176
020400210;500;539;540;3;238;499;1;0;0;0;0;238;5;233
020400211;600;606;606;6;293;599;1;0;0;0;0;293;4;289
020400212;500;550;550;5;214;499;1;0;0;0;0;214;5;209
020400213;600;599;598;3;280;599;1;0;0;0;0;280;9;271
020400214;500;534;534;5;244;498;2;0;0;0;0;244;5;239
020400215;500;542;542;8;236;499;1;0;0;0;0;236;2;234
020400216;500;552;552;6;265;499;1;0;0;0;0;265;6;259
020400217;600;565;565;8;262;599;1;0;0;0;0;262;3;259
020400218;600;566;566;14;271;599;1;0;0;0;0;271;1;270
020400219;600;625;625;9;265;599;1;0;0;0;0;265;4;261
020400220;500;529;529;9;211;499;1;0;0;0;0;211;3;208
020400221;500;507;508;9;241;499;1;0;0;0;0;241;1;240
020400222;600;584;584;5;250;599;1;0;0;0;0;250;2;248
020400223;500;536;539;6;240;499;1;0;0;0;0;240;4;236
020400224;600;635;637;5;278;599;1;0;0;0;0;278;5;273
020400225;500;468;469;6;227;499;1;0;0;0;0;227;7;220
020400226;500;550;550;5;251;499;1;0;0;0;0;251;4;247
020400227;700;698;700;6;357;699;1;0;0;0;0;357;9;348
020400228;600;595;595;5;303;599;1;0;0;0;0;303;5;298
020400229;800;790;790;3;411;799;1;0;0;0;0;411;8;403
020400230;500;548;547;7;309;499;1;0;0;0;0;309;3;306
020400231;600;587;587;4;249;599;1;0;0;0;0;249;4;245
020400232;600;614;607;7;300;364;1;235;4;8;223;65;2;63
020400233;600;602;602;8;312;599;1;0;0;0;0;312;5;307
020400234;600;586;588;8;266;599;1;0;0;0;0;266;7;259
020400235;600;564;564;10;266;599;1;0;0;0;0;266;4;262
020400236;600;576;577;5;261;599;1;0;0;0;0;261;5;256
020400237;500;491;491;6;235;499;1;0;0;0;0;235;1;234
020400238;600;611;612;4;283;599;1;0;0;0;0;283;6;277
020400239;600;583;584;6;286;599;1;0;0;0;0;286;4;282
020400240;500;522;523;7;212;499;1;0;0;0;0;212;5;207
020400241;500;527;528;7;225;498;2;0;0;0;0;225;6;219
020400242;500;500;501;7;193;499;1;0;0;0;0;193;1;192
020400243;500;540;540;8;230;499;1;0;0;0;0;230;3;227
020400244;500;500;500;7;227;499;1;0;0;0;0;227;3;224
020400245;600;596;596;11;243;599;1;0;0;0;0;243;5;238
020400246;600;583;582;5;229;599;1;0;0;0;0;229;9;220
020400247;700;264;679;7;264;700;0;0;0;0;0;264;3;261
020400248;500;557;556;6;237;500;0;0;0;0;0;237;6;231
020400249;600;610;610;6;272;599;1;0;0;0;0;272;7;265
020400250;500;548;548;8;264;499;1;0;0;0;0;264;1;263
020400251;500;544;545;8;245;499;1;0;0;0;0;245;3;242
020400252;200;188;188;5;75;124;1;75;0;0;75;0;0;0
020400253;700;704;705;5;366;699;1;0;0;0;0;366;6;360
020400254;600;651;651;4;319;599;1;0;0;0;0;319;5;314
020400255;700;682;683;7;324;699;1;0;0;0;0;324;10;314
020400256;800;867;867;8;428;800;0;0;0;0;0;428;7;421
020400257;600;579;579;8;294;600;0;0;0;0;0;294;3;291
020400258;600;574;577;2;189;599;1;0;0;0;0;189;2;187
020400259;600;629;630;5;163;599;1;0;0;0;0;163;5;158
020400260;600;650;651;6;45;599;1;0;0;0;0;45;0;45
020400261;600;660;661;2;45;599;1;0;0;0;0;45;0;45
020400262;500;454;454;7;34;499;1;0;0;0;0;34;0;34
020400263;600;575;577;7;175;599;1;0;0;0;0;175;4;171
020400264;600;588;588;1;142;599;1;0;0;0;0;142;2;140
020400265;500;537;538;3;177;499;1;0;0;0;0;177;1;176
020400266;500;554;554;7;251;499;1;0;0;0;0;251;1;250
020400267;600;629;629;8;303;599;1;0;0;0;0;303;5;298
020400268;600;583;584;5;283;599;1;0;0;0;0;283;2;281
020400269;600;605;605;9;289;599;1;0;0;0;0;289;10;279
020400270;600;603;603;8;294;599;1;0;0;0;0;294;2;292
020400271;600;622;622;8;330;599;1;0;0;0;0;330;6;324
020400272;600;624;625;8;326;599;1;0;0;0;0;326;1;325
020400273;600;600;601;8;281;599;1;0;0;0;0;281;4;277
020400274;600;587;587;5;305;599;1;0;0;0;0;305;7;298
020400275;600;609;610;7;284;599;1;0;0;0;0;284;6;278
020400276;600;644;642;5;313;599;1;0;0;0;0;313;8;305
020400277;500;531;531;6;270;498;2;0;0;0;0;270;5;265
020400278;500;527;527;8;247;499;1;0;0;0;0;247;3;244
020400279;600;596;596;8;226;599;1;0;0;0;0;226;2;224
020400280;500;523;524;9;225;500;0;0;0;0;0;225;4;221
020400281;600;608;610;29;320;599;1;0;0;0;0;320;3;317
020400282;600;642;642;6;308;599;1;0;0;0;0;308;5;303
020400283;600;640;641;5;300;599;1;0;0;0;0;300;5;295
020400284;500;542;542;9;246;499;1;0;0;0;0;246;4;242
020400285;600;616;616;8;285;599;1;0;0;0;0;285;8;277
020400286;600;601;601;9;284;599;1;0;0;0;0;284;4;280
020400287;600;665;666;7;324;599;1;0;0;0;0;324;8;316
020400288;500;536;536;5;258;499;1;0;0;0;0;258;4;254
020400289;600;628;628;5;317;599;1;0;0;0;0;317;10;307
020400290;500;526;526;7;238;499;1;0;0;0;0;238;2;236
020400291;600;573;573;8;253;599;1;0;0;0;0;253;4;249
020400292;500;552;552;8;235;499;1;0;0;0;0;235;3;232
020400293;600;625;626;11;312;599;1;0;0;0;0;312;3;309
020400294;600;633;633;7;303;599;1;0;0;0;0;303;8;295
020400295;600;609;610;7;296;599;1;0;0;0;0;296;4;292
020400296;500;562;564;9;245;499;1;0;0;0;0;245;5;240
020400297;600;638;638;5;293;599;1;0;0;0;0;293;2;291
020400298;500;529;529;0;226;499;1;0;0;0;0;226;5;221
020400299;600;598;599;5;255;599;1;0;0;0;0;255;5;250
020400300;600;601;600;9;258;599;1;0;0;0;0;258;0;258
020400301;500;516;515;7;213;499;1;0;0;0;0;213;5;208
020400302;600;578;578;7;273;599;1;0;0;0;0;273;8;265
020400303;600;573;573;7;276;599;1;0;0;0;0;276;2;274
020400304;600;634;634;7;310;599;1;0;0;0;0;310;7;303
020400305;600;595;595;0;255;599;1;0;0;0;0;255;2;253
020400306;600;613;613;8;322;599;1;0;0;0;0;322;5;317
020400307;500;556;556;7;284;499;1;0;0;0;0;284;7;277
020400308;500;488;488;8;266;499;1;0;0;0;0;266;7;259
020400309;600;675;675;4;220;599;1;0;0;0;0;220;2;218
020400310;600;647;647;6;196;599;1;0;0;0;0;196;3;193
020400311;600;641;641;0;284;599;1;0;0;0;0;284;1;283
020400312;600;620;620;2;234;599;1;0;0;0;0;234;0;234
020400313;600;617;617;2;201;599;1;0;0;0;0;201;2;199
020400314;600;617;618;1;151;599;1;0;0;0;0;151;1;150
020400315;600;567;568;3;189;599;1;0;0;0;0;189;2;187
020400316;200;113;113;1;79;120;1;79;3;2;74;0;0;0
020400317;300;261;261;3;133;166;1;133;4;1;128;0;0;0
020400318;800;781;781;3;260;799;1;0;0;0;0;260;2;258
020400319;900;863;863;3;201;899;1;0;0;0;0;201;6;195
020400320;200;152;153;4;113;86;1;113;3;1;109;0;0;0
020400321;400;412;412;4;206;399;1;0;0;0;0;206;3;203
020400322;400;414;414;3;177;399;1;0;0;0;0;177;3;174
020400323;400;361;361;4;186;400;0;0;0;0;0;186;3;183
020400324;900;895;898;7;325;899;1;0;0;0;0;325;2;323
020400325;100;65;66;4;30;69;1;30;2;0;28;0;0;0
020400326;700;660;662;4;180;699;1;0;0;0;0;180;0;180
020400327;600;559;559;6;145;599;1;0;0;0;0;145;1;144
020400328;400;414;414;5;179;399;1;0;0;0;0;179;1;178
020400329;100;20;8;8;22;77;1;22;4;0;18;0;0;0
020400330;200;124;124;68;132;66;2;132;3;2;127;0;0;0
020400331;100;33;33;8;21;78;1;21;0;0;21;0;0;0
020400332;100;17;17;86;98;0;2;98;1;8;89;0;0;0
020400333;100;1;1;61;62;37;1;62;3;0;59;0;0;0
020400334;100;57;57;55;75;23;2;75;2;2;71;0;0;0
020400335;100;27;27;8;21;78;1;21;1;0;20;0;0;0
020400336;200;93;93;33;118;81;1;118;12;4;102;0;0;0
020400337;200;10;10;105;113;86;1;113;0;2;111;0;0;0
020400340;100;27;27;1;28;72;0;28;0;1;27;0;0;0
020400341;100;26;26;1;27;73;0;27;0;0;27;0;0;0
020400342;100;28;28;0;28;71;1;28;0;2;26;0;0;0
020600001;300;423;423;5;184;299;1;0;0;0;0;184;1;183
020600002;400;604;604;3;206;399;1;0;0;0;0;206;3;203
020600003;300;415;415;4;173;299;1;0;0;0;0;173;2;171
020600004;300;535;535;8;250;299;1;0;0;0;0;250;3;247
020600005;500;701;701;8;279;499;1;0;0;0;0;279;1;278
020600006;500;864;864;8;178;499;1;0;0;0;0;178;2;176
020600007;500;717;709;8;111;500;0;0;0;0;0;111;1;110
020600008;300;515;515;7;192;299;1;0;0;0;0;192;4;188
020600009;100;22;22;8;24;76;0;24;0;0;24;0;0;0
020600010;100;12;12;8;18;80;2;18;0;0;18;0;0;0
020600011;100;63;63;6;42;57;1;42;3;0;39;0;0;0
020600012;100;55;55;6;46;53;1;46;1;0;45;0;0;0
020600014;100;57;57;7;55;44;1;55;4;0;51;0;0;0
020600015;100;64;64;4;50;49;1;50;1;3;46;0;0;0
020600016;100;20;20;5;20;79;1;20;0;0;20;0;0;0
020600017;500;674;674;5;225;499;1;0;0;0;0;225;1;224
020600018;500;740;740;5;172;499;1;0;0;0;0;172;3;169
020600019;100;15;15;7;18;81;1;18;0;0;18;0;0;0
020600020;100;42;42;6;32;67;1;32;0;1;31;0;0;0
020600021;300;337;337;5;207;91;2;207;3;2;202;0;0;0
020600022;200;248;248;5;150;49;1;150;6;0;144;0;0;0
020600023;200;176;176;4;84;114;2;84;5;0;79;0;0;0
020600024;200;210;210;4;132;67;1;132;6;3;123;0;0;0
020600025;100;38;38;8;36;63;1;36;0;0;36;0;0;0
020600028;100;46;46;8;44;55;1;44;1;1;42;0;0;0
020600029;100;50;50;5;35;64;1;35;0;0;35;0;0;0
020600030;300;276;276;5;94;205;1;94;3;1;90;0;0;0
020600031;100;55;55;8;35;64;1;35;0;0;35;0;0;0
020600032;100;27;27;8;29;70;1;29;0;0;29;0;0;0
020600033;100;47;47;6;27;72;1;27;0;1;26;0;0;0
020600034;200;141;141;6;101;98;1;101;5;1;95;0;0;0
020600035;100;71;71;7;37;62;1;37;1;0;36;0;0;0
020600037;100;21;21;8;16;83;1;16;1;0;15;0;0;0
020600038;100;57;57;7;38;61;1;38;0;0;38;0;0;0
020600039;300;285;285;6;148;151;1;148;6;1;141;0;0;0
020600040;600;1071;1071;6;141;600;0;0;0;0;0;141;0;141
020600041;400;580;580;2;241;399;1;0;0;0;0;241;2;239
020600042;500;726;726;2;296;499;1;0;0;0;0;296;6;290
020600043;300;246;246;6;95;204;1;95;3;0;92;0;0;0
020800001;200;722;723;3;226;199;1;0;0;0;0;226;7;219
020800002;200;778;779;9;112;199;1;0;0;0;0;112;2;110
020800003;200;875;875;1;90;199;1;0;0;0;0;90;2;88
020800004;200;703;704;4;208;199;1;0;0;0;0;208;5;203
020800005;200;799;799;4;319;199;1;0;0;0;0;319;8;311
020800006;200;577;577;5;222;199;1;0;0;0;0;222;3;219
020800007;500;736;736;5;150;499;1;0;0;0;0;150;0;150
020800008;100;130;130;4;54;45;1;54;9;0;45;0;0;0
020800009;200;169;169;3;76;123;1;76;1;0;75;0;0;0
020800010;500;648;649;10;110;499;1;0;0;0;0;110;2;108
020800011;200;172;172;2;116;83;1;116;6;5;105;0;0;0
020800012;300;296;296;5;209;90;1;209;3;3;203;0;0;0
020800013;300;301;302;6;185;113;2;185;7;2;176;0;0;0
020800014;300;329;329;5;94;299;1;0;0;0;0;94;2;92
020800015;300;403;403;4;83;299;1;0;0;0;0;83;1;82
020800016;300;358;358;5;60;299;1;0;0;0;0;60;0;60
020800017;298;310;310;4;196;101;1;196;10;5;181;0;0;0
020800018;500;440;441;6;127;499;1;0;0;0;0;127;3;124
020800019;500;630;630;6;182;499;1;0;0;0;0;182;1;181
020800020;500;530;531;1;252;499;1;0;0;0;0;252;3;249
020900001;500;578;580;8;281;499;1;0;0;0;0;281;3;278
020900002;547;547;548;0;252;546;1;0;0;0;0;252;4;248
020900003;500;501;502;0;234;499;1;0;0;0;0;234;2;232
020900004;500;600;601;12;287;499;1;0;0;0;0;287;6;281
020900005;600;647;648;0;231;599;1;0;0;0;0;231;6;225
020900006;700;739;739;0;90;699;1;0;0;0;0;90;0;90
020900007;600;675;675;0;273;599;1;0;0;0;0;273;2;271
020900008;400;495;495;0;238;399;1;0;0;0;0;238;3;235
020900009;600;632;632;2;250;599;1;0;0;0;0;250;6;244
020900010;400;442;443;7;193;399;1;0;0;0;0;193;1;192
020900011;400;435;431;6;237;399;1;0;0;0;0;237;4;233
020900012;600;601;605;7;248;599;1;0;0;0;0;248;1;247
020900013;700;763;763;3;341;699;1;0;0;0;0;341;5;336
020900014;600;614;619;2;274;599;1;0;0;0;0;274;2;272
020900015;500;564;565;4;203;499;1;0;0;0;0;203;2;201
020900016;400;412;412;0;178;399;1;0;0;0;0;178;3;175
020900017;400;425;425;5;178;399;1;0;0;0;0;178;1;177
020900018;700;794;796;6;74;699;1;0;0;0;0;74;1;73
020900019;800;802;803;1;153;799;1;0;0;0;0;153;2;151
020900020;700;778;778;8;43;699;1;0;0;0;0;43;0;43
020900021;500;556;556;7;181;311;8;181;5;2;174;0;0;0
020900022;600;662;661;7;174;599;1;0;0;0;0;174;4;170
020900023;200;193;193;5;80;119;1;80;1;2;77;0;0;0
020900024;700;731;731;5;205;699;1;0;0;0;0;205;3;202
020900025;700;760;760;6;35;699;1;0;0;0;0;35;0;35
020900026;500;509;509;0;181;499;1;0;0;0;0;181;2;179
020900027;300;342;343;0;153;299;1;0;0;0;0;153;3;150
020900028;300;328;328;7;100;299;1;0;0;0;0;100;0;100
020900029;300;386;387;5;34;299;1;0;0;0;0;34;0;34
020900030;300;395;396;6;88;299;1;0;0;0;0;88;0;88
020900031;100;89;90;5;35;64;1;35;2;1;32;0;0;0
020900032;100;81;81;5;57;42;1;57;1;0;56;0;0;0
020900033;100;68;68;6;41;58;1;41;2;0;39;0;0;0
020900034;100;95;95;6;41;58;1;41;0;1;40;0;0;0
020900035;100;108;108;7;40;59;1;40;1;1;38;0;0;0
020900036;100;64;64;5;44;54;2;44;1;1;42;0;0;0
020900037;100;44;46;7;27;72;1;27;0;2;25;0;0;0
020900038;300;350;351;3;105;299;1;0;0;0;0;105;2;103
020900039;100;66;66;5;44;55;1;44;4;0;40;0;0;0
020900040;200;129;129;5;69;130;1;69;2;5;62;0;0;0
020900041;100;50;50;6;29;70;1;29;0;0;29;0;0;0
020900042;300;298;298;7;155;144;1;155;2;1;152;0;0;0
020900043;300;267;267;6;70;229;1;70;0;0;70;0;0;0
020900044;100;50;50;9;34;65;1;34;2;0;32;0;0;0
020900045;200;173;173;5;24;175;1;24;1;0;23;0;0;0
020900046;700;762;775;7;394;699;1;0;0;0;0;394;2;392
020900047;300;246;246;4;68;231;1;68;0;1;67;0;0;0
020900048;100;17;17;8;15;84;1;15;0;0;15;0;0;0
020900049;200;78;78;6;58;141;1;58;1;1;56;0;0;0
020900050;200;105;105;7;73;126;1;73;6;0;67;0;0;0
020900051;200;173;173;6;57;142;1;57;1;0;56;0;0;0
020900052;200;122;122;7;46;153;1;46;0;0;46;0;0;0
020900053;100;88;88;6;49;50;1;49;0;2;47;0;0;0
020900054;100;95;95;6;41;58;1;41;3;0;38;0;0;0
020900055;200;173;173;6;60;138;2;60;2;0;58;0;0;0
020900056;500;452;452;6;112;499;1;0;0;0;0;112;0;112
020900057;100;26;26;8;21;78;1;21;0;0;21;0;0;0
020900058;100;85;85;6;44;55;1;44;1;0;43;0;0;0
020900059;100;30;30;0;29;70;1;29;0;0;29;0;0;0
021200001;300;342;343;5;104;299;1;0;0;0;0;104;2;102
021200002;420;548;548;3;199;419;1;0;0;0;0;199;4;195
021200003;400;537;537;1;181;399;1;0;0;0;0;181;5;176
021200004;400;415;415;5;144;399;1;0;0;0;0;144;0;144
021200005;50;29;29;5;27;22;1;27;0;0;27;0;0;0
021200007;200;206;205;2;139;59;2;139;9;0;130;0;0;0
021200008;50;24;24;6;25;24;1;25;0;0;25;0;0;0
021200009;60;35;35;5;27;32;1;27;2;0;25;0;0;0
021200010;50;14;14;4;16;33;1;16;1;0;15;0;0;0
021200011;60;38;38;4;32;27;1;32;4;0;28;0;0;0
021200012;100;46;46;7;43;56;1;43;2;1;40;0;0;0
021200013;300;309;309;6;140;159;1;140;10;4;126;0;0;0
021200014;50;20;20;7;21;28;1;21;0;0;21;0;0;0
021200016;60;34;34;5;32;27;1;32;1;0;31;0;0;0
021300001;400;484;484;5;256;399;1;0;0;0;0;256;4;252
021300002;600;686;686;5;356;599;1;0;0;0;0;356;5;351
021300003;600;664;663;3;302;599;1;0;0;0;0;302;6;296
021300004;700;767;767;4;400;699;1;0;0;0;0;400;12;388
021300005;300;386;386;5;256;299;1;0;0;0;0;256;5;251
021300006;700;800;800;2;354;699;1;0;0;0;0;354;0;354
021300007;900;990;989;5;439;899;1;0;0;0;0;439;5;434
021300008;300;258;258;8;88;210;2;88;6;0;82;0;0;0
021300009;50;23;23;7;26;23;1;26;1;0;25;0;0;0
021300010;500;580;580;8;349;499;1;0;0;0;0;349;7;342
021300011;100;71;71;7;57;42;1;57;0;1;56;0;0;0
021300012;50;36;36;4;28;21;1;28;0;0;28;0;0;0
021300013;500;504;504;3;260;499;1;0;0;0;0;260;0;260
021300014;500;570;569;7;270;499;1;0;0;0;0;270;4;266
021300015;100;65;64;1;61;38;1;61;1;0;60;0;0;0
021300016;400;357;356;6;249;150;1;249;4;1;244;0;0;0
021300017;250;209;210;0;93;156;1;93;2;0;91;0;0;0
021300018;200;166;166;5;87;112;1;87;1;0;86;0;0;0
021300019;250;252;251;2;164;85;1;164;8;2;154;0;0;0
021300020;50;40;40;7;27;22;1;27;2;0;25;0;0;0
021500001;500;498;498;5;292;499;1;0;0;0;0;292;5;287
021500002;500;503;503;6;271;500;0;0;0;0;0;271;8;263
021500003;400;435;434;6;211;399;1;0;0;0;0;211;6;205
021500004;700;715;715;6;335;699;1;0;0;0;0;335;5;330
021500005;700;776;776;2;369;699;1;0;0;0;0;369;6;363
021500006;700;723;723;5;322;699;1;0;0;0;0;322;1;321
021500007;600;631;630;8;246;599;1;0;0;0;0;246;2;244
021500008;600;672;672;2;243;599;1;0;0;0;0;243;4;239
021500009;700;754;754;8;377;699;1;0;0;0;0;377;6;371
021500010;700;717;716;1;356;699;1;0;0;0;0;356;2;354
021500011;700;727;726;5;375;700;0;0;0;0;0;375;5;370
021500012;500;557;553;7;189;499;1;0;0;0;0;189;0;189
021500013;500;595;594;5;204;499;1;0;0;0;0;204;2;202
021500014;200;180;180;3;135;64;1;135;3;2;130;0;0;0
021500015;800;815;816;3;386;799;1;0;0;0;0;386;4;382
021500016;700;713;712;3;329;699;1;0;0;0;0;329;6;323
021500017;800;895;895;3;376;799;1;0;0;0;0;376;6;370
021500018;500;485;482;2;102;499;1;0;0;0;0;102;1;101
021500019;300;326;326;4;147;299;1;0;0;0;0;147;0;147
021500020;500;490;491;5;156;499;1;0;0;0;0;156;1;155
021500021;400;414;415;7;180;399;1;0;0;0;0;180;1;179
021500022;600;585;585;3;310;599;1;0;0;0;0;310;5;305
021500023;500;535;535;1;320;499;1;0;0;0;0;320;5;315
021500024;700;701;701;1;338;699;1;0;0;0;0;338;3;335
021500025;100;46;46;8;44;55;1;44;2;0;42;0;0;0
021500026;100;48;48;7;41;58;1;41;1;0;40;0;0;0
021500027;400;445;445;3;142;399;1;0;0;0;0;142;0;142
021500028;600;648;648;5;80;599;1;0;0;0;0;80;1;79
021500029;100;74;75;6;56;43;1;56;4;0;52;0;0;0
021500030;600;643;642;7;329;599;1;0;0;0;0;329;6;323
021500031;600;593;593;6;293;599;1;0;0;0;0;293;2;291
021500032;400;417;417;0;137;399;1;0;0;0;0;137;0;137
021500033;500;507;507;3;162;499;1;0;0;0;0;162;2;160
021500034;800;879;879;3;385;799;1;0;0;0;0;385;3;382
021500035;1000;1114;1111;5;442;999;1;0;0;0;0;442;2;440
021500036;500;589;588;2;289;499;1;0;0;0;0;289;6;283
021500037;400;248;248;48;200;199;1;200;2;4;194;0;0;0
021700001;100;72;72;7;57;42;1;57;0;0;57;0;0;0
021700002;500;516;517;4;231;499;1;0;0;0;0;231;2;229
021700003;400;413;413;2;163;399;1;0;0;0;0;163;0;163
021700004;400;459;459;2;185;399;1;0;0;0;0;185;2;183
021700005;400;421;421;4;166;399;1;0;0;0;0;166;1;165
021700006;500;497;497;2;200;499;1;0;0;0;0;200;1;199
021700007;400;406;407;9;150;399;1;0;0;0;0;150;2;148
021700008;400;396;396;5;199;399;1;0;0;0;0;199;0;199
021700009;500;508;508;4;238;499;1;0;0;0;0;238;0;238
021700010;500;525;525;3;112;499;1;0;0;0;0;112;1;111
021700011;500;513;514;6;175;499;1;0;0;0;0;175;0;175
021700012;400;401;401;2;122;399;1;0;0;0;0;122;2;120
021700013;300;246;246;3;115;184;1;115;2;1;112;0;0;0
021700014;600;639;639;2;124;599;1;0;0;0;0;124;2;122
021700015;400;472;472;1;92;399;1;0;0;0;0;92;1;91
021700016;500;568;568;1;207;499;1;0;0;0;0;207;1;206
021700017;500;582;582;2;209;499;1;0;0;0;0;209;1;208
021700018;600;612;612;7;293;599;1;0;0;0;0;293;2;291
021700019;300;368;368;5;172;299;1;0;0;0;0;172;4;168
021700020;500;514;514;9;249;499;1;0;0;0;0;249;3;246
021700021;400;425;427;6;204;399;1;0;0;0;0;204;6;198
021700022;400;471;475;0;236;399;1;0;0;0;0;236;4;232
021700023;500;517;517;11;248;499;1;0;0;0;0;248;0;248
021700024;800;787;790;1;352;799;1;0;0;0;0;352;4;348
021700025;800;847;848;1;392;799;1;0;0;0;0;392;6;386
021700026;500;562;563;3;235;499;1;0;0;0;0;235;4;231
021700027;200;216;216;4;107;92;1;107;0;1;106;0;0;0
021700028;400;481;482;7;228;400;0;0;0;0;0;228;2;226
021700029;700;312;752;9;312;699;1;0;0;0;0;312;3;309
021700030;400;415;417;3;175;399;1;0;0;0;0;175;3;172
021700031;500;529;529;6;223;499;1;0;0;0;0;223;0;223
021700032;700;762;762;7;159;699;1;0;0;0;0;159;0;159
021700033;400;397;397;5;184;399;1;0;0;0;0;184;5;179
021700034;200;176;175;7;130;68;2;130;0;1;129;0;0;0
021700035;300;288;288;4;79;220;1;79;2;0;77;0;0;0
021700036;400;399;401;6;169;399;1;0;0;0;0;169;7;162
021700037;600;594;594;3;245;599;1;0;0;0;0;245;5;240
021700038;600;589;594;6;228;599;1;0;0;0;0;228;6;222
021700039;500;539;539;4;238;499;1;0;0;0;0;238;1;237
021700040;800;909;908;8;147;799;1;0;0;0;0;147;3;144
021700041;200;140;140;2;55;144;1;55;0;1;54;0;0;0
021700042;100;38;38;7;29;70;1;29;1;1;27;0;0;0
021700043;500;551;551;5;282;499;1;0;0;0;0;282;1;281
021700044;700;716;716;6;323;698;2;0;0;0;0;323;0;323
021700045;439;439;439;4;149;438;1;0;0;0;0;149;3;146
021700046;600;683;683;7;169;599;1;0;0;0;0;169;1;168
021700047;300;213;213;4;107;192;1;107;1;2;104;0;0;0
021700049;300;130;130;68;166;133;1;166;2;6;158;0;0;0
021700051;500;526;526;5;174;499;1;0;0;0;0;174;3;171
021700052;300;41;41;108;147;150;3;147;3;2;142;0;0;0
021700053;100;17;17;3;20;80;0;20;0;0;20;0;0;0
021800001;800;885;885;4;278;799;1;0;0;0;0;278;1;277
021800002;600;599;599;6;302;599;1;0;0;0;0;302;1;301
021800003;700;668;668;4;296;699;1;0;0;0;0;296;6;290
021800004;700;672;672;2;307;699;1;0;0;0;0;307;1;306
021800005;300;261;261;5;153;146;1;153;0;2;151;0;0;0
021800006;800;376;820;6;382;800;0;0;0;0;0;382;0;382
021800007;700;697;697;2;411;699;1;0;0;0;0;411;1;410
021800008;600;612;613;0;352;599;1;0;0;0;0;352;1;351
021800009;400;359;360;2;150;399;1;0;0;0;0;150;3;147
021800010;300;323;324;4;146;300;0;0;0;0;0;146;1;145
021800011;700;689;689;2;374;699;1;0;0;0;0;374;1;373
021800012;400;421;421;3;263;399;1;0;0;0;0;263;2;261
021800013;1100;1040;1040;5;743;1100;0;0;0;0;0;743;2;741
021800015;200;182;182;3;145;54;1;145;0;3;142;0;0;0
021800016;400;428;429;1;263;400;0;0;0;0;0;263;0;263
021800017;500;454;454;2;201;499;1;0;0;0;0;201;2;199
021800018;761;761;761;3;239;761;0;0;0;0;0;239;2;237
021800019;800;804;800;3;253;799;1;0;0;0;0;253;2;251
021800020;500;501;501;5;145;499;1;0;0;0;0;145;2;143
021800021;500;301;488;4;301;499;1;0;0;0;0;301;1;300
021800022;700;676;676;5;356;699;1;0;0;0;0;356;0;356
021800023;800;795;795;4;410;799;1;0;0;0;0;410;0;410
021800024;400;354;354;1;204;399;1;0;0;0;0;204;1;203
021800025;500;452;453;3;269;499;1;0;0;0;0;269;0;269
021800026;400;370;370;1;224;399;1;0;0;0;0;224;3;221
021800027;600;555;555;5;172;599;1;0;0;0;0;172;5;167
021800028;600;613;613;4;185;599;1;0;0;0;0;185;1;184
021800029;1000;940;940;3;427;999;1;0;0;0;0;427;2;425
021800030;700;697;697;5;333;700;0;0;0;0;0;333;1;332
021800031;400;387;387;3;242;399;1;0;0;0;0;242;1;241
021800032;300;221;221;0;157;142;1;157;0;1;156;0;0;0
021800033;600;551;551;12;270;599;1;0;0;0;0;270;0;270
021800034;800;776;776;3;354;799;1;0;0;0;0;354;0;354
021800035;500;434;434;3;216;500;0;0;0;0;0;216;0;216
021800036;400;359;359;1;221;400;0;0;0;0;0;221;3;218
021800037;600;611;611;6;324;599;1;0;0;0;0;324;1;323
021800038;400;337;337;2;224;399;1;0;0;0;0;224;0;224
021800039;1000;951;951;4;665;999;1;0;0;0;0;665;5;660
021800041;600;556;556;4;217;599;1;0;0;0;0;217;0;217
021800042;300;322;322;2;256;299;1;0;0;0;0;256;0;256
021800043;600;370;615;3;370;600;0;0;0;0;0;370;1;369
021800044;300;341;341;4;220;299;1;0;0;0;0;220;6;214
021800045;500;470;470;2;274;500;0;0;0;0;0;274;0;274
021800046;800;836;836;2;367;799;1;0;0;0;0;367;0;367
021800047;700;661;661;5;250;699;1;0;0;0;0;250;3;247
021800048;700;686;686;2;312;699;1;0;0;0;0;312;2;310
021800049;400;341;341;5;185;399;1;0;0;0;0;185;1;184
021800051;1100;1098;1099;5;439;1099;1;0;0;0;0;439;0;439
021800052;500;446;446;4;239;500;0;0;0;0;0;239;0;239
022100001;550;602;603;5;349;549;1;0;0;0;0;349;7;342
022100002;450;502;502;14;309;449;1;0;0;0;0;309;2;307
022100003;750;847;846;5;414;749;1;0;0;0;0;414;3;411
022100004;500;561;561;9;292;499;1;0;0;0;0;292;1;291
022100005;850;910;909;9;453;849;1;0;0;0;0;453;5;448
022100006;750;791;788;4;467;749;1;0;0;0;0;467;12;455
022100008;250;217;217;4;126;123;1;126;5;1;120;0;0;0
022100009;450;507;507;5;253;449;1;0;0;0;0;253;8;245
022100010;150;104;104;4;90;58;2;90;1;0;89;0;0;0
022100011;250;210;210;3;72;177;1;72;2;0;70;0;0;0
022100012;400;422;422;0;137;399;1;0;0;0;0;137;0;137
022100013;400;426;426;3;78;399;1;0;0;0;0;78;1;77
022100015;200;156;156;2;110;89;1;110;3;1;106;0;0;0
022100016;654;654;654;5;245;653;1;0;0;0;0;245;0;245
022100017;150;103;100;3;70;76;4;70;3;1;66;0;0;0
022100018;550;598;598;4;279;549;1;0;0;0;0;279;1;278
022100019;550;684;684;4;202;549;1;0;0;0;0;202;1;201
022100020;700;760;761;1;249;699;1;0;0;0;0;249;6;243
022100021;300;345;345;2;148;299;1;0;0;0;0;148;1;147
022100022;900;984;983;6;471;900;0;0;0;0;0;471;9;462
022100023;850;922;918;4;468;850;0;0;0;0;0;468;7;461
022300001;600;662;662;7;187;600;0;0;0;0;0;187;3;184
022300002;600;575;575;8;203;600;0;0;0;0;0;203;0;203
022300003;600;626;626;2;211;600;0;0;0;0;0;211;2;209
022300004;800;897;897;6;221;800;0;0;0;0;0;221;0;221
022300005;100;80;81;5;55;43;2;55;1;0;54;0;0;0
022300006;100;62;62;6;34;65;1;34;3;0;31;0;0;0
022300007;100;69;69;4;46;53;1;46;0;0;46;0;0;0
022300008;300;291;279;2;133;166;1;133;1;0;132;0;0;0
022300009;100;106;106;6;75;24;1;75;12;0;63;0;0;0
022300010;100;60;60;7;34;65;1;34;1;0;33;0;0;0
022300011;300;303;303;6;134;165;1;134;10;1;123;0;0;0
022300012;600;612;612;6;167;599;1;0;0;0;0;167;0;167
022300013;100;23;23;7;25;74;1;25;0;0;25;0;0;0
022300014;100;39;39;6;28;71;1;28;0;0;28;0;0;0
022300015;100;84;84;3;54;45;1;54;1;0;53;0;0;0
022300016;200;178;178;3;36;163;1;36;0;0;36;0;0;0
022300017;300;306;304;7;189;299;1;0;0;0;0;189;0;189
022300018;300;314;314;6;127;299;1;0;0;0;0;127;0;127
022300019;500;592;588;6;206;499;1;0;0;0;0;206;2;204
022300020;500;578;578;2;263;499;1;0;0;0;0;263;2;261
022300021;500;537;537;5;222;499;1;0;0;0;0;222;1;221
022300022;300;312;312;0;183;114;3;183;6;2;175;0;0;0
022300023;500;495;495;2;224;500;0;0;0;0;0;224;3;221
022300024;200;138;133;5;68;130;2;68;1;0;67;0;0;0
022300025;600;615;615;5;213;600;0;0;0;0;0;213;2;211
022300026;200;164;164;5;78;121;1;78;5;0;73;0;0;0
022300027;800;840;840;6;338;800;0;0;0;0;0;338;0;338
022300028;100;58;59;7;36;63;1;36;3;0;33;0;0;0
022300029;300;288;287;6;147;152;1;147;7;1;139;0;0;0
022300030;500;473;473;2;181;500;0;0;0;0;0;181;1;180
022700001;700;820;822;7;440;699;1;0;0;0;0;440;5;435
022700002;900;1064;1063;7;484;899;1;0;0;0;0;484;10;474
022700003;1000;1000;1000;6;430;999;1;0;0;0;0;430;4;426
022700004;600;711;711;4;386;599;1;0;0;0;0;386;3;383
022700005;200;131;131;5;89;110;1;89;3;5;81;0;0;0
022700006;400;496;497;2;303;399;1;0;0;0;0;303;2;301
022700007;100;37;36;3;19;79;2;19;2;0;17;0;0;0
022700008;850;983;982;3;548;849;1;0;0;0;0;548;9;539
022700009;400;455;455;5;267;399;1;0;0;0;0;267;4;263
030100001;600;517;518;4;266;600;0;0;0;0;0;266;3;263
030100002;600;499;414;2;255;599;1;0;0;0;0;255;2;253
030100003;700;606;535;6;347;700;0;0;0;0;0;347;5;342
030100004;200;142;100;5;106;93;1;106;0;0;106;0;0;0
030100005;500;358;359;2;152;499;1;0;0;0;0;152;1;151
030100006;800;722;722;4;253;799;1;0;0;0;0;253;0;253
030100007;400;305;277;5;232;167;1;232;8;5;219;0;0;0
030100008;300;209;165;4;89;210;1;89;4;0;85;0;0;0
030100009;300;221;222;4;153;146;1;153;4;0;149;0;0;0
030100010;200;66;56;6;60;139;1;60;1;1;58;0;0;0
030100011;900;795;738;5;402;900;0;0;0;0;0;402;4;398
030100012;300;103;145;6;103;196;1;103;5;0;98;0;0;0
030100013;400;240;108;4;140;256;4;140;7;1;132;0;0;0
030100014;1000;874;875;2;274;999;1;0;0;0;0;274;3;271
030100015;500;438;369;6;218;499;1;0;0;0;0;218;3;215
030100016;600;543;397;7;279;599;1;0;0;0;0;279;0;279
030100017;200;87;74;4;45;154;1;45;3;0;42;0;0;0
030200001;600;717;718;4;369;599;1;0;0;0;0;369;1;368
030200002;700;756;756;4;364;699;1;0;0;0;0;364;4;360
030200003;700;758;760;9;371;699;1;0;0;0;0;371;5;366
030200004;500;568;570;5;252;499;1;0;0;0;0;252;5;247
030200005;700;721;724;2;260;699;1;0;0;0;0;260;2;258
030200006;700;810;810;7;369;699;1;0;0;0;0;369;6;363
030200007;700;778;778;3;352;699;1;0;0;0;0;352;4;348
030200008;600;689;689;4;297;599;1;0;0;0;0;297;3;294
030200009;600;724;726;6;317;599;1;0;0;0;0;317;2;315
030200010;700;702;661;5;314;699;1;0;0;0;0;314;0;314
030200011;900;862;209;2;370;529;1;370;17;8;345;0;0;0
030200012;200;173;173;6;121;77;2;121;1;2;118;0;0;0
030200013;200;140;140;4;114;85;1;114;7;1;106;0;0;0
030200014;600;601;601;3;205;599;1;0;0;0;0;205;2;203
030200015;600;675;673;6;226;600;0;0;0;0;0;226;2;224
030200016;600;646;648;5;186;600;0;0;0;0;0;186;0;186
030200017;700;710;712;5;198;699;1;0;0;0;0;198;1;197
030200018;697;697;697;5;159;696;1;0;0;0;0;159;0;159
030200019;600;679;617;3;343;599;1;0;0;0;0;343;3;340
030200020;200;140;141;4;103;96;1;103;1;4;98;0;0;0
030200021;800;803;802;5;403;800;0;0;0;0;0;403;14;389
030200022;400;295;296;4;193;206;1;193;1;2;190;0;0;0
030200023;300;231;231;4;165;133;2;165;0;1;164;0;0;0
030200024;300;286;288;2;177;122;1;177;5;2;170;0;0;0
030200025;200;96;96;4;82;117;1;82;1;0;81;0;0;0
030200026;200;174;174;2;119;77;4;119;2;3;114;0;0;0
030200027;400;352;353;6;187;399;1;0;0;0;0;187;0;187
030200028;400;356;356;4;178;400;0;0;0;0;0;178;6;172
030200029;200;146;146;1;135;64;1;135;0;0;135;0;0;0
030200030;200;113;113;2;77;122;1;77;0;0;77;0;0;0
030200031;100;119;119;6;81;17;2;81;2;1;78;0;0;0
030200032;100;30;30;3;25;74;1;25;1;0;24;0;0;0
030200033;300;294;55;5;121;178;1;121;2;0;119;0;0;0
030200034;500;515;134;3;215;283;2;215;6;0;209;0;0;0
030200035;400;353;84;2;138;257;5;138;6;0;132;0;0;0
030200036;300;260;260;1;191;108;1;191;2;0;189;0;0;0
030200037;100;77;77;6;57;42;1;57;5;1;51;0;0;0
030200038;100;20;20;6;24;75;1;24;2;0;22;0;0;0
030400001;900;836;837;8;151;899;1;0;0;0;0;151;0;151
030400002;800;814;814;3;228;799;1;0;0;0;0;228;2;226
030400003;900;852;855;1;338;899;1;0;0;0;0;338;4;334
030400004;800;768;770;3;304;799;1;0;0;0;0;304;4;300
030400005;600;575;576;9;253;600;0;0;0;0;0;253;7;246
030400006;500;509;510;6;202;499;1;0;0;0;0;202;0;202
030400007;600;559;560;6;253;599;1;0;0;0;0;253;7;246
030400008;600;558;559;8;231;599;1;0;0;0;0;231;2;229
030400009;500;437;438;4;133;499;1;0;0;0;0;133;4;129
030400010;600;496;496;6;197;599;1;0;0;0;0;197;0;197
030400011;400;377;377;3;174;399;1;0;0;0;0;174;2;172
030400012;700;710;677;7;328;699;1;0;0;0;0;328;1;327
030400013;600;580;580;7;188;599;1;0;0;0;0;188;3;185
030400014;1000;925;924;7;275;999;1;0;0;0;0;275;3;272
030500001;500;855;856;4;367;499;1;0;0;0;0;367;6;361
030500002;500;792;792;1;393;499;1;0;0;0;0;393;8;385
030500003;100;87;87;5;65;33;2;65;1;0;64;0;0;0
030500004;200;227;227;1;106;93;1;106;0;1;105;0;0;0
030500005;200;228;228;5;114;85;1;114;4;3;107;0;0;0
030500006;500;400;404;4;84;499;1;0;0;0;0;84;0;84
030600378;500;641;641;9;305;499;1;0;0;0;0;305;3;302
030600379;500;487;487;4;203;499;1;0;0;0;0;203;3;200
030600380;500;634;634;3;288;499;1;0;0;0;0;288;1;287
030600381;500;742;742;6;312;499;1;0;0;0;0;312;10;302
030600382;500;322;322;6;192;307;1;192;3;5;184;0;0;0
030600383;500;443;443;3;192;499;1;0;0;0;0;192;1;191
030600384;800;773;773;5;77;799;1;0;0;0;0;77;0;77
030600385;700;726;726;8;115;700;0;0;0;0;0;115;1;114
030600386;1000;946;946;5;518;999;1;0;0;0;0;518;6;512
030600387;1500;1091;1091;5;394;1499;1;0;0;0;0;394;3;391
030601001;500;625;628;8;309;499;1;0;0;0;0;309;7;302
030601002;500;754;754;9;368;499;1;0;0;0;0;368;5;363
030601003;1000;918;918;9;490;999;1;0;0;0;0;490;9;481
030601004;1000;782;783;8;359;999;1;0;0;0;0;359;3;356
030601005;500;719;719;11;357;499;1;0;0;0;0;357;8;349
030601006;500;587;587;10;303;499;1;0;0;0;0;303;6;297
030601007;500;667;672;7;324;499;1;0;0;0;0;324;5;319
030601008;500;591;591;8;261;500;0;0;0;0;0;261;4;257
030601009;500;558;560;11;271;499;1;0;0;0;0;271;3;268
030601010;500;600;601;6;310;499;1;0;0;0;0;310;6;304
030601011;500;724;724;9;356;499;1;0;0;0;0;356;2;354
030601012;1000;781;783;9;353;999;1;0;0;0;0;353;2;351
030601013;500;748;749;10;388;499;1;0;0;0;0;388;5;383
030601014;500;715;716;8;331;499;1;0;0;0;0;331;3;328
030601015;500;764;766;14;338;500;0;0;0;0;0;338;4;334
030601016;1000;929;931;7;370;1000;0;0;0;0;0;370;5;365
030601017;1000;949;951;11;460;999;1;0;0;0;0;460;6;454
030601018;1000;1015;1016;12;483;999;1;0;0;0;0;483;10;473
030601019;1000;830;832;7;369;999;1;0;0;0;0;369;3;366
030601020;1000;960;961;6;440;1000;0;0;0;0;0;440;7;433
030601021;1000;972;972;4;396;999;1;0;0;0;0;396;3;393
030601022;1000;755;757;7;350;999;1;0;0;0;0;350;5;345
030601023;1000;947;947;10;407;999;1;0;0;0;0;407;7;400
030601024;1000;929;929;10;390;1000;0;0;0;0;0;390;6;384
030601025;500;734;734;10;346;500;0;0;0;0;0;346;8;338
030601026;1000;876;878;12;436;999;1;0;0;0;0;436;5;431
030601027;500;718;722;10;352;500;0;0;0;0;0;352;8;344
030601028;1000;859;861;7;377;999;1;0;0;0;0;377;4;373
030601029;500;722;727;9;326;500;0;0;0;0;0;326;1;325
030601030;1000;864;864;6;416;1000;0;0;0;0;0;416;8;408
030601031;500;573;575;10;275;500;0;0;0;0;0;275;4;271
030601032;1000;895;895;8;453;1000;0;0;0;0;0;453;5;448
030601033;1000;900;900;10;348;999;1;0;0;0;0;348;4;344
030601034;500;740;740;10;379;500;0;0;0;0;0;379;9;370
030601035;500;705;706;11;361;499;1;0;0;0;0;361;4;357
030601036;500;554;558;9;285;499;1;0;0;0;0;285;2;283
030601037;500;715;715;11;354;499;1;0;0;0;0;354;3;351
030601038;1000;783;783;4;381;999;1;0;0;0;0;381;1;380
030601039;1000;869;869;10;432;999;1;0;0;0;0;432;7;425
030601040;500;551;551;12;301;500;0;0;0;0;0;301;4;297
030601041;500;592;592;11;294;499;1;0;0;0;0;294;1;293
030601042;500;734;735;9;360;499;1;0;0;0;0;360;5;355
030601043;500;745;745;10;362;500;0;0;0;0;0;362;4;358
030601044;500;670;671;9;332;500;0;0;0;0;0;332;7;325
030601045;500;711;714;10;332;500;0;0;0;0;0;332;11;321
030601046;1000;874;876;12;451;999;1;0;0;0;0;451;4;447
030601047;1000;886;888;10;450;1000;0;0;0;0;0;450;5;445
030601048;1000;904;904;9;437;1000;0;0;0;0;0;437;8;429
030601049;1000;800;802;15;388;999;1;0;0;0;0;388;3;385
030601050;1000;936;939;9;470;1000;0;0;0;0;0;470;3;467
030601051;1000;895;897;8;402;1000;0;0;0;0;0;402;9;393
030601052;1000;836;837;9;396;1000;0;0;0;0;0;396;5;391
030601053;1000;776;777;6;366;999;1;0;0;0;0;366;4;362
030601054;1000;882;882;7;397;999;1;0;0;0;0;397;7;390
030601055;1000;912;914;10;467;999;1;0;0;0;0;467;6;461
030601056;1000;984;984;8;462;1000;0;0;0;0;0;462;4;458
030601057;1000;899;901;8;434;1000;0;0;0;0;0;434;7;427
030601058;1000;856;859;8;374;1000;0;0;0;0;0;374;6;368
030601059;1000;958;960;9;449;1000;0;0;0;0;0;449;10;439
030601060;1000;963;964;11;462;1000;0;0;0;0;0;462;6;456
030601061;1000;831;831;10;427;999;1;0;0;0;0;427;9;418
030601062;1000;840;841;6;422;999;1;0;0;0;0;422;1;421
030601063;1000;914;916;10;445;1000;0;0;0;0;0;445;5;440
030601064;1000;979;979;7;409;1000;0;0;0;0;0;409;7;402
030601065;1000;1062;1064;10;449;999;1;0;0;0;0;449;15;434
030601066;1000;861;861;9;390;999;1;0;0;0;0;390;4;386
030601067;1000;856;858;8;314;998;2;0;0;0;0;314;7;307
030601068;1000;944;948;6;378;999;1;0;0;0;0;378;4;374
030601069;1000;975;980;10;337;999;1;0;0;0;0;337;6;331
030601070;1000;884;887;11;365;1000;0;0;0;0;0;365;2;363
030601071;1000;765;767;9;293;999;1;0;0;0;0;293;7;286
030601072;500;716;718;6;235;500;0;0;0;0;0;235;0;235
030601073;500;575;575;5;107;500;0;0;0;0;0;107;3;104
030601074;500;416;416;0;91;500;0;0;0;0;0;91;0;91
030601075;1000;791;791;9;65;999;1;0;0;0;0;65;0;65
030601076;1000;877;877;9;57;999;1;0;0;0;0;57;1;56
030601077;1000;877;883;9;225;1000;0;0;0;0;0;225;1;224
030601078;1000;943;947;7;275;1000;0;0;0;0;0;275;0;275
030601079;1000;928;931;8;397;1000;0;0;0;0;0;397;4;393
030601080;1000;937;939;7;399;1000;0;0;0;0;0;399;10;389
030601081;1000;937;937;10;366;1000;0;0;0;0;0;366;5;361
030601082;1000;895;899;8;335;1000;0;0;0;0;0;335;6;329
030601083;500;710;714;9;287;500;0;0;0;0;0;287;8;279
030601084;1000;875;876;13;458;999;1;0;0;0;0;458;6;452
030601085;1000;809;809;8;387;999;1;0;0;0;0;387;4;383
030601086;500;559;559;5;278;499;1;0;0;0;0;278;4;274
030602087;800;819;821;13;407;799;1;0;0;0;0;407;6;401
030602088;800;769;771;9;360;799;1;0;0;0;0;360;8;352
030602089;800;765;765;3;273;799;1;0;0;0;0;273;7;266
030602090;700;701;703;10;332;699;1;0;0;0;0;332;5;327
030602091;900;921;922;12;398;900;0;0;0;0;0;398;7;391
030602092;900;936;939;16;419;900;0;0;0;0;0;419;4;415
030602093;1000;946;946;10;481;999;1;0;0;0;0;481;7;474
030602094;1000;976;978;9;459;999;1;0;0;0;0;459;4;455
030602095;900;881;884;18;417;900;0;0;0;0;0;417;6;411
030602096;1000;998;999;10;449;999;1;0;0;0;0;449;5;444
030602097;900;889;890;7;448;899;1;0;0;0;0;448;6;442
030602098;800;818;822;20;398;799;1;0;0;0;0;398;8;390
030602099;800;753;755;13;333;799;1;0;0;0;0;333;0;333
030602100;800;764;765;24;369;799;1;0;0;0;0;369;5;364
030602101;700;693;693;13;321;699;1;0;0;0;0;321;2;319
030602102;600;611;612;11;297;599;1;0;0;0;0;297;6;291
030602103;800;802;803;12;377;799;1;0;0;0;0;377;10;367
030602104;800;821;823;33;384;799;1;0;0;0;0;384;3;381
030602105;500;408;409;7;192;311;1;188;0;7;181;4;0;4
030602106;400;382;384;21;198;400;0;0;0;0;0;198;4;194
030602107;800;787;787;8;313;704;1;95;0;5;90;218;4;214
030602108;900;881;882;8;417;899;1;0;0;0;0;417;8;409
030602109;900;908;910;8;444;899;1;0;0;0;0;444;6;438
030602110;800;751;753;15;349;800;0;0;0;0;0;349;7;342
030602111;800;830;833;12;390;800;0;0;0;0;0;390;4;386
030602112;800;881;883;8;381;799;1;0;0;0;0;381;4;377
030602113;700;723;723;8;352;699;1;0;0;0;0;352;2;350
030602114;600;635;635;13;273;599;1;0;0;0;0;273;5;268
030602115;900;888;890;7;417;899;1;0;0;0;0;417;4;413
030602116;700;746;746;10;336;700;0;0;0;0;0;336;6;330
030602117;800;844;844;11;404;800;0;0;0;0;0;404;3;401
030602118;800;773;775;10;385;799;1;0;0;0;0;385;3;382
030602119;800;797;798;11;410;799;1;0;0;0;0;410;7;403
030602120;1000;960;961;8;467;999;1;0;0;0;0;467;8;459
030602121;800;796;796;8;359;799;1;0;0;0;0;359;6;353
030602122;900;856;860;9;394;899;1;0;0;0;0;394;8;386
030602123;900;920;923;11;476;899;1;0;0;0;0;476;3;473
030602124;800;837;837;13;410;799;1;0;0;0;0;410;2;408
030602125;800;851;852;10;409;799;1;0;0;0;0;409;12;397
030602126;900;854;853;7;351;899;1;0;0;0;0;351;2;349
030602127;700;734;738;11;291;699;1;0;0;0;0;291;2;289
030602128;800;780;781;9;339;799;1;0;0;0;0;339;4;335
030602129;800;850;843;10;398;799;1;0;0;0;0;398;3;395
030602130;900;880;881;15;447;899;1;0;0;0;0;447;10;437
030602131;900;921;921;12;489;900;0;0;0;0;0;489;7;482
030602132;1000;977;978;8;507;1000;0;0;0;0;0;507;11;496
030602133;700;664;670;22;319;699;1;0;0;0;0;319;6;313
030602134;800;792;793;17;409;799;1;0;0;0;0;409;8;401
030602135;800;796;796;16;425;800;0;0;0;0;0;425;7;418
030602136;700;664;664;19;344;700;0;0;0;0;0;344;8;336
030602137;900;905;906;18;476;899;1;0;0;0;0;476;5;471
030602138;1000;1014;1017;26;555;999;1;0;0;0;0;555;7;548
030602139;900;884;887;21;466;899;1;0;0;0;0;466;7;459
030602140;900;921;921;9;448;900;0;0;0;0;0;448;4;444
030602141;900;923;923;13;487;899;1;0;0;0;0;487;9;478
030602142;1000;976;976;12;461;1000;0;0;0;0;0;461;5;456
030602143;700;730;731;7;315;699;1;0;0;0;0;315;4;311
030602144;700;744;746;9;341;700;0;0;0;0;0;341;6;335
030602145;700;691;693;7;315;699;1;0;0;0;0;315;4;311
030602146;700;741;741;8;363;699;1;0;0;0;0;363;5;358
030602147;800;822;822;8;433;799;1;0;0;0;0;433;7;426
030602148;700;663;665;9;305;700;0;0;0;0;0;305;4;301
030602149;600;646;647;16;348;600;0;0;0;0;0;348;3;345
030602150;800;759;760;14;373;799;1;0;0;0;0;373;3;370
030602151;800;831;832;18;410;799;1;0;0;0;0;410;7;403
030602152;900;895;895;13;416;899;1;0;0;0;0;416;4;412
030602153;600;525;525;22;268;600;0;0;0;0;0;268;5;263
030602154;900;937;937;10;455;899;1;0;0;0;0;455;11;444
030602155;600;646;646;13;285;599;1;0;0;0;0;285;6;279
030602156;600;582;583;12;302;599;1;0;0;0;0;302;3;299
030602157;600;644;645;11;299;598;2;0;0;0;0;299;6;293
030602158;600;593;593;10;280;599;1;0;0;0;0;280;3;277
030602159;600;621;623;10;275;599;1;0;0;0;0;275;3;272
030602160;600;608;611;9;271;599;1;0;0;0;0;271;2;269
030602161;600;624;626;9;283;599;1;0;0;0;0;283;4;279
030602162;600;659;660;9;328;599;1;0;0;0;0;328;4;324
030602163;600;650;652;12;296;599;1;0;0;0;0;296;3;293
030602164;600;654;655;6;304;599;1;0;0;0;0;304;4;300
030602165;800;845;845;8;432;799;1;0;0;0;0;432;5;427
030602166;600;630;632;8;342;600;0;0;0;0;0;342;6;336
030602167;500;237;563;8;245;500;0;0;0;0;0;245;1;244
030602168;700;299;651;8;307;699;1;0;0;0;0;307;5;302
030602169;900;869;870;8;427;900;0;0;0;0;0;427;2;425
030602170;700;726;727;10;351;700;0;0;0;0;0;351;5;346
030602171;1100;1112;1112;7;565;1099;1;0;0;0;0;565;6;559
030602172;1200;1200;1232;9;574;1198;2;0;0;0;0;574;14;560
030602173;500;544;545;7;238;500;0;0;0;0;0;238;4;234
030602174;600;658;658;7;305;599;1;0;0;0;0;305;3;302
030602175;1000;976;978;14;418;1000;0;0;0;0;0;418;6;412
030602176;1000;964;965;11;448;999;1;0;0;0;0;448;7;441
030602177;900;932;935;7;395;899;1;0;0;0;0;395;9;386
030602178;1000;1011;1012;8;443;999;1;0;0;0;0;443;4;439
030602179;900;891;894;5;360;899;1;0;0;0;0;360;7;353
030602180;900;924;925;6;440;899;1;0;0;0;0;440;4;436
030602181;1000;995;997;8;464;999;1;0;0;0;0;464;4;460
030602182;800;761;761;9;367;800;0;0;0;0;0;367;3;364
030602183;900;408;907;16;408;900;0;0;0;0;0;408;13;395
030602184;1000;983;983;9;471;999;1;0;0;0;0;471;9;462
030602185;600;585;624;7;269;599;1;0;0;0;0;269;3;266
030602186;700;624;624;12;322;700;0;0;0;0;0;322;4;318
030602187;700;713;713;14;353;700;0;0;0;0;0;353;4;349
030602188;800;851;852;13;421;799;1;0;0;0;0;421;8;413
030602189;900;877;877;15;451;899;1;0;0;0;0;451;11;440
030602190;800;825;825;11;379;799;1;0;0;0;0;379;3;376
030602191;600;624;627;8;306;599;1;0;0;0;0;306;4;302
030602388;500;536;536;8;247;499;1;0;0;0;0;247;1;246
030602389;600;594;596;8;295;599;1;0;0;0;0;295;7;288
030602390;500;490;490;8;221;499;1;0;0;0;0;221;1;220
030602391;500;477;477;11;248;500;0;0;0;0;0;248;3;245
030602392;500;541;543;5;232;500;0;0;0;0;0;232;2;230
030602394;800;831;831;11;423;799;1;0;0;0;0;423;9;414
030602395;200;70;70;9;79;119;2;79;2;0;77;0;0;0
030602396;200;59;59;18;44;155;1;44;7;1;36;0;0;0
030602397;500;128;128;123;204;292;4;204;4;2;198;0;0;0
030602398;300;25;25;46;60;239;1;60;0;1;59;0;0;0
030602399;400;31;31;105;108;289;3;108;3;0;105;0;0;0
030602400;400;66;66;20;69;330;1;69;0;0;69;0;0;0
030602402;500;57;57;7;58;441;1;58;0;0;58;0;0;0
030602403;100;64;64;8;51;49;0;51;2;0;49;0;0;0
030602404;500;11;11;0;11;489;0;11;0;0;11;0;0;0
030603192;800;830;830;28;379;799;1;0;0;0;0;379;7;372
030603193;900;956;956;7;453;899;1;0;0;0;0;453;8;445
030603194;900;916;918;6;389;900;0;0;0;0;0;389;1;388
030603195;900;890;890;2;364;899;1;0;0;0;0;364;9;355
030603196;800;779;781;6;257;800;0;0;0;0;0;257;6;251
030603197;800;827;827;6;319;799;1;0;0;0;0;319;4;315
030603198;1000;945;947;7;378;1000;0;0;0;0;0;378;4;374
030603199;1000;957;957;5;409;1000;0;0;0;0;0;409;6;403
030603200;800;782;784;8;343;800;0;0;0;0;0;343;7;336
030603201;800;815;816;2;362;799;1;0;0;0;0;362;1;361
030603202;900;871;871;7;348;900;0;0;0;0;0;348;3;345
030603203;900;875;875;6;344;900;0;0;0;0;0;344;2;342
030603204;800;842;842;5;375;799;1;0;0;0;0;375;2;373
030603205;900;872;872;6;351;899;1;0;0;0;0;351;2;349
030603206;700;709;710;9;269;700;0;0;0;0;0;269;5;264
030603207;800;772;775;9;292;799;1;0;0;0;0;292;4;288
030603208;900;877;882;7;370;900;0;0;0;0;0;370;8;362
030603209;900;891;892;11;435;899;1;0;0;0;0;435;7;428
030603210;800;787;787;9;325;800;0;0;0;0;0;325;4;321
030603211;700;694;695;7;257;699;1;0;0;0;0;257;1;256
030603212;800;822;823;8;321;799;1;0;0;0;0;321;7;314
030603213;1098;1098;1098;4;469;1097;1;0;0;0;0;469;7;462
030603214;500;514;514;27;248;499;1;0;0;0;0;248;3;245
030603215;900;910;910;8;474;900;0;0;0;0;0;474;8;466
030603216;600;618;618;2;273;599;1;0;0;0;0;273;5;268
030603217;500;520;520;7;241;499;1;0;0;0;0;241;2;239
030603218;900;946;947;12;424;899;1;0;0;0;0;424;9;415
030603219;500;489;489;6;231;499;1;0;0;0;0;231;5;226
030603220;600;635;635;4;243;599;1;0;0;0;0;243;2;241
030603221;700;731;731;8;325;699;1;0;0;0;0;325;9;316
030603222;400;375;375;6;170;399;1;0;0;0;0;170;2;168
030603223;500;447;448;6;207;499;1;0;0;0;0;207;5;202
030603224;500;497;499;8;225;499;1;0;0;0;0;225;5;220
030603225;400;379;379;6;163;399;1;0;0;0;0;163;2;161
030603226;700;730;730;7;290;699;1;0;0;0;0;290;5;285
030603227;900;872;875;9;420;899;1;0;0;0;0;420;6;414
030603228;700;663;663;6;245;699;1;0;0;0;0;245;6;239
030603229;400;429;430;4;170;399;1;0;0;0;0;170;6;164
030603230;600;635;635;2;267;599;1;0;0;0;0;267;8;259
030603231;600;641;645;6;292;598;2;0;0;0;0;292;3;289
030603232;600;607;609;7;231;599;1;0;0;0;0;231;3;228
030603233;700;671;675;10;306;699;1;0;0;0;0;306;4;302
030603234;700;638;639;8;245;699;1;0;0;0;0;245;3;242
030603235;600;575;575;8;235;599;1;0;0;0;0;235;2;233
030603236;600;566;567;6;216;599;1;0;0;0;0;216;7;209
030603237;900;942;942;8;386;900;0;0;0;0;0;386;4;382
030603238;1000;1052;1056;11;457;1000;0;0;0;0;0;457;6;451
030603239;900;927;930;8;409;900;0;0;0;0;0;409;1;408
030603240;800;745;745;6;337;800;0;0;0;0;0;337;5;332
030603241;700;676;676;10;337;381;2;317;5;0;312;20;0;20
030603242;700;681;682;4;320;700;0;0;0;0;0;320;5;315
030603243;800;763;765;6;365;799;1;0;0;0;0;365;4;361
030603244;800;744;746;8;347;800;0;0;0;0;0;347;4;343
030603245;800;818;818;9;341;799;1;0;0;0;0;341;4;337
030603246;500;500;502;15;216;500;0;0;0;0;0;216;6;210
030603247;400;358;359;5;145;399;1;0;0;0;0;145;2;143
030603248;600;619;619;7;328;599;1;0;0;0;0;328;5;323
030603249;400;433;434;5;195;399;1;0;0;0;0;195;5;190
030603250;700;711;713;9;324;699;1;0;0;0;0;324;7;317
030603251;800;760;762;10;370;799;1;0;0;0;0;370;6;364
030603252;400;445;445;9;210;399;1;0;0;0;0;210;3;207
030603253;600;600;601;7;282;599;1;0;0;0;0;282;2;280
030603254;400;436;436;6;219;399;1;0;0;0;0;219;4;215
030603255;500;498;498;9;229;499;1;0;0;0;0;229;2;227
030603256;500;483;484;8;231;499;1;0;0;0;0;231;2;229
030603257;600;564;565;8;268;600;0;0;0;0;0;268;2;266
030603258;823;823;825;10;389;823;0;0;0;0;0;389;3;386
030603259;500;521;521;8;241;499;1;0;0;0;0;241;1;240
030603260;700;633;635;9;281;699;1;0;0;0;0;281;7;274
030603261;800;793;793;5;379;799;1;0;0;0;0;379;9;370
030603262;800;829;831;8;394;799;1;0;0;0;0;394;4;390
030603263;700;701;703;8;311;699;1;0;0;0;0;311;8;303
030603264;700;732;733;9;316;699;1;0;0;0;0;316;3;313
030603265;400;357;359;5;131;399;1;0;0;0;0;131;1;130
030603266;900;897;898;8;406;899;1;0;0;0;0;406;4;402
030603267;800;789;789;11;346;800;0;0;0;0;0;346;7;339
030603268;700;682;682;9;306;507;2;191;2;3;186;115;0;115
030603269;700;692;693;7;241;700;0;0;0;0;0;241;0;241
030603270;700;642;645;6;176;700;0;0;0;0;0;176;1;175
030603271;800;782;784;7;341;799;1;0;0;0;0;341;5;336
030603272;700;667;667;6;205;700;0;0;0;0;0;205;7;198
030603273;900;888;889;8;93;899;1;0;0;0;0;93;0;93
030603274;800;243;802;7;243;799;1;0;0;0;0;243;1;242
030603275;1000;969;969;6;187;999;1;0;0;0;0;187;2;185
030603276;800;800;801;7;179;800;0;0;0;0;0;179;2;177
030603277;700;691;691;13;326;699;1;0;0;0;0;326;4;322
030603278;700;678;678;9;266;699;1;0;0;0;0;266;4;262
030603279;900;851;851;7;273;900;0;0;0;0;0;273;5;268
030603280;800;756;759;8;113;800;0;0;0;0;0;113;3;110
030603281;900;882;883;13;440;899;1;0;0;0;0;440;8;432
030603282;700;642;642;9;302;395;3;302;2;2;298;0;0;0
030603283;600;600;566;10;287;599;1;0;0;0;0;287;4;283
030603284;700;653;655;11;336;699;1;0;0;0;0;336;2;334
030603285;600;631;631;10;312;599;1;0;0;0;0;312;6;306
030603286;700;723;723;6;343;699;1;0;0;0;0;343;4;339
030603287;500;450;452;6;195;499;1;0;0;0;0;195;4;191
030603288;600;565;565;10;259;599;1;0;0;0;0;259;2;257
030603289;400;387;389;11;170;400;0;0;0;0;0;170;3;167
030603290;800;745;746;11;359;799;1;0;0;0;0;359;6;353
030603393;800;781;782;7;303;799;1;0;0;0;0;303;4;299
030603405;100;52;52;24;67;30;3;67;1;3;63;0;0;0
030603406;100;24;24;16;36;62;2;36;1;3;32;0;0;0
030604291;500;475;475;11;213;499;1;0;0;0;0;213;7;206
030604292;500;525;526;8;212;499;1;0;0;0;0;212;6;206
030604293;500;495;496;8;207;499;1;0;0;0;0;207;1;206
030604294;700;640;640;6;272;700;0;0;0;0;0;272;7;265
030604295;500;499;500;4;184;499;1;0;0;0;0;184;2;182
030604296;600;565;566;5;237;599;1;0;0;0;0;237;6;231
030604297;800;760;762;6;247;800;0;0;0;0;0;247;3;244
030604298;600;569;569;9;97;599;1;0;0;0;0;97;0;97
030604299;800;782;782;7;215;799;1;0;0;0;0;215;4;211
030604300;900;898;902;9;145;899;1;0;0;0;0;145;3;142
030604301;600;610;611;6;248;599;1;0;0;0;0;248;4;244
030604302;600;578;578;10;205;599;1;0;0;0;0;205;3;202
030604303;400;365;365;9;177;399;1;0;0;0;0;177;3;174
030604304;600;541;542;7;240;599;1;0;0;0;0;240;2;238
030604305;400;399;400;5;162;399;1;0;0;0;0;162;3;159
030604306;400;397;397;6;139;399;1;0;0;0;0;139;0;139
030604307;700;711;714;8;246;699;1;0;0;0;0;246;6;240
030604308;600;597;596;7;62;600;0;0;0;0;0;62;0;62
030604309;700;709;709;10;295;699;1;0;0;0;0;295;4;291
030604310;800;757;759;7;307;800;0;0;0;0;0;307;2;305
030604311;900;869;873;5;371;899;1;0;0;0;0;371;2;369
030604312;900;876;876;8;290;899;1;0;0;0;0;290;4;286
030604313;800;761;765;9;315;799;1;0;0;0;0;315;4;311
030604314;700;716;716;4;263;699;1;0;0;0;0;263;4;259
030604315;800;837;838;3;309;799;1;0;0;0;0;309;2;307
030604316;700;699;699;6;300;699;1;0;0;0;0;300;1;299
030604317;700;690;690;5;289;699;1;0;0;0;0;289;3;286
030604318;700;647;647;8;259;699;1;0;0;0;0;259;2;257
030604319;700;655;655;5;282;699;1;0;0;0;0;282;6;276
030604320;700;692;692;1;298;699;1;0;0;0;0;298;6;292
030604321;600;608;609;5;251;599;1;0;0;0;0;251;1;250
030604322;600;630;631;7;280;599;1;0;0;0;0;280;2;278
030604323;700;646;646;4;267;700;0;0;0;0;0;267;1;266
030604324;800;813;813;6;271;799;1;0;0;0;0;271;3;268
030604325;700;727;729;6;255;699;1;0;0;0;0;255;2;253
030604326;800;820;820;8;379;799;1;0;0;0;0;379;6;373
030604327;700;645;646;8;282;699;1;0;0;0;0;282;6;276
030604328;400;371;372;2;161;399;1;0;0;0;0;161;0;161
030604329;400;422;422;4;189;399;1;0;0;0;0;189;1;188
030604330;400;419;419;6;161;399;1;0;0;0;0;161;1;160
030604331;500;456;457;5;182;499;1;0;0;0;0;182;4;178
030604332;600;554;554;4;237;600;0;0;0;0;0;237;6;231
030604333;700;718;718;7;270;699;1;0;0;0;0;270;4;266
030604334;500;530;530;8;222;499;1;0;0;0;0;222;2;220
030604335;500;445;445;8;196;499;1;0;0;0;0;196;0;196
030604336;700;648;648;8;256;699;1;0;0;0;0;256;4;252
030604337;500;488;488;9;210;500;0;0;0;0;0;210;0;210
030604338;700;724;730;11;272;700;0;0;0;0;0;272;3;269
030604339;400;413;417;7;155;400;0;0;0;0;0;155;5;150
030604340;600;553;554;6;204;600;0;0;0;0;0;204;6;198
030604341;800;831;833;7;346;800;0;0;0;0;0;346;10;336
030604342;500;471;471;4;140;500;0;0;0;0;0;140;1;139
030604343;600;617;617;5;213;599;1;0;0;0;0;213;2;211
030604344;400;436;438;4;114;399;1;0;0;0;0;114;0;114
030604345;700;724;728;8;223;699;1;0;0;0;0;223;6;217
030604346;500;542;542;7;164;499;1;0;0;0;0;164;2;162
030604347;800;762;763;8;268;800;0;0;0;0;0;268;6;262
030604348;400;433;433;6;171;399;1;0;0;0;0;171;3;168
030604349;500;474;474;5;178;499;1;0;0;0;0;178;4;174
030604350;700;682;682;9;265;700;0;0;0;0;0;265;1;264
030604351;500;524;525;8;201;499;1;0;0;0;0;201;5;196
030605352;1000;990;991;6;462;999;1;0;0;0;0;462;7;455
030605353;800;851;852;5;271;799;1;0;0;0;0;271;6;265
030605354;900;921;921;5;428;900;0;0;0;0;0;428;7;421
030605355;800;862;863;10;384;799;1;0;0;0;0;384;7;377
030605356;900;903;903;5;361;899;1;0;0;0;0;361;5;356
030605357;900;878;878;10;365;899;1;0;0;0;0;365;3;362
030605358;700;685;688;7;271;699;1;0;0;0;0;271;3;268
030605359;600;641;642;8;176;599;1;0;0;0;0;176;1;175
030605360;700;732;732;7;220;700;0;0;0;0;0;220;1;219
030605361;1000;994;995;4;113;999;1;0;0;0;0;113;1;112
030605362;800;844;848;14;163;799;1;0;0;0;0;163;5;158
030605363;900;897;896;10;391;899;1;0;0;0;0;391;5;386
030605364;900;858;858;9;380;899;1;0;0;0;0;380;2;378
030605365;900;894;895;10;354;900;0;0;0;0;0;354;4;350
030605366;800;823;825;7;367;799;1;0;0;0;0;367;5;362
030605367;900;865;868;7;330;900;0;0;0;0;0;330;3;327
030605368;900;881;882;8;369;900;0;0;0;0;0;369;6;363
030605369;800;790;793;10;361;799;1;0;0;0;0;361;5;356
030605370;700;696;698;15;335;699;1;0;0;0;0;335;8;327
030605371;800;787;787;5;262;799;1;0;0;0;0;262;3;259
030605372;800;764;766;7;64;800;0;0;0;0;0;64;0;64
030605373;900;850;852;7;259;899;1;0;0;0;0;259;5;254
030605374;900;894;895;5;405;899;1;0;0;0;0;405;5;400
030605375;1000;1022;1025;9;438;999;1;0;0;0;0;438;3;435
030605376;1000;965;968;11;425;999;1;0;0;0;0;425;6;419
030605377;1100;1105;1106;6;482;1099;1;0;0;0;0;482;7;475
030605407;100;22;22;16;34;65;1;34;1;0;33;0;0;0
030800001;800;754;754;6;443;800;0;0;0;0;0;443;13;430
030800002;100;88;88;4;60;39;1;60;2;1;57;0;0;0
030800003;300;247;247;1;136;162;2;136;3;4;129;0;0;0
030800004;400;388;385;3;174;399;1;0;0;0;0;174;0;174
030800005;700;687;689;3;283;699;1;0;0;0;0;283;3;280
030800006;700;654;654;2;212;699;1;0;0;0;0;212;4;208
030800007;200;190;190;3;92;107;1;92;5;1;86;0;0;0
030800008;300;309;309;3;156;143;1;156;3;0;153;0;0;0
030800009;400;420;420;3;159;399;1;0;0;0;0;159;1;158
030800010;200;135;136;4;96;103;1;96;1;1;94;0;0;0
030800011;100;33;33;6;29;70;1;29;1;0;28;0;0;0
030800012;400;391;390;2;212;399;1;0;0;0;0;212;1;211
030800013;400;427;427;1;223;399;1;0;0;0;0;223;5;218
030900001;560;548;552;7;260;560;0;0;0;0;0;260;3;257
030900002;610;598;602;0;236;609;1;0;0;0;0;236;4;232
030900003;600;596;596;1;250;599;1;0;0;0;0;250;5;245
030900004;830;827;828;4;240;829;1;0;0;0;0;240;1;239
030900005;200;200;199;1;87;111;2;87;1;2;84;0;0;0
030900006;150;142;143;6;114;34;2;114;3;1;110;0;0;0
030900007;340;332;334;4;142;339;1;0;0;0;0;142;1;141
030900008;370;361;362;7;148;369;1;0;0;0;0;148;3;145
030900009;100;90;90;8;69;30;1;69;2;0;67;0;0;0
030900010;210;205;206;9;132;77;1;132;6;0;126;0;0;0
030900011;270;262;262;1;111;158;1;111;10;3;98;0;0;0
030900012;600;592;595;4;222;600;0;0;0;0;0;222;0;222
030900013;300;298;299;3;84;215;1;84;4;2;78;0;0;0
030900014;70;63;64;5;52;17;1;52;1;0;51;0;0;0
030900015;240;233;233;4;85;154;1;85;0;0;85;0;0;0
030900016;200;196;198;4;97;102;1;97;4;0;93;0;0;0
030900017;450;440;443;3;215;450;0;0;0;0;0;215;2;213
030900018;80;79;79;3;30;49;1;30;1;0;29;0;0;0
030900019;40;33;35;2;14;25;1;14;0;0;14;0;0;0
030900020;610;594;603;3;198;610;0;0;0;0;0;198;1;197
030900021;210;200;200;5;93;116;1;93;8;0;85;0;0;0
030900022;170;163;163;1;89;80;1;89;2;1;86;0;0;0
030900023;340;340;332;6;69;340;0;0;0;0;0;69;0;69
030900024;350;342;344;2;166;350;0;0;0;0;0;166;5;161
030900025;290;283;284;0;134;154;2;134;7;0;127;0;0;0
030900026;30;20;20;0;20;10;0;20;1;0;19;0;0;0
031300001;600;660;660;4;297;599;1;0;0;0;0;297;1;296
031300002;600;674;675;6;336;599;1;0;0;0;0;336;0;336
031300003;800;841;842;6;269;800;0;0;0;0;0;269;2;267
031300004;800;897;896;0;238;799;1;0;0;0;0;238;3;235
031300005;900;935;936;5;77;899;1;0;0;0;0;77;0;77
031300006;900;991;991;1;180;900;0;0;0;0;0;180;4;176
031300007;800;837;838;2;185;800;0;0;0;0;0;185;3;182
031300008;500;575;575;3;191;500;0;0;0;0;0;191;3;188
031300009;600;699;699;2;173;600;0;0;0;0;0;173;2;171
031300010;600;676;324;5;77;599;1;0;0;0;0;77;0;77
031300011;500;519;521;0;149;500;0;0;0;0;0;149;1;148
031300012;600;566;568;4;141;600;0;0;0;0;0;141;0;141
031300013;600;597;597;5;250;600;0;0;0;0;0;250;1;249
031300014;700;704;704;3;284;700;0;0;0;0;0;284;2;282
031300015;700;679;680;3;258;700;0;0;0;0;0;258;0;258
031300016;200;182;182;6;108;91;1;108;1;1;106;0;0;0
031300017;100;64;64;6;53;46;1;53;2;0;51;0;0;0
031300018;200;202;202;5;120;79;1;120;1;0;119;0;0;0
031300019;100;38;38;8;28;71;1;28;1;0;27;0;0;0
031300020;500;450;450;3;148;500;0;0;0;0;0;148;1;147
031300021;200;153;154;2;82;117;1;82;1;0;81;0;0;0
031300022;557;557;557;2;154;557;0;0;0;0;0;154;0;154
031300023;600;630;630;3;228;600;0;0;0;0;0;228;3;225
031300024;800;811;811;1;113;800;0;0;0;0;0;113;1;112
031300025;700;754;754;2;250;700;0;0;0;0;0;250;1;249
031300026;200;162;162;2;105;93;2;105;7;0;98;0;0;0
031300027;600;620;614;2;251;600;0;0;0;0;0;251;2;249
031300028;300;321;321;4;200;299;1;0;0;0;0;200;2;198
031300029;100;32;40;2;32;67;1;32;3;0;29;0;0;0
031400001;800;781;783;3;182;799;1;0;0;0;0;182;1;181
031400002;1000;1044;1046;1;247;999;1;0;0;0;0;247;1;246
031400003;1000;949;949;2;349;999;1;0;0;0;0;349;2;347
031400004;600;568;571;3;203;599;1;0;0;0;0;203;2;201
031400005;900;845;845;1;256;899;1;0;0;0;0;256;1;255
031400006;700;735;736;6;278;699;1;0;0;0;0;278;4;274
031400007;800;738;740;8;325;799;1;0;0;0;0;325;5;320
031400008;800;780;782;4;373;799;1;0;0;0;0;373;6;367
031400009;700;674;674;18;346;699;1;0;0;0;0;346;5;341
031400010;400;388;388;3;190;399;1;0;0;0;0;190;1;189
031400011;300;241;241;4;192;107;1;192;11;4;177;0;0;0
031600001;500;489;503;8;240;499;1;0;0;0;0;240;0;240
031600002;400;419;426;4;209;399;1;0;0;0;0;209;1;208
031600003;500;587;596;10;275;500;0;0;0;0;0;275;2;273
031600004;800;737;762;8;343;799;1;0;0;0;0;343;1;342
031600005;600;566;577;8;291;599;1;0;0;0;0;291;2;289
031600006;600;563;579;7;285;599;1;0;0;0;0;285;0;285
031600007;500;524;524;5;259;499;1;0;0;0;0;259;1;258
031600008;500;463;475;4;265;500;0;0;0;0;0;265;0;265
031600009;300;184;188;4;119;180;1;119;6;0;113;0;0;0
031600010;200;178;178;2;108;91;1;108;2;0;106;0;0;0
031600011;400;294;296;4;139;260;1;139;7;1;131;0;0;0
031600012;200;169;169;6;105;94;1;105;5;0;100;0;0;0
031600013;100;54;57;7;39;60;1;39;1;1;37;0;0;0
031600014;100;93;93;4;63;36;1;63;0;1;62;0;0;0
031600015;400;431;457;4;188;399;1;0;0;0;0;188;0;188
031600016;700;634;680;3;261;699;1;0;0;0;0;261;5;256
031600017;100;61;61;6;49;50;1;49;1;0;48;0;0;0
031600018;500;472;479;4;189;500;0;0;0;0;0;189;1;188
031600019;400;503;513;7;133;399;1;0;0;0;0;133;0;133
031600020;700;760;760;12;252;699;1;0;0;0;0;252;1;251
031600021;700;827;845;9;290;699;1;0;0;0;0;290;1;289
031600022;700;690;753;7;367;700;0;0;0;0;0;367;3;364
031600023;600;591;591;2;235;599;1;0;0;0;0;235;0;235
031600024;300;310;315;3;152;299;1;0;0;0;0;152;0;152
031600025;600;563;574;5;228;599;1;0;0;0;0;228;1;227
031600026;700;668;668;4;257;699;1;0;0;0;0;257;0;257
031600027;400;424;425;2;96;399;1;0;0;0;0;96;0;96
031600028;100;82;82;0;80;19;1;80;1;0;79;0;0;0
031600029;50;35;35;4;39;11;0;39;0;0;39;0;0;0
031600030;100;93;93;6;99;0;1;99;2;1;96;0;0;0
031600031;150;118;118;7;123;26;1;123;0;0;123;0;0;0
031600032;100;49;49;21;46;53;1;46;11;0;35;0;0;0
032400001;700;666;666;0;233;699;1;0;0;0;0;233;0;233
032400002;550;531;531;7;209;549;1;0;0;0;0;209;3;206
032400003;600;575;578;8;258;599;1;0;0;0;0;258;3;255
032400004;700;717;719;2;262;699;1;0;0;0;0;262;3;259
032400005;600;557;557;6;238;599;1;0;0;0;0;238;4;234
032400006;850;837;840;0;346;849;1;0;0;0;0;346;2;344
032400007;750;741;745;8;345;750;0;0;0;0;0;345;5;340
032400008;550;548;548;4;201;549;1;0;0;0;0;201;1;200
032400009;550;527;529;7;229;549;1;0;0;0;0;229;2;227
032400010;750;764;769;7;324;749;1;0;0;0;0;324;3;321
032400011;750;737;741;9;272;749;1;0;0;0;0;272;3;269
032400012;1000;981;985;9;364;1000;0;0;0;0;0;364;2;362
032400013;750;734;743;8;263;749;1;0;0;0;0;263;3;260
032400014;700;714;716;9;333;699;1;0;0;0;0;333;2;331
032400015;650;624;626;3;213;649;1;0;0;0;0;213;1;212
032400016;600;613;615;0;251;599;1;0;0;0;0;251;3;248
032400017;900;908;914;4;153;899;1;0;0;0;0;153;1;152
032400018;350;330;330;4;155;349;1;0;0;0;0;155;1;154
032400019;680;680;680;5;205;679;1;0;0;0;0;205;2;203
032400020;180;142;142;6;69;110;1;69;2;0;67;0;0;0
032400021;200;177;177;6;106;93;1;106;4;1;101;0;0;0
032400022;80;58;59;5;43;36;1;43;2;0;41;0;0;0
032400023;150;135;135;6;75;74;1;75;2;0;73;0;0;0
032400024;120;97;97;6;74;45;1;74;0;0;74;0;0;0
032400025;120;98;98;6;72;47;1;72;2;0;70;0;0;0
032400026;280;243;243;6;104;174;2;104;5;1;98;0;0;0
032400027;60;43;43;4;33;26;1;33;3;0;30;0;0;0
032400028;700;695;695;5;189;699;1;0;0;0;0;189;0;189
032400029;400;386;386;3;180;399;1;0;0;0;0;180;2;178
032400030;500;509;511;2;179;499;1;0;0;0;0;179;0;179
032400031;250;223;223;4;89;160;1;89;0;0;89;0;0;0
032400032;650;633;639;0;193;649;1;0;0;0;0;193;1;192
032400033;400;392;397;1;147;399;1;0;0;0;0;147;0;147
032400034;50;28;29;6;23;26;1;23;1;0;22;0;0;0
032400035;330;325;327;2;164;165;1;164;4;0;160;0;0;0
032400036;300;318;318;3;142;299;1;0;0;0;0;142;0;142
032400037;700;683;685;2;209;699;1;0;0;0;0;209;0;209
032400038;400;376;376;3;150;399;1;0;0;0;0;150;0;150
032400039;200;162;162;4;112;86;2;112;4;1;107;0;0;0
032400040;250;222;222;4;117;132;1;117;2;0;115;0;0;0
032400041;250;235;236;5;122;127;1;122;12;0;110;0;0;0
032400042;250;249;249;5;153;96;1;153;2;1;150;0;0;0
032400043;50;39;39;7;32;17;1;32;0;1;31;0;0;0
032400044;50;38;38;5;42;7;1;42;3;0;39;0;0;0
032400045;50;34;34;0;33;17;0;33;0;0;33;0;0;0
032400046;50;23;23;8;23;26;1;23;1;0;22;0;0;0
032600001;800;840;845;3;413;799;1;0;0;0;0;413;0;413
032600002;700;739;742;1;301;699;1;0;0;0;0;301;2;299
032600003;800;877;880;2;278;800;0;0;0;0;0;278;1;277
032600004;800;859;862;1;284;799;1;0;0;0;0;284;4;280
032600005;700;705;715;1;310;699;1;0;0;0;0;310;2;308
032600006;600;605;612;7;199;599;1;0;0;0;0;199;3;196
032600007;500;567;567;7;337;500;0;0;0;0;0;337;6;331
032600008;200;222;222;2;84;115;1;84;1;1;82;0;0;0
032600009;200;130;131;5;104;95;1;104;3;0;101;0;0;0
032600010;150;121;120;4;90;59;1;90;1;0;89;0;0;0
032600011;400;307;307;5;249;150;1;249;2;4;243;0;0;0
032600012;200;192;192;5;136;63;1;136;2;0;134;0;0;0
032600013;400;367;367;4;216;183;1;216;5;4;207;0;0;0
032600014;50;32;32;0;31;17;2;31;0;0;31;0;0;0
040400001;600;624;624;10;257;599;1;0;0;0;0;257;3;254
040400002;900;920;920;9;278;622;1;277;5;4;268;1;0;1
040400003;300;792;792;13;204;299;1;0;0;0;0;204;1;203
040400004;500;540;540;10;236;500;0;0;0;0;0;236;2;234
040400005;200;73;73;9;22;177;1;22;0;1;21;0;0;0
040400006;400;387;388;10;172;399;1;0;0;0;0;172;1;171
040400007;500;495;497;11;215;499;1;0;0;0;0;215;4;211
040400008;500;529;529;14;228;499;1;0;0;0;0;228;5;223
040400009;596;596;594;8;238;596;0;0;0;0;0;238;2;236
040400010;500;491;491;5;184;499;1;0;0;0;0;184;5;179
040400011;400;450;451;9;177;399;1;0;0;0;0;177;1;176
040400012;600;624;625;7;249;599;1;0;0;0;0;249;8;241
040400013;600;653;654;12;303;599;1;0;0;0;0;303;2;301
040400014;500;480;480;11;238;499;1;0;0;0;0;238;1;237
040400015;500;480;483;16;225;499;1;0;0;0;0;225;4;221
040400016;400;447;452;11;195;399;1;0;0;0;0;195;1;194
040400017;400;410;412;5;196;399;1;0;0;0;0;196;2;194
040400018;400;434;434;10;227;399;1;0;0;0;0;227;6;221
040400019;500;519;520;10;277;499;1;0;0;0;0;277;4;273
040400020;600;588;588;9;299;598;2;0;0;0;0;299;4;295
040400021;600;607;607;8;282;599;1;0;0;0;0;282;4;278
040400022;500;516;516;7;272;499;1;0;0;0;0;272;7;265
040400023;400;415;416;15;200;399;1;0;0;0;0;200;2;198
040400024;700;683;684;6;297;699;1;0;0;0;0;297;1;296
040400025;800;793;795;4;388;799;1;0;0;0;0;388;7;381
040400026;400;398;399;4;159;399;1;0;0;0;0;159;2;157
040400027;500;477;477;13;232;499;1;0;0;0;0;232;1;231
040400028;400;439;440;8;183;399;1;0;0;0;0;183;2;181
040400029;400;431;432;7;220;399;1;0;0;0;0;220;2;218
040400030;600;648;650;6;283;599;1;0;0;0;0;283;4;279
040400031;500;552;554;8;226;499;1;0;0;0;0;226;3;223
040400032;700;710;713;7;283;699;1;0;0;0;0;283;2;281
040400033;700;683;685;6;301;699;1;0;0;0;0;301;2;299
040400034;700;696;696;8;304;699;1;0;0;0;0;304;3;301
040400035;800;827;829;8;383;799;1;0;0;0;0;383;6;377
040400036;700;720;722;11;319;699;1;0;0;0;0;319;7;312
040400037;600;599;599;7;254;599;1;0;0;0;0;254;3;251
040400038;600;597;600;17;246;599;1;0;0;0;0;246;7;239
040400039;600;630;633;5;307;600;0;0;0;0;0;307;3;304
040400040;700;703;704;8;340;699;1;0;0;0;0;340;6;334
040400041;700;683;683;8;281;699;1;0;0;0;0;281;4;277
040400042;700;718;719;8;342;699;1;0;0;0;0;342;4;338
040400043;600;647;647;10;256;599;1;0;0;0;0;256;4;252
040400044;800;760;761;5;356;799;1;0;0;0;0;356;4;352
040400045;400;456;458;9;181;399;1;0;0;0;0;181;1;180
040400046;500;511;512;11;228;499;1;0;0;0;0;228;3;225
040400047;600;584;585;12;241;599;1;0;0;0;0;241;2;239
040400048;700;674;678;7;260;699;1;0;0;0;0;260;4;256
040400049;700;752;754;20;328;699;1;0;0;0;0;328;9;319
040400050;600;567;568;15;288;599;1;0;0;0;0;288;5;283
040400051;800;813;813;29;367;799;1;0;0;0;0;367;6;361
040400052;800;853;854;12;390;799;1;0;0;0;0;390;8;382
040400053;600;563;565;13;300;599;1;0;0;0;0;300;4;296
040400054;700;754;758;8;296;699;1;0;0;0;0;296;7;289
040400055;600;577;577;14;267;599;1;0;0;0;0;267;3;264
040400056;600;640;640;10;303;599;1;0;0;0;0;303;3;300
040400057;600;579;582;14;252;599;1;0;0;0;0;252;4;248
040400058;800;823;823;15;372;799;1;0;0;0;0;372;6;366
040400059;900;949;953;10;410;899;1;0;0;0;0;410;4;406
040400060;800;764;766;9;361;799;1;0;0;0;0;361;6;355
040400061;800;787;786;12;354;799;1;0;0;0;0;354;4;350
040400062;900;939;944;11;432;899;1;0;0;0;0;432;6;426
040400063;800;800;802;8;321;799;1;0;0;0;0;321;8;313
040400064;900;891;892;5;345;899;1;0;0;0;0;345;1;344
040400065;600;638;638;8;274;368;1;231;3;4;224;43;0;43
040400066;600;562;563;9;225;599;1;0;0;0;0;225;3;222
040400067;900;880;881;3;337;899;1;0;0;0;0;337;5;332
040400068;500;477;477;9;196;499;1;0;0;0;0;196;4;192
040400069;500;462;463;5;155;499;1;0;0;0;0;155;1;154
040400070;700;705;706;10;274;699;1;0;0;0;0;274;4;270
040400071;900;891;891;7;374;899;1;0;0;0;0;374;6;368
040400072;700;700;701;7;336;699;1;0;0;0;0;336;7;329
040400073;700;743;745;5;315;699;1;0;0;0;0;315;4;311
040400074;600;674;674;4;265;599;1;0;0;0;0;265;5;260
040400075;500;474;475;8;197;499;1;0;0;0;0;197;2;195
040400076;600;750;750;5;314;599;1;0;0;0;0;314;5;309
040400077;500;568;569;7;239;499;1;0;0;0;0;239;5;234
040400078;700;715;714;9;267;699;1;0;0;0;0;267;6;261
040400079;600;643;645;10;229;599;1;0;0;0;0;229;4;225
040400080;400;407;408;3;126;399;1;0;0;0;0;126;2;124
040400081;600;744;746;7;246;599;1;0;0;0;0;246;5;241
040400082;100;53;53;6;36;63;1;36;7;1;28;0;0;0
040400083;600;600;601;7;229;599;1;0;0;0;0;229;8;221
040400084;700;793;793;7;393;699;1;0;0;0;0;393;9;384
040400085;700;811;811;10;395;700;0;0;0;0;0;395;9;386
040400086;400;380;380;10;169;399;1;0;0;0;0;169;4;165
040400087;400;359;359;8;170;399;1;0;0;0;0;170;2;168
040400088;500;487;487;14;226;499;1;0;0;0;0;226;1;225
040400089;600;610;610;8;306;599;1;0;0;0;0;306;3;303
040400090;600;563;563;8;216;599;1;0;0;0;0;216;4;212
040400091;500;465;465;7;190;499;1;0;0;0;0;190;5;185
040400092;500;541;540;7;208;499;1;0;0;0;0;208;5;203
040400095;600;673;673;7;269;599;1;0;0;0;0;269;4;265
040400096;600;576;576;5;138;600;0;0;0;0;0;138;0;138
040400097;200;151;153;5;108;91;1;108;0;2;106;0;0;0
040400098;200;244;244;5;98;101;1;98;6;2;90;0;0;0
040400099;200;249;250;4;119;79;2;119;1;1;117;0;0;0
040400100;300;264;264;3;142;157;1;142;1;1;140;0;0;0
040400101;300;269;269;2;99;200;1;99;1;1;97;0;0;0
040400102;500;492;492;2;210;499;1;0;0;0;0;210;2;208
040400103;300;314;314;0;119;299;1;0;0;0;0;119;1;118
040400104;400;479;479;5;176;400;0;0;0;0;0;176;2;174
040400105;300;254;256;8;179;119;2;179;0;2;177;0;0;0
040400106;400;460;461;4;155;399;1;0;0;0;0;155;1;154
040400107;400;393;394;5;175;399;1;0;0;0;0;175;8;167
040400108;400;397;399;4;160;399;1;0;0;0;0;160;5;155
040400109;300;252;252;4;147;151;2;147;0;3;144;0;0;0
040400110;200;196;196;4;139;59;2;139;2;2;135;0;0;0
040400111;700;725;726;6;280;700;0;0;0;0;0;280;4;276
040400112;400;421;419;5;223;399;1;0;0;0;0;223;6;217
040400113;100;43;43;7;39;60;1;39;1;0;38;0;0;0
040400114;100;97;98;5;59;39;2;59;1;0;58;0;0;0
040400115;100;70;70;6;59;40;1;59;0;1;58;0;0;0
040400116;400;388;388;3;192;206;2;192;4;1;187;0;0;0
040400117;400;363;362;3;205;399;1;0;0;0;0;205;2;203
040400118;100;67;67;9;59;39;2;59;2;0;57;0;0;0
040400119;100;51;51;7;46;53;1;46;0;0;46;0;0;0
040400120;700;678;678;3;294;699;1;0;0;0;0;294;2;292
040400121;500;618;621;7;236;499;1;0;0;0;0;236;2;234
040400122;600;670;673;3;296;599;1;0;0;0;0;296;3;293
040400123;500;596;597;1;233;499;1;0;0;0;0;233;3;230
040400124;500;625;625;9;263;499;1;0;0;0;0;263;4;259
040400125;300;273;273;2;139;159;2;139;3;2;134;0;0;0
040400126;400;436;437;5;210;399;1;0;0;0;0;210;1;209
040400127;200;170;171;3;103;96;1;103;1;1;101;0;0;0
040400128;600;617;618;6;324;599;1;0;0;0;0;324;4;320
040400129;300;274;275;5;150;149;1;150;3;2;145;0;0;0
040400130;700;730;731;3;273;700;0;0;0;0;0;273;7;266
040400131;500;593;596;3;207;499;1;0;0;0;0;207;1;206
040400132;600;643;646;1;208;600;0;0;0;0;0;208;3;205
040400133;200;117;117;6;98;101;1;98;2;3;93;0;0;0
040400134;200;139;141;6;88;111;1;88;0;0;88;0;0;0
040400135;100;56;56;6;39;60;1;39;1;1;37;0;0;0
040400137;100;42;42;7;43;56;1;43;0;2;41;0;0;0
040400138;100;57;57;5;57;42;1;57;1;0;56;0;0;0
040400139;100;66;66;6;62;37;1;62;0;0;62;0;0;0
040400140;100;51;52;4;43;56;1;43;3;0;40;0;0;0
040400141;200;179;180;6;140;59;1;140;2;2;136;0;0;0
040400142;100;29;29;7;23;75;2;23;0;0;23;0;0;0
040400143;100;33;33;5;38;62;0;38;1;0;37;0;0;0
040400144;100;35;35;64;78;21;1;78;1;3;74;0;0;0
040400147;100;40;40;18;46;53;1;46;7;2;37;0;0;0
040400149;100;16;16;18;33;64;3;33;2;1;30;0;0;0
040400150;100;24;24;33;43;56;1;43;0;1;42;0;0;0
040600002;700;730;730;7;343;699;1;0;0;0;0;343;3;340
040600004;400;471;473;7;210;399;1;0;0;0;0;210;1;209
040600005;600;650;652;11;310;599;1;0;0;0;0;310;2;308
040600006;600;605;605;8;237;599;1;0;0;0;0;237;2;235
040600007;500;527;528;10;270;499;1;0;0;0;0;270;3;267
040600008;600;617;618;7;289;599;1;0;0;0;0;289;5;284
040600009;600;625;628;9;253;599;1;0;0;0;0;253;3;250
040600010;600;676;677;0;310;599;1;0;0;0;0;310;3;307
040600011;700;693;695;7;325;699;1;0;0;0;0;325;4;321
040600012;600;636;637;9;289;599;1;0;0;0;0;289;8;281
040600013;700;758;760;6;291;699;1;0;0;0;0;291;3;288
040600014;600;584;585;8;227;599;1;0;0;0;0;227;1;226
040600015;700;718;728;8;230;699;1;0;0;0;0;230;1;229
040600016;600;657;658;6;255;599;1;0;0;0;0;255;3;252
040600018;600;630;633;7;271;599;1;0;0;0;0;271;1;270
040600019;500;567;568;11;252;499;1;0;0;0;0;252;3;249
040600020;600;586;587;3;237;599;1;0;0;0;0;237;3;234
040600021;600;580;582;9;239;599;1;0;0;0;0;239;1;238
040600022;600;614;617;5;253;599;1;0;0;0;0;253;0;253
040600024;300;342;343;4;130;299;1;0;0;0;0;130;2;128
040600025;600;584;586;9;252;599;1;0;0;0;0;252;2;250
040600026;800;842;843;5;375;800;0;0;0;0;0;375;3;372
040600028;800;770;771;4;326;799;1;0;0;0;0;326;1;325
040600029;600;636;638;6;252;599;1;0;0;0;0;252;5;247
040600030;500;541;541;6;180;499;1;0;0;0;0;180;1;179
040600031;800;769;770;6;322;799;1;0;0;0;0;322;6;316
040600032;700;741;743;4;309;699;1;0;0;0;0;309;4;305
040600033;600;625;627;6;274;600;0;0;0;0;0;274;5;269
040600035;600;600;601;4;233;599;1;0;0;0;0;233;4;229
040600036;700;706;709;3;279;699;1;0;0;0;0;279;5;274
040600037;600;602;603;6;288;599;1;0;0;0;0;288;4;284
040600038;700;745;746;10;299;699;1;0;0;0;0;299;5;294
040600039;700;704;705;4;261;699;1;0;0;0;0;261;1;260
040600041;600;609;612;6;211;599;1;0;0;0;0;211;3;208
040600042;800;787;791;5;290;799;1;0;0;0;0;290;4;286
040600043;600;663;663;5;265;599;1;0;0;0;0;265;3;262
040600045;600;655;656;6;224;599;1;0;0;0;0;224;3;221
040600046;700;748;750;5;297;699;1;0;0;0;0;297;4;293
040600047;100;11;11;26;32;67;1;32;1;0;31;0;0;0
040600050;800;796;796;9;259;799;1;0;0;0;0;259;0;259
040600051;700;726;726;7;261;699;1;0;0;0;0;261;5;256
040600052;600;605;605;8;219;599;1;0;0;0;0;219;2;217
040600053;700;728;731;10;162;699;1;0;0;0;0;162;2;160
040600054;600;660;660;10;134;599;1;0;0;0;0;134;3;131
040600058;400;464;468;1;217;400;0;0;0;0;0;217;4;213
040600059;600;678;681;7;303;599;1;0;0;0;0;303;2;301
040600060;600;644;645;5;301;599;1;0;0;0;0;301;7;294
040600061;800;832;834;8;406;799;1;0;0;0;0;406;8;398
040600063;800;825;826;5;327;800;0;0;0;0;0;327;8;319
040600065;800;815;815;6;332;799;1;0;0;0;0;332;2;330
040600066;600;673;675;4;205;599;1;0;0;0;0;205;0;205
040600067;500;563;564;1;209;499;1;0;0;0;0;209;3;206
040600068;500;518;518;3;195;499;1;0;0;0;0;195;3;192
040600069;600;670;670;1;277;599;1;0;0;0;0;277;4;273
040600070;600;653;655;1;240;599;1;0;0;0;0;240;1;239
040600071;800;851;851;4;196;800;0;0;0;0;0;196;1;195
040600072;300;288;288;3;126;173;1;126;4;2;120;0;0;0
040600073;500;546;547;2;114;499;1;0;0;0;0;114;0;114
040600074;700;730;732;6;153;699;1;0;0;0;0;153;0;153
040600075;600;632;634;4;200;600;0;0;0;0;0;200;2;198
040600076;500;592;592;3;170;500;0;0;0;0;0;170;0;170
040600077;300;228;228;4;102;197;1;102;5;1;96;0;0;0
040600078;100;88;89;5;28;71;1;28;0;0;28;0;0;0
040600079;400;442;443;3;125;399;1;0;0;0;0;125;0;125
040600081;100;80;97;7;57;42;1;57;0;0;57;0;0;0
040600082;300;279;279;5;146;153;1;146;7;0;139;0;0;0
040600083;100;43;43;0;43;56;1;43;0;0;43;0;0;0
041300001;500;798;801;0;304;499;1;0;0;0;0;304;7;297
041300002;500;828;829;5;377;499;1;0;0;0;0;377;11;366
041300003;500;875;875;10;382;499;1;0;0;0;0;382;5;377
041300004;500;747;747;2;315;499;1;0;0;0;0;315;2;313
041300005;500;635;635;2;207;499;1;0;0;0;0;207;5;202
041300006;500;849;849;3;273;499;1;0;0;0;0;273;4;269
041300010;200;282;284;8;170;29;1;170;9;1;160;0;0;0
041300011;100;65;65;8;54;45;1;54;1;0;53;0;0;0
041300012;100;50;50;8;26;73;1;26;0;0;26;0;0;0
041300013;100;89;89;8;64;35;1;64;2;0;62;0;0;0
041300015;100;58;58;8;51;48;1;51;2;0;49;0;0;0
041300016;100;78;79;7;53;46;1;53;5;1;47;0;0;0
041300017;200;170;171;5;98;101;1;98;4;0;94;0;0;0
041300018;600;943;944;4;323;599;1;0;0;0;0;323;2;321
041300019;100;57;57;7;42;57;1;42;0;1;41;0;0;0
041300020;600;967;968;8;258;599;1;0;0;0;0;258;0;258
041300021;100;86;86;6;55;44;1;55;1;2;52;0;0;0
041300022;100;45;45;8;36;62;2;36;0;0;36;0;0;0
041300023;100;117;117;4;82;18;0;82;6;0;76;0;0;0
041300024;100;95;95;5;69;30;1;69;1;2;66;0;0;0
041300025;100;71;71;5;59;40;1;59;1;0;58;0;0;0
041300026;100;51;51;7;42;57;1;42;0;0;42;0;0;0
041300027;100;60;60;8;45;54;1;45;1;0;44;0;0;0
041300028;100;38;38;6;35;64;1;35;1;1;33;0;0;0
041300029;100;57;57;8;48;50;2;48;0;1;47;0;0;0
041400001;600;753;753;6;275;599;1;0;0;0;0;275;2;273
041400002;700;845;847;0;268;699;1;0;0;0;0;268;0;268
041400003;400;593;594;7;228;399;1;0;0;0;0;228;0;228
041400004;300;358;359;2;190;299;1;0;0;0;0;190;1;189
041400005;400;428;427;4;253;399;1;0;0;0;0;253;1;252
041400006;100;65;64;6;57;42;1;57;3;0;54;0;0;0
041400007;100;57;54;8;35;64;1;35;0;0;35;0;0;0
041400008;100;49;49;6;36;63;1;36;2;2;32;0;0;0
041400009;200;125;125;5;72;127;1;72;0;0;72;0;0;0
041400010;100;89;89;5;64;35;1;64;3;0;61;0;0;0
041400011;200;114;114;6;74;125;1;74;0;2;72;0;0;0
041400012;100;43;40;7;28;71;1;28;0;0;28;0;0;0
041400013;100;48;48;8;41;58;1;41;1;1;39;0;0;0
042000001;600;562;564;9;221;599;1;0;0;0;0;221;2;219
042000002;700;710;712;0;292;699;1;0;0;0;0;292;3;289
042000003;700;654;654;5;290;699;1;0;0;0;0;290;3;287
042000005;700;730;731;1;281;699;1;0;0;0;0;281;7;274
042000006;800;747;747;0;294;799;1;0;0;0;0;294;5;289
042000007;900;960;961;3;422;899;1;0;0;0;0;422;4;418
042000009;700;725;725;2;246;699;1;0;0;0;0;246;4;242
042000010;800;794;795;3;315;799;1;0;0;0;0;315;2;313
042000011;600;570;570;7;263;599;1;0;0;0;0;263;3;260
042000012;700;649;649;7;257;699;1;0;0;0;0;257;1;256
042000014;600;581;581;3;245;599;1;0;0;0;0;245;2;243
042000015;500;405;406;5;175;499;1;0;0;0;0;175;5;170
042000016;600;696;696;3;303;599;1;0;0;0;0;303;7;296
042000018;800;871;872;3;274;799;1;0;0;0;0;274;0;274
042000019;800;726;728;3;296;800;0;0;0;0;0;296;3;293
042000020;700;685;686;5;266;700;0;0;0;0;0;266;4;262
042200001;500;583;583;9;229;499;1;0;0;0;0;229;4;225
042200002;600;626;628;5;260;599;1;0;0;0;0;260;6;254
042200003;400;441;441;1;163;399;1;0;0;0;0;163;2;161
042200004;500;552;553;7;236;499;1;0;0;0;0;236;6;230
042200005;400;422;423;4;180;399;1;0;0;0;0;180;5;175
042200006;600;678;680;5;276;599;1;0;0;0;0;276;6;270
042200007;700;776;777;6;282;699;1;0;0;0;0;282;9;273
042200008;400;473;475;5;189;399;1;0;0;0;0;189;4;185
042200009;600;639;641;9;159;599;1;0;0;0;0;159;7;152
042200010;600;631;636;5;102;600;0;0;0;0;0;102;0;102
042200011;800;893;895;7;192;799;1;0;0;0;0;192;3;189
042200012;600;567;567;12;252;599;1;0;0;0;0;252;0;252
042200013;500;561;566;9;259;499;1;0;0;0;0;259;6;253
042200014;500;596;596;8;216;499;1;0;0;0;0;216;2;214
042200015;100;30;30;24;30;70;0;30;1;0;29;0;0;0
042200016;600;604;605;6;275;599;1;0;0;0;0;275;3;272
042200017;500;587;591;8;223;499;1;0;0;0;0;223;4;219
042200021;600;674;675;5;115;599;1;0;0;0;0;115;2;113
042200022;600;628;630;0;216;599;1;0;0;0;0;216;0;216
042200023;700;722;723;0;233;699;1;0;0;0;0;233;6;227
042200024;600;650;651;1;145;599;1;0;0;0;0;145;5;140
042200025;800;811;813;0;133;799;1;0;0;0;0;133;4;129
042200026;200;203;205;6;114;85;1;114;0;2;112;0;0;0
042200027;600;676;680;4;212;599;1;0;0;0;0;212;2;210
042200028;400;429;430;0;121;399;1;0;0;0;0;121;1;120
042200029;300;340;340;2;139;299;1;0;0;0;0;139;0;139
042200030;400;456;456;2;140;400;0;0;0;0;0;140;1;139
042200031;200;276;277;1;139;60;1;139;4;2;133;0;0;0
042200032;300;303;304;2;127;172;1;127;4;2;121;0;0;0
042200033;700;746;755;2;318;699;1;0;0;0;0;318;3;315
042200034;100;30;30;4;12;87;1;12;1;1;10;0;0;0
042200035;300;345;349;3;160;300;0;0;0;0;0;160;4;156
042200036;400;466;466;1;164;399;1;0;0;0;0;164;2;162
042200037;200;113;113;5;77;122;1;77;2;1;74;0;0;0
042200038;300;392;397;1;139;299;1;0;0;0;0;139;0;139
042200039;600;676;680;3;252;599;1;0;0;0;0;252;0;252
042200040;200;118;118;4;89;110;1;89;1;1;87;0;0;0
042200041;300;334;335;0;148;299;1;0;0;0;0;148;1;147
042200042;200;129;129;6;94;105;1;94;2;1;91;0;0;0
042200043;200;250;251;6;126;72;2;126;3;1;122;0;0;0
042200044;500;588;588;3;123;499;1;0;0;0;0;123;0;123
042200045;100;14;14;0;14;85;1;14;2;0;12;0;0;0
042600001;400;833;834;6;299;399;1;0;0;0;0;299;2;297
042600002;400;729;729;2;278;121;1;278;3;4;271;0;0;0
042600003;400;765;765;4;236;399;1;0;0;0;0;236;4;232
042600004;500;902;902;4;282;499;1;0;0;0;0;282;5;277
042600005;400;787;792;5;291;399;1;0;0;0;0;291;1;290
042600006;300;640;641;1;235;299;1;0;0;0;0;235;2;233
042600007;0;688;690;1;263;0;0;0;0;0;0;263;1;262
042600008;200;427;427;4;169;199;1;0;0;0;0;169;1;168
042600009;200;209;209;3;97;101;2;97;3;1;93;0;0;0
042600010;300;393;393;5;174;299;1;0;0;0;0;174;1;173
042600011;100;97;98;6;51;48;1;51;0;1;50;0;0;0
042600012;300;490;491;4;170;299;1;0;0;0;0;170;3;167
042600013;300;319;319;3;155;143;2;155;5;2;148;0;0;0
042600014;300;476;477;1;230;299;1;0;0;0;0;230;3;227
042600015;200;162;162;4;137;62;1;137;4;0;133;0;0;0
042600016;300;550;552;3;164;299;1;0;0;0;0;164;1;163
042600017;300;659;660;5;180;299;1;0;0;0;0;180;0;180
042600018;300;625;626;5;185;300;0;0;0;0;0;185;1;184
042600019;400;713;713;0;230;400;0;0;0;0;0;230;1;229
042600020;300;461;461;2;123;299;1;0;0;0;0;123;0;123
042600021;300;634;634;3;226;299;1;0;0;0;0;226;3;223
042600022;100;57;57;11;64;36;0;64;6;0;58;0;0;0
042800001;500;651;651;11;181;499;1;0;0;0;0;181;2;179
042800002;300;429;432;0;175;299;1;0;0;0;0;175;6;169
042800003;400;475;476;4;144;399;1;0;0;0;0;144;2;142
042800005;500;617;617;5;256;499;1;0;0;0;0;256;2;254
042800006;300;439;439;3;201;299;1;0;0;0;0;201;3;198
042800007;500;678;680;1;290;499;1;0;0;0;0;290;6;284
042800009;500;693;695;10;170;499;1;0;0;0;0;170;2;168
042800010;400;562;562;7;179;399;1;0;0;0;0;179;3;176
042800011;400;547;549;6;236;399;1;0;0;0;0;236;2;234
042800012;400;511;512;6;261;399;1;0;0;0;0;261;1;260
042800013;300;472;474;5;227;299;1;0;0;0;0;227;0;227
042800014;300;391;394;5;147;299;1;0;0;0;0;147;3;144
042800016;400;536;536;3;227;399;1;0;0;0;0;227;2;225
042800017;600;764;764;6;340;599;1;0;0;0;0;340;2;338
042800018;500;632;633;9;244;499;1;0;0;0;0;244;3;241
042800019;400;513;513;4;204;399;1;0;0;0;0;204;5;199
042800020;500;671;672;6;286;499;1;0;0;0;0;286;9;277
042800021;600;744;746;7;360;600;0;0;0;0;0;360;5;355
042800022;500;605;608;7;258;499;1;0;0;0;0;258;4;254
042800023;500;628;628;6;208;499;1;0;0;0;0;208;6;202
042800024;500;643;643;6;269;499;1;0;0;0;0;269;6;263
042800025;400;501;502;9;208;399;1;0;0;0;0;208;4;204
042800026;400;592;592;5;248;400;0;0;0;0;0;248;3;245
042800029;100;14;14;16;24;75;1;24;0;0;24;0;0;0
042800030;100;74;52;16;65;34;1;65;12;0;53;0;0;0
042800031;600;764;764;8;297;599;1;0;0;0;0;297;8;289
042800032;500;610;612;6;263;499;1;0;0;0;0;263;7;256
042800033;400;509;512;6;215;399;1;0;0;0;0;215;2;213
042800034;700;1116;1118;7;354;699;1;0;0;0;0;354;5;349
042800035;500;702;702;8;282;499;1;0;0;0;0;282;8;274
042800041;300;434;435;2;143;299;1;0;0;0;0;143;1;142
042800044;200;148;149;2;73;126;1;73;4;0;69;0;0;0
042800047;800;924;926;4;312;799;1;0;0;0;0;312;3;309
042800050;700;796;800;3;312;700;0;0;0;0;0;312;4;308
042800053;300;316;319;1;102;299;1;0;0;0;0;102;1;101
042800056;100;97;97;5;68;31;1;68;0;2;66;0;0;0
042800058;400;481;481;3;236;399;1;0;0;0;0;236;2;234
042800062;800;1022;1023;0;281;799;1;0;0;0;0;281;0;281
042800065;700;812;813;4;231;699;1;0;0;0;0;231;2;229
042800069;530;530;530;1;181;529;1;0;0;0;0;181;2;179
042800070;500;623;626;2;165;499;1;0;0;0;0;165;0;165
042800071;100;21;21;17;37;62;1;37;0;2;35;0;0;0
042800073;500;667;668;4;226;499;1;0;0;0;0;226;1;225
042800074;400;572;574;2;204;399;1;0;0;0;0;204;2;202
042800078;200;205;207;3;66;133;1;66;4;0;62;0;0;0
042800080;400;544;546;2;232;399;1;0;0;0;0;232;2;230
042800083;700;915;921;4;436;699;1;0;0;0;0;436;6;430
042800086;200;214;214;3;97;102;1;97;7;0;90;0;0;0
042800087;500;711;714;4;278;499;1;0;0;0;0;278;3;275
042800088;400;532;532;14;239;399;1;0;0;0;0;239;2;237
042800089;400;533;535;8;239;399;1;0;0;0;0;239;0;239
042800090;500;767;768;5;264;499;1;0;0;0;0;264;6;258
043100001;500;780;781;1;372;499;1;0;0;0;0;372;5;367
043100002;500;325;757;1;326;499;1;0;0;0;0;326;3;323
043100003;500;891;892;1;316;500;0;0;0;0;0;316;3;313
043100004;500;998;999;4;257;499;1;0;0;0;0;257;5;252
043100005;500;916;916;3;309;499;1;0;0;0;0;309;6;303
043100006;400;580;580;3;196;399;1;0;0;0;0;196;1;195
043100007;300;360;360;3;147;299;1;0;0;0;0;147;0;147
043100008;100;73;73;2;62;37;1;62;0;1;61;0;0;0
043100009;300;346;346;3;144;299;1;0;0;0;0;144;0;144
043100010;400;578;579;2;171;399;1;0;0;0;0;171;0;171
043100011;200;224;224;5;104;95;1;104;2;0;102;0;0;0
043100012;200;207;207;3;141;58;1;141;3;1;137;0;0;0
043100013;500;595;596;4;174;499;1;0;0;0;0;174;0;174
043100014;500;663;663;4;211;500;0;0;0;0;0;211;2;209
043100015;500;608;609;8;256;499;1;0;0;0;0;256;1;255
043100016;500;592;592;4;183;500;0;0;0;0;0;183;3;180
043100018;100;30;30;5;25;74;1;25;1;0;24;0;0;0
043100019;200;270;272;2;104;95;1;104;6;0;98;0;0;0
043100020;200;120;120;4;58;140;2;58;2;3;53;0;0;0
043100021;100;55;55;6;44;55;1;44;2;1;41;0;0;0
043100022;200;172;172;0;88;110;2;88;4;1;83;0;0;0
043100023;100;78;78;8;43;56;1;43;0;0;43;0;0;0
043100026;400;531;531;3;167;399;1;0;0;0;0;167;1;166
043100030;400;588;588;1;177;399;1;0;0;0;0;177;1;176
043200001;300;488;494;3;155;299;1;0;0;0;0;155;0;155
043200002;300;577;592;1;194;299;1;0;0;0;0;194;2;192
043200003;300;508;518;4;186;299;1;0;0;0;0;186;4;182
043200004;100;68;69;6;38;61;1;38;2;1;35;0;0;0
043200005;100;47;47;8;34;65;1;34;0;0;34;0;0;0
043200006;100;140;145;6;78;20;2;78;5;0;73;0;0;0
043200007;100;78;80;6;58;41;1;58;0;1;57;0;0;0
043200008;100;81;83;6;50;49;1;50;1;0;49;0;0;0
043200009;100;32;32;0;30;69;1;30;0;0;30;0;0;0
043200010;100;32;32;14;22;77;1;22;4;0;18;0;0;0
050100001;500;529;529;0;179;499;1;0;0;0;0;179;7;172
050100002;400;412;412;5;147;399;1;0;0;0;0;147;3;144
050100003;500;442;442;0;145;499;1;0;0;0;0;145;1;144
050100004;400;349;349;5;136;399;1;0;0;0;0;136;5;131
050100005;500;506;506;0;189;499;1;0;0;0;0;189;5;184
050100006;600;700;702;0;230;599;1;0;0;0;0;230;2;228
050100007;600;701;701;5;221;599;1;0;0;0;0;221;4;217
050100008;700;880;881;6;110;699;1;0;0;0;0;110;1;109
050100009;200;91;92;7;46;153;1;46;1;1;44;0;0;0
050100010;100;72;72;7;60;39;1;60;1;1;58;0;0;0
050100011;200;195;195;4;120;78;2;120;1;2;117;0;0;0
050100012;100;31;31;7;28;71;1;28;0;0;28;0;0;0
050100013;100;61;62;5;35;64;1;35;1;1;33;0;0;0
050100014;200;116;117;6;74;125;1;74;2;5;67;0;0;0
050100015;100;33;33;7;27;71;2;27;1;0;26;0;0;0
050100016;100;35;35;7;27;72;1;27;1;0;26;0;0;0
050100017;200;103;104;5;65;134;1;65;2;0;63;0;0;0
050100018;100;48;48;8;33;66;1;33;0;0;33;0;0;0
050100019;100;50;50;7;26;73;1;26;0;1;25;0;0;0
050300001;400;308;308;2;188;211;1;188;7;4;177;0;0;0
050300002;200;93;93;6;61;138;1;61;0;0;61;0;0;0
050300003;200;66;66;4;35;162;3;35;1;0;34;0;0;0
050300004;100;24;24;7;18;81;1;18;1;0;17;0;0;0
050300005;300;260;260;1;148;151;1;148;5;2;141;0;0;0
050600001;500;530;543;4;286;499;1;0;0;0;0;286;10;276
050600002;500;492;492;4;257;499;1;0;0;0;0;257;7;250
050600003;400;451;468;5;259;399;1;0;0;0;0;259;3;256
050600004;400;456;456;1;208;399;1;0;0;0;0;208;4;204
050600005;300;321;321;3;182;300;0;0;0;0;0;182;3;179
050600006;100;88;91;4;72;27;1;72;1;0;71;0;0;0
050600007;500;500;519;3;233;499;1;0;0;0;0;233;4;229
050600008;300;242;242;3;160;139;1;160;1;2;157;0;0;0
050600009;300;303;310;2;160;138;2;160;3;2;155;0;0;0
050600010;200;206;206;2;130;69;1;130;7;0;123;0;0;0
050600011;300;288;310;3;188;111;1;188;4;2;182;0;0;0
050600012;200;195;210;3;106;92;2;106;2;2;102;0;0;0
050600013;100;70;70;0;68;31;1;68;5;0;63;0;0;0
050600014;100;35;35;0;34;66;0;34;0;0;34;0;0;0
050600015;100;44;44;0;44;55;1;44;5;1;38;0;0;0
050900001;400;333;333;6;48;399;1;0;0;0;0;48;1;47
050900002;500;580;580;7;206;499;1;0;0;0;0;206;3;203
050900003;500;482;482;9;170;499;1;0;0;0;0;170;1;169
050900004;500;484;484;9;164;500;0;0;0;0;0;164;3;161
050900005;500;538;538;7;175;499;1;0;0;0;0;175;5;170
050900006;600;637;637;9;206;599;1;0;0;0;0;206;3;203
050900007;600;632;634;5;188;599;1;0;0;0;0;188;1;187
050900008;500;573;575;7;221;499;1;0;0;0;0;221;7;214
050900009;500;497;497;9;171;499;1;0;0;0;0;171;1;170
050900010;500;700;702;4;237;499;1;0;0;0;0;237;5;232
050900011;400;413;414;3;134;399;1;0;0;0;0;134;2;132
050900012;500;617;617;10;239;499;1;0;0;0;0;239;7;232
050900013;500;623;625;7;232;499;1;0;0;0;0;232;5;227
050900014;500;602;602;7;183;499;1;0;0;0;0;183;1;182
050900015;500;536;536;5;171;499;1;0;0;0;0;171;4;167
050900016;500;568;568;4;128;499;1;0;0;0;0;128;4;124
050900017;500;547;547;9;151;499;1;0;0;0;0;151;2;149
050900018;500;472;474;9;176;500;0;0;0;0;0;176;2;174
050900019;500;461;461;7;134;499;1;0;0;0;0;134;3;131
050900020;500;538;539;7;153;499;1;0;0;0;0;153;2;151
050900021;500;501;501;10;175;499;1;0;0;0;0;175;6;169
050900022;500;608;608;4;213;499;1;0;0;0;0;213;5;208
050900023;500;672;674;7;207;499;1;0;0;0;0;207;1;206
050900024;500;552;552;10;186;499;1;0;0;0;0;186;6;180
050900025;500;562;562;9;209;499;1;0;0;0;0;209;4;205
050900026;500;567;567;10;230;499;1;0;0;0;0;230;3;227
050900027;500;644;645;5;260;499;1;0;0;0;0;260;3;257
050900028;500;694;696;5;240;499;1;0;0;0;0;240;4;236
050900029;500;643;643;5;237;499;1;0;0;0;0;237;2;235
050900030;500;510;513;7;146;499;1;0;0;0;0;146;0;146
050900031;500;615;618;5;217;499;1;0;0;0;0;217;3;214
050900032;500;594;594;9;194;499;1;0;0;0;0;194;4;190
050900033;500;565;567;7;167;499;1;0;0;0;0;167;4;163
050900034;500;516;522;9;152;499;1;0;0;0;0;152;2;150
050900035;500;491;491;7;167;499;1;0;0;0;0;167;0;167
050900036;500;622;622;0;182;499;1;0;0;0;0;182;5;177
050900037;500;517;518;8;168;499;1;0;0;0;0;168;2;166
050900038;500;643;646;9;175;499;1;0;0;0;0;175;5;170
050900039;500;619;619;1;173;499;1;0;0;0;0;173;3;170
050900040;500;687;687;10;189;499;1;0;0;0;0;189;6;183
050900041;500;702;702;10;258;499;1;0;0;0;0;258;6;252
050900042;500;586;587;6;207;499;1;0;0;0;0;207;1;206
050900043;500;642;643;6;194;499;1;0;0;0;0;194;3;191
050900044;500;442;443;8;164;499;1;0;0;0;0;164;0;164
050900045;300;235;236;8;93;206;1;93;0;0;93;0;0;0
050900046;500;514;516;11;202;499;1;0;0;0;0;202;5;197
050900047;500;579;579;5;238;499;1;0;0;0;0;238;1;237
050900048;500;445;448;8;179;499;1;0;0;0;0;179;4;175
050900049;500;536;537;7;217;499;1;0;0;0;0;217;2;215
050900050;500;678;678;8;180;499;1;0;0;0;0;180;5;175
050900051;500;597;597;9;134;365;1;134;3;2;129;0;0;0
050900052;500;692;693;10;183;499;1;0;0;0;0;183;1;182
050900053;500;633;635;8;190;499;1;0;0;0;0;190;2;188
050900054;500;580;581;9;161;499;1;0;0;0;0;161;1;160
050900055;500;510;510;6;138;499;1;0;0;0;0;138;1;137
050900056;500;594;596;9;176;499;1;0;0;0;0;176;3;173
050900057;500;634;636;5;181;499;1;0;0;0;0;181;1;180
050900058;500;621;622;6;207;499;1;0;0;0;0;207;3;204
050900059;500;588;590;6;199;499;1;0;0;0;0;199;3;196
050900060;500;521;522;7;176;499;1;0;0;0;0;176;1;175
050900061;500;655;657;8;166;499;1;0;0;0;0;166;3;163
050900062;500;628;630;6;171;499;1;0;0;0;0;171;6;165
050900063;500;592;593;7;183;499;1;0;0;0;0;183;3;180
050900064;500;619;620;8;155;499;1;0;0;0;0;155;4;151
050900065;500;847;847;10;288;500;0;0;0;0;0;288;3;285
050900066;500;613;613;9;244;499;1;0;0;0;0;244;11;233
050900067;500;662;664;7;241;499;1;0;0;0;0;241;1;240
050900068;500;609;615;10;237;499;1;0;0;0;0;237;5;232
050900069;700;698;698;6;104;699;1;0;0;0;0;104;0;104
050900070;700;728;731;5;132;699;1;0;0;0;0;132;0;132
050900071;700;844;845;5;94;699;1;0;0;0;0;94;1;93
050900072;500;499;499;9;64;499;1;0;0;0;0;64;1;63
050900073;500;601;602;5;54;499;1;0;0;0;0;54;0;54
050900074;500;566;567;3;54;499;1;0;0;0;0;54;0;54
050900075;600;704;704;6;50;599;1;0;0;0;0;50;1;49
050900076;500;139;657;3;139;500;0;0;0;0;0;139;2;137
050900077;300;306;298;8;117;299;1;0;0;0;0;117;2;115
050900078;400;409;409;7;117;399;1;0;0;0;0;117;0;117
050900079;500;783;783;9;235;499;1;0;0;0;0;235;1;234
050900080;400;395;395;9;32;399;1;0;0;0;0;32;0;32
050900081;100;100;100;4;75;24;1;75;0;3;72;0;0;0
050900082;100;64;64;6;54;44;2;54;0;2;52;0;0;0
050900083;200;165;165;3;104;95;1;104;1;0;103;0;0;0
050900084;100;45;45;4;38;60;2;38;1;1;36;0;0;0
050900085;100;64;64;6;56;43;1;56;1;0;55;0;0;0
050900086;100;104;104;5;79;20;1;79;0;0;79;0;0;0
050900087;400;518;539;1;178;399;1;0;0;0;0;178;2;176
050900088;500;650;679;8;257;499;1;0;0;0;0;257;1;256
050900089;100;35;35;8;29;70;1;29;3;2;24;0;0;0
050900090;100;97;97;6;67;32;1;67;0;1;66;0;0;0
050900091;200;216;217;3;112;87;1;112;3;4;105;0;0;0
050900092;400;578;578;3;244;399;1;0;0;0;0;244;6;238
050900093;400;423;423;3;167;399;1;0;0;0;0;167;6;161
050900094;400;405;405;7;160;399;1;0;0;0;0;160;2;158
050900095;500;533;535;6;186;499;1;0;0;0;0;186;1;185
050900096;500;492;494;0;184;499;1;0;0;0;0;184;3;181
050900097;300;247;248;3;96;203;1;96;1;1;94;0;0;0
050900098;300;278;278;2;130;169;1;130;4;1;125;0;0;0
050900099;400;417;439;2;182;399;1;0;0;0;0;182;1;181
050900100;300;367;367;4;195;299;1;0;0;0;0;195;2;193
050900101;300;328;328;4;140;299;1;0;0;0;0;140;0;140
050900102;300;308;308;4;137;162;1;137;2;1;134;0;0;0
050900103;400;404;406;8;193;399;1;0;0;0;0;193;0;193
050900104;100;58;59;4;48;51;1;48;0;0;48;0;0;0
050900105;300;283;284;4;168;131;1;168;1;3;164;0;0;0
050900106;500;581;594;4;202;499;1;0;0;0;0;202;5;197
050900107;300;295;304;5;108;191;1;108;5;0;103;0;0;0
050900108;500;604;607;4;122;499;1;0;0;0;0;122;2;120
050900109;500;583;596;10;152;499;1;0;0;0;0;152;2;150
050900110;200;262;262;5;153;44;3;153;3;2;148;0;0;0
050900111;100;78;78;4;65;34;1;65;0;1;64;0;0;0
050900112;100;128;128;2;72;27;1;72;1;1;70;0;0;0
050900113;100;38;38;5;31;66;3;31;0;0;31;0;0;0
050900114;100;47;47;7;36;63;1;36;2;3;31;0;0;0
050900115;100;75;75;4;52;47;1;52;0;0;52;0;0;0
050900116;100;43;43;4;41;58;1;41;0;0;41;0;0;0
050900117;100;129;129;3;53;46;1;53;0;0;53;0;0;0
050900118;500;549;550;2;152;498;2;0;0;0;0;152;2;150
050900119;200;195;195;4;105;94;1;105;0;1;104;0;0;0
050900120;300;305;305;3;143;155;2;143;0;1;142;0;0;0
050900121;100;40;40;27;35;64;1;35;0;0;35;0;0;0
050900122;100;20;20;8;28;71;1;28;0;1;27;0;0;0
050900123;100;18;18;2;20;79;1;20;1;1;18;0;0;0
050900124;100;17;17;5;22;77;1;22;1;1;20;0;0;0
050900125;100;24;24;4;27;72;1;27;0;0;27;0;0;0
050900126;100;23;23;1;23;74;3;23;1;0;22;0;0;0
050900127;100;26;26;7;33;66;1;33;1;0;32;0;0;0
050900128;100;6;6;8;14;85;1;14;0;0;14;0;0;0
051500001;200;134;134;6;75;124;1;75;0;2;73;0;0;0
051500002;500;534;535;7;260;499;1;0;0;0;0;260;6;254
051500003;500;441;441;3;188;499;1;0;0;0;0;188;0;188
051500004;200;129;129;1;80;119;1;80;3;1;76;0;0;0
051500005;100;57;57;4;42;57;1;42;0;0;42;0;0;0
051500006;100;33;34;8;33;65;2;33;1;0;32;0;0;0
051500007;100;39;40;6;37;61;2;37;1;0;36;0;0;0
051500008;100;30;30;7;30;69;1;30;0;0;30;0;0;0
051500009;100;33;33;7;35;63;2;35;24;0;11;0;0;0
051600001;400;419;426;6;206;399;1;0;0;0;0;206;4;202
051600002;500;550;551;4;278;499;1;0;0;0;0;278;4;274
051600003;100;31;31;5;26;73;1;26;0;0;26;0;0;0
051600004;200;169;169;6;82;117;1;82;2;3;77;0;0;0
051600005;100;24;25;6;20;79;1;20;0;0;20;0;0;0
051600006;100;52;52;4;27;72;1;27;1;1;25;0;0;0
051600007;100;25;26;3;22;77;1;22;0;0;22;0;0;0
051600008;100;67;67;4;36;63;1;36;0;0;36;0;0;0
051600009;100;45;45;7;44;55;1;44;0;0;44;0;0;0
051600010;100;25;25;4;26;73;1;26;0;0;26;0;0;0
051600011;100;25;25;3;27;72;1;27;0;0;27;0;0;0
051600012;200;135;138;0;85;114;1;85;1;3;81;0;0;0
051600013;200;110;110;1;63;136;1;63;0;0;63;0;0;0
051600014;200;146;146;4;84;115;1;84;1;2;81;0;0;0
051600015;400;327;329;1;145;399;1;0;0;0;0;145;1;144
051600016;300;252;252;4;119;180;1;119;3;2;114;0;0;0
051600017;100;41;43;6;34;65;1;34;0;0;34;0;0;0
051600018;100;46;47;7;33;66;1;33;1;0;32;0;0;0
051600019;100;53;54;3;34;65;1;34;0;0;34;0;0;0
051600020;200;131;131;5;70;128;2;70;1;1;68;0;0;0
051600021;700;792;794;2;252;699;1;0;0;0;0;252;3;249
051600022;600;655;655;4;204;599;1;0;0;0;0;204;1;203
051600023;700;708;710;2;182;550;5;145;4;3;138;37;1;36
051600024;100;80;80;3;60;39;1;60;3;0;57;0;0;0
051600025;100;14;14;0;14;85;1;14;1;0;13;0;0;0
051600026;100;12;12;7;19;80;1;19;1;0;18;0;0;0
051600027;100;22;22;5;26;74;0;26;0;0;26;0;0;0
052200001;500;504;504;0;209;499;1;0;0;0;0;209;10;199
052200002;600;588;589;2;252;599;1;0;0;0;0;252;7;245
052200003;500;499;501;1;198;499;1;0;0;0;0;198;2;196
052200004;500;514;514;7;203;499;1;0;0;0;0;203;4;199
052200005;500;496;496;1;168;499;1;0;0;0;0;168;3;165
052200006;100;39;38;8;38;61;1;38;1;0;37;0;0;0
052200007;200;71;71;6;50;147;3;50;2;0;48;0;0;0
052200008;100;53;53;5;45;54;1;45;1;1;43;0;0;0
052200009;100;54;54;5;36;63;1;36;0;0;36;0;0;0
052200010;100;33;32;6;26;73;1;26;1;0;25;0;0;0
052200011;300;238;238;3;130;169;1;130;9;3;118;0;0;0
052200012;300;264;266;3;147;151;2;147;7;0;140;0;0;0
052200013;200;189;189;2;98;101;1;98;2;0;96;0;0;0
052500001;300;314;308;3;154;145;1;154;6;1;147;0;0;0
052500002;100;50;49;6;34;65;1;34;0;0;34;0;0;0
052500003;100;40;40;3;30;69;1;30;1;0;29;0;0;0
052500004;100;73;73;4;48;51;1;48;1;1;46;0;0;0
052500005;200;160;160;2;80;119;1;80;2;0;78;0;0;0
052500006;400;342;343;3;194;400;0;0;0;0;0;194;2;192
052500007;200;95;95;5;63;136;1;63;1;0;62;0;0;0
052500008;100;22;22;3;25;75;0;25;0;1;24;0;0;0
053000001;400;303;316;3;145;254;1;145;5;1;139;0;0;0
053000002;500;440;443;7;185;499;1;0;0;0;0;185;1;184
053000003;400;303;303;2;158;241;1;158;2;3;153;0;0;0
053000004;300;200;206;5;109;189;2;109;1;2;106;0;0;0
053000005;500;462;467;3;179;499;1;0;0;0;0;179;1;178
053000006;300;240;244;1;151;147;2;151;12;2;137;0;0;0
053000007;200;161;162;3;101;98;1;101;5;2;94;0;0;0
053000008;100;31;31;2;33;67;0;33;0;0;33;0;0;0
053300001;600;651;651;4;316;600;0;0;0;0;0;316;0;316
053300002;200;142;143;1;114;85;1;114;5;1;108;0;0;0
053300003;200;134;135;4;99;100;1;99;3;1;95;0;0;0
053300004;300;173;174;0;76;223;1;76;2;0;74;0;0;0
053300005;200;125;127;3;90;109;1;90;4;0;86;0;0;0
053300006;500;518;532;2;242;499;1;0;0;0;0;242;3;239
053300007;600;560;589;4;265;599;1;0;0;0;0;265;1;264
053300008;200;154;154;0;101;98;1;101;4;1;96;0;0;0
053300009;600;589;588;0;141;599;1;0;0;0;0;141;0;141
053300010;200;91;95;4;55;144;1;55;3;2;50;0;0;0
053300011;100;15;15;11;26;73;1;26;0;0;26;0;0;0
053300012;100;29;29;2;30;69;1;30;2;1;27;0;0;0
053300013;100;33;33;2;35;64;1;35;2;0;33;0;0;0
053700001;300;205;205;1;102;197;1;102;2;2;98;0;0;0
053700002;200;155;155;2;82;117;1;82;1;2;79;0;0;0
053700003;100;67;67;5;44;55;1;44;0;0;44;0;0;0
053700004;200;117;117;1;64;135;1;64;1;1;62;0;0;0
053700005;100;26;26;4;24;73;3;24;1;0;23;0;0;0
053700006;200;124;124;5;69;129;2;69;2;1;66;0;0;0
053700007;300;223;223;1;88;210;2;88;2;5;81;0;0;0
053700008;400;275;275;1;95;304;1;95;6;0;89;0;0;0
053700009;200;148;148;5;66;133;1;66;2;0;64;0;0;0
053700010;200;85;85;2;48;151;1;48;0;1;47;0;0;0
060500001;500;463;483;5;231;499;1;0;0;0;0;231;3;228
060500002;600;516;538;3;253;599;1;0;0;0;0;253;7;246
060500003;800;677;705;2;287;799;1;0;0;0;0;287;5;282
060500004;400;318;329;4;157;399;1;0;0;0;0;157;0;157
060500005;400;383;399;2;157;399;1;0;0;0;0;157;2;155
060500006;700;705;705;5;252;700;0;0;0;0;0;252;0;252
060500007;400;398;418;5;180;399;1;0;0;0;0;180;0;180
060500008;300;288;296;6;177;122;1;177;3;2;172;0;0;0
060500009;400;358;358;2;231;168;1;231;8;2;221;0;0;0
060500010;200;195;195;3;116;83;1;116;2;0;114;0;0;0
060500011;100;73;73;3;71;29;0;71;4;0;67;0;0;0
060500012;100;71;71;5;74;26;0;74;2;0;72;0;0;0
060500013;100;32;32;0;32;67;1;32;6;0;26;0;0;0
060800001;500;571;578;2;319;499;1;0;0;0;0;319;4;315
060800002;500;587;594;8;308;499;1;0;0;0;0;308;2;306
060800003;500;503;511;4;234;499;1;0;0;0;0;234;7;227
060800004;500;546;553;2;252;499;1;0;0;0;0;252;4;248
060800005;500;517;526;2;233;500;0;0;0;0;0;233;6;227
060800006;500;515;515;2;281;499;1;0;0;0;0;281;5;276
060800007;500;572;575;4;247;499;1;0;0;0;0;247;3;244
060800008;600;665;679;7;250;599;1;0;0;0;0;250;1;249
060800009;500;532;538;0;245;499;1;0;0;0;0;245;5;240
060800010;500;495;495;1;261;500;0;0;0;0;0;261;2;259
060800011;500;499;506;3;233;499;1;0;0;0;0;233;4;229
060800012;500;511;516;2;263;500;0;0;0;0;0;263;3;260
060800013;500;610;628;0;252;499;1;0;0;0;0;252;1;251
060800014;600;707;718;6;295;599;1;0;0;0;0;295;3;292
060800015;900;1000;1000;2;403;899;1;0;0;0;0;403;0;403
060800016;700;753;758;10;292;699;1;0;0;0;0;292;3;289
060800017;500;601;605;0;297;500;0;0;0;0;0;297;5;292
060800018;400;374;378;3;200;399;1;0;0;0;0;200;1;199
060800019;500;531;539;1;301;499;1;0;0;0;0;301;1;300
060800020;200;160;160;5;121;77;2;121;1;0;120;0;0;0
060800021;500;592;587;5;306;500;0;0;0;0;0;306;4;302
060800022;500;575;598;3;291;499;1;0;0;0;0;291;1;290
060800023;400;323;326;5;190;209;1;190;8;3;179;0;0;0
060800024;400;384;385;2;186;399;1;0;0;0;0;186;1;185
060800025;300;268;278;1;158;140;2;158;2;1;155;0;0;0
060800026;600;619;653;4;311;599;1;0;0;0;0;311;8;303
060800027;500;474;474;3;278;499;1;0;0;0;0;278;2;276
060800028;200;127;127;6;91;107;2;91;0;0;91;0;0;0
060800029;300;208;217;3;146;153;1;146;3;0;143;0;0;0
060800030;700;771;791;3;362;699;1;0;0;0;0;362;5;357
060800031;600;654;654;1;242;599;1;0;0;0;0;242;2;240
060800032;400;448;461;3;245;399;1;0;0;0;0;245;1;244
060800033;400;291;291;4;209;189;2;209;0;0;209;0;0;0
060800034;600;610;615;3;294;599;1;0;0;0;0;294;3;291
060800035;500;629;654;10;323;499;1;0;0;0;0;323;6;317
060800036;600;656;656;3;276;599;1;0;0;0;0;276;6;270
060800037;500;491;501;3;227;499;1;0;0;0;0;227;1;226
060800038;500;589;596;4;247;499;1;0;0;0;0;247;1;246
060800039;400;409;412;4;229;399;1;0;0;0;0;229;0;229
060800040;100;91;91;0;88;11;1;88;4;2;82;0;0;0
060800041;100;69;69;0;69;30;1;69;2;1;66;0;0;0
060800042;100;56;56;0;54;46;0;54;0;1;53;0;0;0
060800043;100;60;60;1;61;37;2;61;1;1;59;0;0;0
060800044;100;62;62;0;60;40;0;60;0;0;60;0;0;0
060800045;100;47;47;3;47;52;1;47;0;0;47;0;0;0
060800046;100;18;18;25;32;67;1;32;0;1;31;0;0;0
061000001;700;831;826;9;248;699;1;0;0;0;0;248;2;246
061000002;800;951;951;7;334;799;1;0;0;0;0;334;5;329
061000003;500;579;579;4;214;499;1;0;0;0;0;214;2;212
061000004;500;600;600;4;193;499;1;0;0;0;0;193;2;191
061000005;500;607;607;4;210;499;1;0;0;0;0;210;2;208
061000006;600;714;706;8;243;599;1;0;0;0;0;243;3;240
061000007;400;538;539;8;223;399;1;0;0;0;0;223;5;218
061000008;400;514;518;8;226;399;1;0;0;0;0;226;3;223
061000009;700;816;817;4;319;699;1;0;0;0;0;319;7;312
061000010;400;462;462;5;153;399;1;0;0;0;0;153;2;151
061000011;400;465;465;5;201;399;1;0;0;0;0;201;6;195
061000012;500;578;578;8;234;500;0;0;0;0;0;234;1;233
061000013;700;816;818;7;361;699;1;0;0;0;0;361;5;356
061000014;600;675;678;8;324;599;1;0;0;0;0;324;3;321
061000015;500;546;546;9;222;499;1;0;0;0;0;222;5;217
061000016;400;534;535;9;257;399;1;0;0;0;0;257;2;255
061000017;800;900;905;6;414;800;0;0;0;0;0;414;7;407
061000018;500;569;569;8;236;499;1;0;0;0;0;236;2;234
061000019;500;621;622;9;282;499;1;0;0;0;0;282;4;278
061000020;600;642;642;7;254;599;1;0;0;0;0;254;3;251
061000021;800;970;973;2;422;799;1;0;0;0;0;422;3;419
061000022;800;940;943;7;442;799;1;0;0;0;0;442;5;437
061000023;700;829;829;4;361;698;2;0;0;0;0;361;11;350
061000024;900;1093;1094;9;498;899;1;0;0;0;0;498;9;489
061000025;500;601;602;8;244;499;1;0;0;0;0;244;1;243
061000026;700;826;828;7;332;699;1;0;0;0;0;332;8;324
061000027;600;736;736;6;380;599;1;0;0;0;0;380;5;375
061000028;600;737;737;5;314;599;1;0;0;0;0;314;5;309
061000029;500;619;619;4;279;499;1;0;0;0;0;279;5;274
061000030;600;714;714;2;288;599;1;0;0;0;0;288;1;287
061000031;500;613;614;5;267;499;1;0;0;0;0;267;7;260
061000032;800;1001;1002;7;416;799;1;0;0;0;0;416;9;407
061000033;500;606;606;8;293;499;1;0;0;0;0;293;6;287
061000034;700;841;841;7;394;699;1;0;0;0;0;394;7;387
061000035;500;609;609;5;266;499;1;0;0;0;0;266;4;262
061000036;600;763;763;11;317;599;1;0;0;0;0;317;5;312
061000037;400;432;432;8;175;399;1;0;0;0;0;175;8;167
061000038;400;530;530;9;209;399;1;0;0;0;0;209;3;206
061000039;800;942;943;5;385;799;1;0;0;0;0;385;6;379
061000040;500;575;577;6;247;499;1;0;0;0;0;247;2;245
061000041;500;598;602;0;259;499;1;0;0;0;0;259;2;257
061000042;700;779;779;3;341;699;1;0;0;0;0;341;3;338
061000043;400;496;496;5;217;399;1;0;0;0;0;217;9;208
061000044;700;786;788;3;303;699;1;0;0;0;0;303;5;298
061000045;400;485;487;4;187;399;1;0;0;0;0;187;1;186
061000046;700;785;788;8;301;699;1;0;0;0;0;301;7;294
061000047;400;489;490;7;213;399;1;0;0;0;0;213;0;213
061000048;400;409;413;6;150;399;1;0;0;0;0;150;2;148
061000049;600;737;737;6;238;599;1;0;0;0;0;238;1;237
061000050;400;493;493;5;163;399;1;0;0;0;0;163;2;161
061000051;500;534;535;5;225;499;1;0;0;0;0;225;3;222
061000052;500;532;535;9;196;499;1;0;0;0;0;196;2;194
061000053;400;411;411;6;118;399;1;0;0;0;0;118;3;115
061000054;700;803;804;3;264;530;1;169;0;2;167;95;1;94
061000055;600;664;664;7;260;599;1;0;0;0;0;260;5;255
061000056;600;663;663;5;221;599;1;0;0;0;0;221;5;216
061000057;600;681;681;8;283;599;1;0;0;0;0;283;6;277
061000058;600;677;679;4;219;599;1;0;0;0;0;219;1;218
061000059;600;638;639;2;265;599;1;0;0;0;0;265;7;258
061000060;600;732;732;4;213;599;1;0;0;0;0;213;4;209
061000061;600;643;644;6;227;599;1;0;0;0;0;227;2;225
061000062;500;623;627;4;182;499;1;0;0;0;0;182;3;179
061000063;600;600;601;5;194;599;1;0;0;0;0;194;3;191
061000064;600;717;718;1;242;599;1;0;0;0;0;242;4;238
061000065;800;898;901;5;285;799;1;0;0;0;0;285;5;280
061000066;700;709;709;6;244;699;1;0;0;0;0;244;3;241
061000067;500;581;581;7;199;499;1;0;0;0;0;199;7;192
061000068;600;725;729;7;291;599;1;0;0;0;0;291;7;284
061000069;900;999;1000;4;374;899;1;0;0;0;0;374;4;370
061000070;700;774;775;3;274;699;1;0;0;0;0;274;2;272
061000071;500;559;562;8;155;499;1;0;0;0;0;155;6;149
061000072;500;584;584;2;193;499;1;0;0;0;0;193;2;191
061000073;500;576;576;5;162;499;1;0;0;0;0;162;2;160
061000074;800;922;922;4;282;799;1;0;0;0;0;282;1;281
061000075;500;611;611;3;204;499;1;0;0;0;0;204;1;203
061000076;900;996;998;9;325;899;1;0;0;0;0;325;5;320
061000077;500;566;571;7;188;499;1;0;0;0;0;188;1;187
061000078;1000;906;908;3;364;999;1;0;0;0;0;364;5;359
061000079;900;830;834;4;265;899;1;0;0;0;0;265;5;260
061000080;500;530;530;13;194;499;1;0;0;0;0;194;6;188
061000081;400;406;406;2;235;399;1;0;0;0;0;235;3;232
061000082;600;566;566;6;277;599;1;0;0;0;0;277;3;274
061000083;700;644;646;1;273;699;1;0;0;0;0;273;0;273
061000084;200;147;150;6;105;94;1;105;1;1;103;0;0;0
061000085;300;308;308;6;202;97;1;202;13;0;189;0;0;0
061000086;400;398;398;2;136;399;1;0;0;0;0;136;1;135
061000087;200;201;201;4;123;76;1;123;1;0;122;0;0;0
061000088;900;864;867;5;273;899;1;0;0;0;0;273;2;271
061000089;400;375;376;3;167;399;1;0;0;0;0;167;0;167
061000090;600;541;542;2;139;600;0;0;0;0;0;139;5;134
061000091;400;412;414;3;162;400;0;0;0;0;0;162;2;160
061000092;100;51;51;3;47;52;1;47;2;0;45;0;0;0
061000093;200;202;202;5;131;68;1;131;3;1;127;0;0;0
061000094;700;636;637;5;237;699;1;0;0;0;0;237;2;235
061000095;800;775;778;3;243;799;1;0;0;0;0;243;1;242
061000096;500;502;502;6;190;500;0;0;0;0;0;190;4;186
061000097;600;571;571;0;199;599;1;0;0;0;0;199;5;194
061000098;300;273;278;4;136;163;1;136;3;1;132;0;0;0
061000099;700;631;637;5;152;699;1;0;0;0;0;152;1;151
061000100;600;583;585;3;109;599;1;0;0;0;0;109;0;109
061000101;600;582;590;6;281;600;0;0;0;0;0;281;1;280
061000102;800;773;775;5;252;799;1;0;0;0;0;252;4;248
061000103;600;575;582;3;197;599;1;0;0;0;0;197;0;197
061000104;100;108;109;2;76;23;1;76;1;1;74;0;0;0
061000105;400;321;322;2;114;399;1;0;0;0;0;114;0;114
061000106;100;28;28;1;28;72;0;28;1;0;27;0;0;0
061000107;100;28;28;6;31;68;1;31;1;0;30;0;0;0
061000108;100;49;49;11;56;43;1;56;6;0;50;0;0;0
061000109;100;29;29;7;27;72;1;27;3;2;22;0;0;0
061000110;100;27;27;25;45;54;1;45;1;0;44;0;0;0
061000111;100;51;51;46;80;18;2;80;3;2;75;0;0;0
062000001;500;635;635;3;301;500;0;0;0;0;0;301;4;297
062000002;600;782;787;5;316;599;1;0;0;0;0;316;5;311
062000003;400;519;521;7;213;399;1;0;0;0;0;213;1;212
062000004;600;758;758;4;364;599;1;0;0;0;0;364;5;359
062000005;500;603;603;6;273;499;1;0;0;0;0;273;6;267
062000006;700;831;831;8;386;699;1;0;0;0;0;386;12;374
062000007;600;307;677;10;317;600;0;0;0;0;0;317;1;316
062000008;600;768;770;5;347;599;1;0;0;0;0;347;9;338
062000009;700;805;807;7;376;699;1;0;0;0;0;376;4;372
062000010;600;808;809;7;406;599;1;0;0;0;0;406;9;397
062000011;800;920;921;9;411;799;1;0;0;0;0;411;10;401
062000012;600;731;734;9;344;599;1;0;0;0;0;344;8;336
062000013;500;651;648;1;143;499;1;0;0;0;0;143;0;143
062000014;500;599;599;7;210;499;1;0;0;0;0;210;3;207
062000016;700;642;645;3;163;699;1;0;0;0;0;163;2;161
062000017;600;513;527;5;207;599;1;0;0;0;0;207;2;205
062000018;500;490;490;5;198;499;1;0;0;0;0;198;4;194
062000019;500;479;480;3;200;499;1;0;0;0;0;200;3;197
062000020;500;484;492;4;190;499;1;0;0;0;0;190;2;188
062000021;500;475;477;1;203;499;1;0;0;0;0;203;3;200
062000022;800;705;705;6;218;799;1;0;0;0;0;218;0;218
062000023;700;599;600;6;73;699;1;0;0;0;0;73;1;72
062000024;800;811;815;5;247;799;1;0;0;0;0;247;0;247
062000025;800;832;831;3;306;799;1;0;0;0;0;306;2;304
062000026;300;314;321;6;169;130;1;169;5;0;164;0;0;0
062000027;100;44;44;0;42;57;1;42;5;0;37;0;0;0
062100001;600;611;612;3;186;599;1;0;0;0;0;186;1;185
062100002;600;615;620;4;218;599;1;0;0;0;0;218;5;213
062100003;700;684;690;4;246;699;1;0;0;0;0;246;2;244
062100004;800;749;751;3;245;799;1;0;0;0;0;245;3;242
062100005;300;251;253;3;107;192;1;107;1;3;103;0;0;0
062100006;200;158;158;2;96;103;1;96;7;1;88;0;0;0
062100007;500;423;427;1;150;499;1;0;0;0;0;150;1;149
062100008;200;183;183;5;84;114;2;84;2;2;80;0;0;0
062100009;200;199;199;7;122;77;1;122;1;0;121;0;0;0
062100010;400;319;331;3;130;399;1;0;0;0;0;130;1;129
062100011;200;118;119;2;65;133;2;65;1;1;63;0;0;0
062100012;600;583;600;5;190;599;1;0;0;0;0;190;1;189
062100013;600;634;638;2;179;599;1;0;0;0;0;179;1;178
062100014;200;166;168;1;100;99;1;100;5;0;95;0;0;0
062100015;500;529;540;4;179;499;1;0;0;0;0;179;0;179
062100016;700;645;670;6;306;699;1;0;0;0;0;306;2;304
062100017;200;126;126;4;85;114;1;85;10;1;74;0;0;0
062100018;200;170;182;2;110;89;1;110;6;1;103;0;0;0
062100019;100;39;39;8;44;56;0;44;0;0;44;0;0;0
062100020;100;32;32;3;35;65;0;35;0;0;35;0;0;0
062100021;100;25;25;1;20;79;1;20;1;0;19;0;0;0
062700001;600;642;642;5;276;599;1;0;0;0;0;276;8;268
062700002;600;681;682;5;261;599;1;0;0;0;0;261;2;259
062700003;600;672;672;4;288;599;1;0;0;0;0;288;3;285
062700004;600;725;725;6;308;599;1;0;0;0;0;308;4;304
062700005;600;630;630;4;289;599;1;0;0;0;0;289;3;286
062700006;600;632;633;9;258;599;1;0;0;0;0;258;1;257
062700007;500;546;549;10;255;499;1;0;0;0;0;255;6;249
062700008;600;690;693;6;300;599;1;0;0;0;0;300;2;298
062700009;600;618;619;7;258;599;1;0;0;0;0;258;2;256
062700010;600;636;639;5;292;599;1;0;0;0;0;292;3;289
062700011;800;822;824;0;311;799;1;0;0;0;0;311;1;310
062700012;800;834;837;4;344;799;1;0;0;0;0;344;1;343
062700013;500;196;524;5;201;499;1;0;0;0;0;201;0;201
062700014;600;681;682;4;249;599;1;0;0;0;0;249;7;242
062700015;500;491;491;2;220;499;1;0;0;0;0;220;1;219
062700016;400;352;352;0;161;399;1;0;0;0;0;161;1;160
062700017;300;236;236;4;105;194;1;105;1;0;104;0;0;0
062700018;200;78;113;3;81;117;2;81;2;1;78;0;0;0
062700019;300;348;348;4;180;299;1;0;0;0;0;180;4;176
062700020;400;402;403;3;173;399;1;0;0;0;0;173;1;172
062700021;300;301;302;3;186;110;4;186;3;0;183;0;0;0
062700022;300;272;272;4;87;212;1;87;0;0;87;0;0;0
062700023;500;633;635;5;225;499;1;0;0;0;0;225;2;223
062700024;600;756;756;7;253;599;1;0;0;0;0;253;4;249
062700025;100;77;77;4;59;40;1;59;1;0;58;0;0;0
062700026;500;444;445;3;175;500;0;0;0;0;0;175;2;173
062700027;300;278;278;2;135;164;1;135;4;1;130;0;0;0
062700028;100;62;62;5;49;50;1;49;1;1;47;0;0;0
062700029;200;101;193;4;105;94;1;105;1;2;102;0;0;0
062700030;300;245;245;3;151;148;1;151;6;1;144;0;0;0
062700031;200;149;149;3;94;105;1;94;4;1;89;0;0;0
062700032;300;248;248;4;150;148;2;150;2;0;148;0;0;0
062700033;500;560;563;5;243;500;0;0;0;0;0;243;3;240
062700034;400;354;354;4;122;399;1;0;0;0;0;122;0;122
062700035;200;112;112;2;87;112;1;87;1;1;85;0;0;0
062700036;100;82;83;6;54;45;1;54;1;0;53;0;0;0
062700037;300;280;280;3;169;129;2;169;7;0;162;0;0;0
062700038;300;270;271;4;166;133;1;166;2;1;163;0;0;0
062700039;100;81;81;4;50;49;1;50;2;1;47;0;0;0
062700040;300;283;284;1;144;155;1;144;3;3;138;0;0;0
062700041;100;50;50;7;36;63;1;36;0;0;36;0;0;0
062700042;300;254;254;5;119;180;1;119;0;0;119;0;0;0
062800001;700;704;706;3;222;699;1;0;0;0;0;222;3;219
062800002;600;617;619;5;262;599;1;0;0;0;0;262;4;258
062800003;700;693;693;2;268;699;1;0;0;0;0;268;4;264
062800004;600;589;589;4;234;599;1;0;0;0;0;234;5;229
062800005;100;16;20;6;16;83;1;16;0;0;16;0;0;0
062800006;200;190;190;3;107;92;1;107;3;2;102;0;0;0
062800007;700;213;682;4;217;699;1;0;0;0;0;217;4;213
062800008;500;558;569;4;255;499;1;0;0;0;0;255;0;255
062800009;500;550;555;2;170;499;1;0;0;0;0;170;1;169
062800010;500;537;547;1;251;499;1;0;0;0;0;251;10;241
062800011;500;497;525;3;208;499;1;0;0;0;0;208;1;207
062800012;100;12;12;0;12;88;0;12;0;1;11;0;0;0
062800013;100;22;22;0;22;77;1;22;0;0;22;0;0;0
062800014;100;17;17;0;16;83;1;16;1;0;15;0;0;0
062800015;100;25;25;2;25;74;1;25;1;0;24;0;0;0
063100001;900;990;996;2;367;899;1;0;0;0;0;367;2;365
063100002;900;951;952;0;349;899;1;0;0;0;0;349;6;343
063100003;800;778;782;5;325;799;1;0;0;0;0;325;7;318
063100004;500;571;574;5;231;499;1;0;0;0;0;231;3;228
063100005;900;948;950;0;374;899;1;0;0;0;0;374;3;371
063100006;500;542;548;1;186;499;1;0;0;0;0;186;2;184
063100007;600;567;570;5;178;599;1;0;0;0;0;178;0;178
063100008;500;514;517;6;216;499;1;0;0;0;0;216;1;215
063100009;500;593;597;6;217;499;1;0;0;0;0;217;4;213
063100010;600;233;625;5;238;599;1;0;0;0;0;238;3;235
063100011;600;554;562;2;135;599;1;0;0;0;0;135;0;135
063100012;500;475;493;1;155;499;1;0;0;0;0;155;4;151
063100013;200;219;219;6;115;84;1;115;4;0;111;0;0;0
063100014;100;113;114;6;69;30;1;69;3;0;66;0;0;0
063100015;500;483;483;1;206;499;1;0;0;0;0;206;2;204
063100016;200;176;178;4;80;119;1;80;4;1;75;0;0;0
063100017;100;21;21;5;26;73;1;26;0;0;26;0;0;0
063100018;100;26;26;0;25;75;0;25;1;0;24;0;0;0
063200001;500;601;602;1;206;499;1;0;0;0;0;206;3;203
063200002;700;756;761;2;351;699;1;0;0;0;0;351;2;349
063200003;400;488;489;1;137;399;1;0;0;0;0;137;0;137
063200004;500;562;565;1;230;499;1;0;0;0;0;230;1;229
063200005;200;175;175;4;115;84;1;115;4;2;109;0;0;0
063200006;400;474;482;2;178;399;1;0;0;0;0;178;0;178
063200007;400;377;380;3;183;400;0;0;0;0;0;183;2;181
063200008;200;128;128;5;80;119;1;80;0;1;79;0;0;0
063200009;300;273;278;0;140;159;1;140;1;2;137;0;0;0
063200010;300;327;337;3;184;299;1;0;0;0;0;184;1;183
063200011;100;47;47;8;43;56;1;43;0;0;43;0;0;0
063200012;100;90;90;2;63;36;1;63;2;5;56;0;0;0
063200013;200;205;205;4;144;55;1;144;0;1;143;0;0;0
063200014;100;36;36;7;37;62;1;37;0;0;37;0;0;0
063200015;300;238;240;2;150;148;2;150;7;1;142;0;0;0
063200016;100;23;23;1;24;76;0;24;4;0;20;0;0;0
063200017;100;28;28;2;30;69;1;30;0;0;30;0;0;0
063200018;100;19;19;12;31;68;1;31;2;0;29;0;0;0
063500001;600;557;565;6;234;600;0;0;0;0;0;234;2;232
063500002;500;533;544;0;237;500;0;0;0;0;0;237;4;233
063500003;100;31;30;2;33;66;1;33;0;0;33;0;0;0
063500004;400;377;380;2;189;400;0;0;0;0;0;189;3;186
063500005;400;379;381;2;143;400;0;0;0;0;0;143;0;143
063500006;500;475;492;0;229;500;0;0;0;0;0;229;1;228
063500007;400;361;365;4;211;400;0;0;0;0;0;211;2;209
063500008;200;185;185;5;92;107;1;92;3;0;89;0;0;0
063500009;300;335;345;0;114;300;0;0;0;0;0;114;0;114
063500010;400;418;418;3;155;400;0;0;0;0;0;155;0;155
063500011;100;63;63;6;44;55;1;44;0;0;44;0;0;0
063500012;100;41;41;0;39;60;1;39;0;0;39;0;0;0
070500001;1000;988;989;6;388;999;1;0;0;0;0;388;7;381
070500002;900;908;908;7;362;899;1;0;0;0;0;362;6;356
070500003;700;717;717;7;251;699;1;0;0;0;0;251;5;246
070500004;400;422;423;11;167;399;1;0;0;0;0;167;3;164
070500005;600;611;611;5;234;599;1;0;0;0;0;234;5;229
070500006;700;712;713;4;261;699;1;0;0;0;0;261;5;256
070500007;600;630;630;5;234;599;1;0;0;0;0;234;7;227
070500008;600;645;648;9;231;599;1;0;0;0;0;231;2;229
070500009;700;649;651;7;205;699;1;0;0;0;0;205;4;201
070500010;800;751;755;8;243;799;1;0;0;0;0;243;2;241
070500011;500;474;477;9;173;499;1;0;0;0;0;173;1;172
070500012;800;831;835;8;288;799;1;0;0;0;0;288;4;284
070500013;600;642;643;5;242;599;1;0;0;0;0;242;4;238
070500014;800;792;792;9;279;799;1;0;0;0;0;279;3;276
070500015;600;581;581;7;244;599;1;0;0;0;0;244;4;240
070500016;600;624;624;6;207;599;1;0;0;0;0;207;3;204
070500017;600;562;564;7;242;599;1;0;0;0;0;242;8;234
070500018;600;567;567;5;204;599;1;0;0;0;0;204;2;202
070500019;800;840;841;7;325;799;1;0;0;0;0;325;9;316
070500020;600;613;614;9;276;599;1;0;0;0;0;276;6;270
070500021;500;547;545;11;232;499;1;0;0;0;0;232;2;230
070500022;600;556;559;6;225;599;1;0;0;0;0;225;1;224
070500023;600;573;574;7;206;599;1;0;0;0;0;206;4;202
070500024;900;933;936;4;330;899;1;0;0;0;0;330;6;324
070500025;700;710;711;6;270;699;1;0;0;0;0;270;3;267
070500026;500;545;541;5;241;499;1;0;0;0;0;241;2;239
070500027;200;159;157;7;67;131;2;67;2;1;64;0;0;0
070500028;500;501;499;5;223;499;1;0;0;0;0;223;4;219
070500029;600;582;583;9;277;599;1;0;0;0;0;277;4;273
070500030;500;484;485;6;222;499;1;0;0;0;0;222;3;219
070500031;400;423;424;6;189;399;1;0;0;0;0;189;5;184
070500032;700;660;662;8;289;699;1;0;0;0;0;289;4;285
070500033;800;779;781;5;328;799;1;0;0;0;0;328;4;324
070500034;700;688;687;5;309;699;1;0;0;0;0;309;4;305
070500035;800;772;768;6;296;799;1;0;0;0;0;296;6;290
070500036;600;597;595;7;235;599;1;0;0;0;0;235;3;232
070500037;700;698;695;6;268;699;1;0;0;0;0;268;3;265
070500038;600;601;603;7;226;599;1;0;0;0;0;226;4;222
070500039;600;610;606;9;202;599;1;0;0;0;0;202;3;199
070500040;500;533;529;8;233;499;1;0;0;0;0;233;4;229
070500041;900;874;876;6;378;899;1;0;0;0;0;378;5;373
070500042;700;724;711;6;208;699;1;0;0;0;0;208;3;205
070500043;700;660;659;5;254;699;1;0;0;0;0;254;1;253
070500044;800;742;743;4;312;799;1;0;0;0;0;312;4;308
070500045;800;770;771;5;303;799;1;0;0;0;0;303;6;297
070500046;800;719;719;8;252;799;1;0;0;0;0;252;5;247
070500047;600;586;587;9;234;599;1;0;0;0;0;234;2;232
070500048;500;476;476;5;209;499;1;0;0;0;0;209;7;202
070500049;700;668;671;8;282;699;1;0;0;0;0;282;3;279
070500050;500;502;503;11;192;499;1;0;0;0;0;192;1;191
070500051;800;794;796;4;269;799;1;0;0;0;0;269;6;263
070500052;600;633;629;4;246;599;1;0;0;0;0;246;2;244
070500053;569;569;569;8;238;568;1;0;0;0;0;238;4;234
070500054;600;605;603;5;211;599;1;0;0;0;0;211;1;210
070500055;400;390;378;18;146;399;1;0;0;0;0;146;3;143
070500056;700;683;677;6;207;699;1;0;0;0;0;207;5;202
070500057;700;668;668;7;277;699;1;0;0;0;0;277;8;269
070500058;600;603;603;8;181;599;1;0;0;0;0;181;2;179
070500059;500;520;521;8;203;499;1;0;0;0;0;203;4;199
070500060;600;612;613;7;261;599;1;0;0;0;0;261;2;259
070500061;600;624;625;9;248;599;1;0;0;0;0;248;4;244
070500062;500;581;583;6;255;499;1;0;0;0;0;255;4;251
070500063;500;451;453;7;227;499;1;0;0;0;0;227;6;221
070500064;600;572;572;8;237;599;1;0;0;0;0;237;3;234
070500065;600;577;577;5;251;600;0;0;0;0;0;251;6;245
070500066;600;614;609;6;267;599;1;0;0;0;0;267;5;262
070500067;400;359;359;8;143;399;1;0;0;0;0;143;0;143
070500068;600;559;561;6;227;599;1;0;0;0;0;227;4;223
070500069;500;481;482;5;162;499;1;0;0;0;0;162;4;158
070500070;600;638;639;7;253;599;1;0;0;0;0;253;8;245
070500071;600;639;637;6;242;599;1;0;0;0;0;242;5;237
070500072;800;801;800;8;307;799;1;0;0;0;0;307;6;301
070500073;800;797;797;4;290;799;1;0;0;0;0;290;5;285
070500074;700;729;732;4;318;699;1;0;0;0;0;318;5;313
070500075;400;402;402;5;146;399;1;0;0;0;0;146;2;144
070500076;600;580;580;5;188;599;1;0;0;0;0;188;0;188
070500077;800;827;824;5;356;799;1;0;0;0;0;356;5;351
070500078;700;655;652;9;196;699;1;0;0;0;0;196;2;194
070500079;400;360;360;8;136;399;1;0;0;0;0;136;3;133
070500080;700;665;665;8;239;699;1;0;0;0;0;239;4;235
070500081;600;552;552;7;217;599;1;0;0;0;0;217;6;211
070500082;150;147;147;6;62;87;1;62;1;1;60;0;0;0
070500083;150;125;125;7;68;78;4;68;3;0;65;0;0;0
070500084;100;65;65;6;60;39;1;60;3;0;57;0;0;0
070500085;100;54;54;7;42;57;1;42;3;3;36;0;0;0
070500086;100;81;81;6;47;52;1;47;0;0;47;0;0;0
070500087;100;84;85;7;72;27;1;72;0;0;72;0;0;0
070500088;300;265;265;5;122;177;1;122;4;1;117;0;0;0
070500089;150;147;147;5;71;77;2;71;3;3;65;0;0;0
070500090;150;124;124;6;72;77;1;72;6;0;66;0;0;0
070500091;150;150;151;5;93;54;3;93;1;2;90;0;0;0
070500092;300;269;265;4;149;150;1;149;6;0;143;0;0;0
070500093;200;190;191;7;94;105;1;94;1;0;93;0;0;0
070500094;100;83;83;7;50;49;1;50;0;0;50;0;0;0
070500095;100;71;71;6;56;43;1;56;1;0;55;0;0;0
070500096;100;59;60;7;46;53;1;46;1;0;45;0;0;0
070500097;600;655;658;7;293;599;1;0;0;0;0;293;2;291
070500098;200;189;191;5;113;86;1;113;2;2;109;0;0;0
070500099;150;118;120;6;81;68;1;81;1;0;80;0;0;0
070500100;300;262;262;5;158;141;1;158;2;3;153;0;0;0
070500101;100;84;84;6;68;31;1;68;2;1;65;0;0;0
070500102;150;118;122;5;80;69;1;80;1;3;76;0;0;0
070500103;150;106;106;6;86;62;2;86;2;0;84;0;0;0
070500104;300;292;293;7;132;166;2;132;3;3;126;0;0;0
070500105;150;136;136;4;106;43;1;106;2;2;102;0;0;0
070500106;600;588;588;5;184;599;1;0;0;0;0;184;6;178
070500107;300;256;256;6;132;167;1;132;2;0;130;0;0;0
070500108;150;131;132;6;82;66;2;82;3;1;78;0;0;0
070500109;200;177;173;6;117;80;3;117;2;1;114;0;0;0
070500110;50;29;29;12;32;17;1;32;4;0;28;0;0;0
070500111;200;37;37;87;97;101;2;97;2;1;94;0;0;0
070500113;100;20;20;15;31;68;1;31;1;0;30;0;0;0
070500117;50;19;19;7;26;23;1;26;2;0;24;0;0;0
071200001;410;406;406;5;156;409;1;0;0;0;0;156;1;155
071200002;541;541;545;2;241;540;1;0;0;0;0;241;1;240
071200003;500;494;497;8;208;499;1;0;0;0;0;208;2;206
071200004;535;535;535;2;199;535;0;0;0;0;0;199;3;196
071200005;414;413;417;0;190;413;1;0;0;0;0;190;2;188
071200006;395;393;394;6;180;394;1;0;0;0;0;180;4;176
071200007;330;327;329;5;134;329;1;0;0;0;0;134;2;132
071200008;656;656;658;7;124;655;1;0;0;0;0;124;0;124
071200009;530;529;531;0;206;529;1;0;0;0;0;206;1;205
071200010;545;544;547;8;212;544;1;0;0;0;0;212;3;209
071200011;640;639;641;3;247;639;1;0;0;0;0;247;2;245
071200012;424;423;424;2;198;423;1;0;0;0;0;198;1;197
071200013;520;518;518;4;169;519;1;0;0;0;0;169;1;168
071200014;505;505;506;4;250;504;1;0;0;0;0;250;4;246
071200015;50;46;46;7;42;7;1;42;5;1;36;0;0;0
071200016;80;76;76;6;42;37;1;42;1;1;40;0;0;0
071200017;50;44;44;7;41;8;1;41;2;0;39;0;0;0
071200018;200;196;197;6;107;92;1;107;5;1;101;0;0;0
071200019;25;24;24;5;16;8;1;16;1;0;15;0;0;0
071200020;95;92;92;5;62;32;1;62;1;2;59;0;0;0
071200021;185;179;179;5;106;78;1;106;2;4;100;0;0;0
071200022;100;97;97;7;58;41;1;58;2;1;55;0;0;0
071200023;35;34;34;7;10;24;1;10;1;0;9;0;0;0
071200025;35;33;33;6;7;27;1;7;0;1;6;0;0;0
072900001;800;847;848;4;207;799;1;0;0;0;0;207;4;203
072900002;500;483;485;8;182;499;1;0;0;0;0;182;2;180
072900003;500;484;485;4;207;499;1;0;0;0;0;207;2;205
072900004;500;494;494;8;235;499;1;0;0;0;0;235;2;233
072900005;700;687;688;1;181;699;1;0;0;0;0;181;1;180
072900006;700;690;691;8;220;699;1;0;0;0;0;220;4;216
072900007;500;492;492;6;105;499;1;0;0;0;0;105;0;105
072900008;900;926;928;6;153;899;1;0;0;0;0;153;1;152
072900009;600;586;587;6;251;599;1;0;0;0;0;251;4;247
072900010;800;746;746;8;341;798;2;0;0;0;0;341;3;338
072900011;800;859;860;12;339;799;1;0;0;0;0;339;7;332
072900012;643;643;645;1;236;642;1;0;0;0;0;236;3;233
072900013;400;510;510;7;249;399;1;0;0;0;0;249;4;245
072900014;700;631;632;7;302;699;1;0;0;0;0;302;5;297
072900015;500;550;550;4;260;499;1;0;0;0;0;260;4;256
072900016;500;486;488;4;220;499;1;0;0;0;0;220;2;218
072900017;700;708;711;6;284;699;1;0;0;0;0;284;9;275
072900018;700;728;729;5;285;699;1;0;0;0;0;285;5;280
072900019;600;557;557;4;188;599;1;0;0;0;0;188;2;186
072900020;700;780;781;5;282;699;1;0;0;0;0;282;6;276
072900021;600;593;593;2;250;598;2;0;0;0;0;250;1;249
072900022;700;760;766;5;289;699;1;0;0;0;0;289;6;283
072900023;800;885;885;8;347;799;1;0;0;0;0;347;4;343
072900024;600;647;648;2;225;599;1;0;0;0;0;225;5;220
072900025;500;554;554;6;225;499;1;0;0;0;0;225;5;220
072900026;600;648;648;0;269;599;1;0;0;0;0;269;2;267
072900027;700;693;695;3;301;699;1;0;0;0;0;301;7;294
072900028;900;889;892;1;329;899;1;0;0;0;0;329;4;325
072900029;900;843;844;4;305;899;1;0;0;0;0;305;6;299
072900030;700;761;763;7;281;699;1;0;0;0;0;281;3;278
072900031;300;253;254;3;104;195;1;104;5;1;98;0;0;0
072900032;700;689;689;6;170;699;1;0;0;0;0;170;1;169
072900033;200;233;233;4;117;81;2;117;14;1;102;0;0;0
072900034;300;273;276;2;134;165;1;134;2;2;130;0;0;0
072900035;200;145;146;3;79;120;1;79;1;0;78;0;0;0
072900036;100;91;91;5;62;36;2;62;3;0;59;0;0;0
072900037;500;508;514;5;230;499;1;0;0;0;0;230;3;227
072900038;400;414;416;6;164;399;1;0;0;0;0;164;1;163
072900039;500;501;501;4;147;499;1;0;0;0;0;147;0;147
072900040;300;313;313;3;148;151;1;148;5;0;143;0;0;0
072900041;400;458;465;6;110;399;1;0;0;0;0;110;3;107
072900042;500;550;553;6;198;499;1;0;0;0;0;198;1;197
072900043;600;608;595;3;143;599;1;0;0;0;0;143;1;142
072900044;100;79;79;3;33;66;1;33;3;0;30;0;0;0
072900045;50;19;20;7;14;35;1;14;0;0;14;0;0;0
072900046;500;497;498;5;190;500;0;0;0;0;0;190;1;189
072900047;400;325;325;3;125;399;1;0;0;0;0;125;0;125
072900048;400;425;425;4;187;400;0;0;0;0;0;187;6;181
072900049;200;168;168;3;65;134;1;65;2;0;63;0;0;0
072900050;200;191;194;4;97;102;1;97;5;0;92;0;0;0
072900051;100;101;101;4;69;30;1;69;1;0;68;0;0;0
072900052;100;78;78;5;64;35;1;64;2;0;62;0;0;0
072900053;200;131;131;3;62;137;1;62;0;0;62;0;0;0
072900054;300;335;334;4;109;299;1;0;0;0;0;109;2;107
072900055;600;571;571;4;213;599;1;0;0;0;0;213;2;211
072900056;600;612;615;4;197;599;1;0;0;0;0;197;1;196
072900057;600;575;576;4;161;599;1;0;0;0;0;161;2;159
072900058;100;77;77;5;36;63;1;36;0;2;34;0;0;0
072900059;300;190;208;5;106;193;1;106;5;3;98;0;0;0
072900060;200;179;188;4;70;129;1;70;1;0;69;0;0;0
072900061;500;512;514;3;206;499;1;0;0;0;0;206;4;202
072900062;100;60;60;3;32;67;1;32;0;0;32;0;0;0
072900063;100;50;50;6;37;62;1;37;0;0;37;0;0;0
072900064;100;66;66;7;35;64;1;35;1;3;31;0;0;0
072900065;100;37;37;6;22;77;1;22;1;0;21;0;0;0
072900066;200;125;125;6;76;123;1;76;3;0;73;0;0;0
072900067;800;774;767;4;283;800;0;0;0;0;0;283;2;281
072900069;50;48;48;3;26;23;1;26;3;0;23;0;0;0
072900070;50;38;38;5;41;8;1;41;0;0;41;0;0;0
072900071;50;13;13;1;13;37;0;13;0;0;13;0;0;0
073500001;500;577;578;8;231;499;1;0;0;0;0;231;4;227
073500002;800;841;841;2;307;799;1;0;0;0;0;307;4;303
073500003;700;726;726;4;285;699;1;0;0;0;0;285;4;281
073500004;800;777;778;7;305;799;1;0;0;0;0;305;2;303
073500005;600;606;607;8;245;599;1;0;0;0;0;245;4;241
073500006;700;665;665;8;227;699;1;0;0;0;0;227;3;224
073500007;600;605;605;7;230;599;1;0;0;0;0;230;6;224
073500008;600;618;619;8;189;599;1;0;0;0;0;189;1;188
073500009;700;713;714;6;276;699;1;0;0;0;0;276;1;275
073500010;600;627;627;9;240;599;1;0;0;0;0;240;3;237
073500011;400;381;382;9;154;399;1;0;0;0;0;154;1;153
073500012;500;529;529;9;176;499;1;0;0;0;0;176;1;175
073500013;600;576;577;5;185;599;1;0;0;0;0;185;0;185
073500014;100;39;39;7;27;72;1;27;0;1;26;0;0;0
073500015;100;32;33;6;22;77;1;22;0;0;22;0;0;0
073500016;100;47;47;7;32;67;1;32;1;2;29;0;0;0
073500017;100;87;87;6;32;65;3;32;0;1;31;0;0;0
073500018;700;699;701;6;254;699;1;0;0;0;0;254;3;251
073500019;800;795;795;7;312;799;1;0;0;0;0;312;9;303
073500020;100;24;24;6;24;75;1;24;4;1;19;0;0;0
080300001;800;1003;1004;9;412;799;1;0;0;0;0;412;4;408
080300002;500;653;655;4;205;499;1;0;0;0;0;205;3;202
080300003;1000;1107;1107;9;84;999;1;0;0;0;0;84;0;84
080300004;600;647;649;5;179;599;1;0;0;0;0;179;3;176
080300005;500;573;574;2;129;499;1;0;0;0;0;129;0;129
080300006;800;803;806;8;307;799;1;0;0;0;0;307;5;302
080300007;900;1095;1096;9;215;898;2;0;0;0;0;215;4;211
080300008;600;610;610;4;248;599;1;0;0;0;0;248;2;246
080300009;600;659;659;7;204;599;1;0;0;0;0;204;2;202
080300010;600;618;618;8;260;599;1;0;0;0;0;260;4;256
080300011;500;598;598;6;274;499;1;0;0;0;0;274;3;271
080300012;800;840;840;7;295;799;1;0;0;0;0;295;1;294
080300013;800;942;945;6;308;799;1;0;0;0;0;308;1;307
080300014;500;532;532;7;228;499;1;0;0;0;0;228;2;226
080300015;100;11;11;10;13;86;1;13;0;0;13;0;0;0
080300016;400;286;286;3;169;230;1;169;6;2;161;0;0;0
080300017;200;116;116;4;28;171;1;28;0;0;28;0;0;0
080300018;400;438;438;5;175;399;1;0;0;0;0;175;0;175
080300019;300;230;230;6;87;212;1;87;0;0;87;0;0;0
080300020;200;120;120;7;44;155;1;44;2;1;41;0;0;0
080300021;300;173;173;4;71;228;1;71;4;0;67;0;0;0
080300022;600;625;627;8;281;599;1;0;0;0;0;281;5;276
080300023;200;99;99;6;62;137;1;62;0;1;61;0;0;0
080300024;300;385;385;3;103;299;1;0;0;0;0;103;0;103
080300025;200;120;120;6;72;127;1;72;2;1;69;0;0;0
080300026;700;779;779;3;285;699;1;0;0;0;0;285;7;278
080300027;1000;1069;1070;1;193;999;1;0;0;0;0;193;1;192
080300028;300;176;176;5;109;190;1;109;1;2;106;0;0;0
080300029;300;174;175;6;44;255;1;44;1;0;43;0;0;0
080300030;500;490;492;5;144;499;1;0;0;0;0;144;1;143
080300031;100;51;51;11;33;66;1;33;4;0;29;0;0;0
080300032;800;791;791;7;302;799;1;0;0;0;0;302;3;299
080300033;300;346;347;3;83;299;1;0;0;0;0;83;0;83
080300034;200;88;88;6;27;172;1;27;1;0;26;0;0;0
080300035;100;49;49;7;17;82;1;17;0;2;15;0;0;0
080300036;400;238;239;3;123;274;3;123;4;1;118;0;0;0
080300037;100;41;41;24;59;40;1;59;3;0;56;0;0;0
080300038;100;20;20;16;35;64;1;35;1;2;32;0;0;0
081200001;600;621;622;7;260;599;1;0;0;0;0;260;2;258
081200002;600;615;615;5;213;599;1;0;0;0;0;213;2;211
081200003;700;698;698;6;256;699;1;0;0;0;0;256;8;248
081200004;700;762;762;3;304;699;1;0;0;0;0;304;1;303
081200005;700;693;694;9;283;699;1;0;0;0;0;283;1;282
081200006;700;758;758;8;253;699;1;0;0;0;0;253;2;251
081200007;700;782;784;7;130;699;1;0;0;0;0;130;3;127
081200008;700;683;684;6;251;699;1;0;0;0;0;251;1;250
081200009;300;294;294;4;138;161;1;138;2;2;134;0;0;0
081200010;100;22;22;4;17;82;1;17;0;1;16;0;0;0
081200011;100;49;49;3;32;67;1;32;1;1;30;0;0;0
081200012;100;41;41;8;23;76;1;23;2;0;21;0;0;0
081200013;300;281;281;5;107;192;1;107;2;0;105;0;0;0
081200014;100;33;33;5;22;77;1;22;0;2;20;0;0;0
081200015;100;61;61;6;17;82;1;17;0;0;17;0;0;0
081200016;100;28;28;4;20;79;1;20;1;0;19;0;0;0
081200017;100;95;96;5;55;44;1;55;0;1;54;0;0;0
081200018;200;124;124;6;79;120;1;79;3;1;75;0;0;0
081200019;100;71;71;6;39;60;1;39;1;0;38;0;0;0
081200020;200;180;180;5;67;132;1;67;3;0;64;0;0;0
081200021;500;652;652;6;71;499;1;0;0;0;0;71;0;71
081200022;100;45;45;8;29;70;1;29;0;0;29;0;0;0
081200023;400;411;411;3;144;399;1;0;0;0;0;144;2;142
081200024;400;387;387;4;128;399;1;0;0;0;0;128;1;127
081200025;100;21;21;5;19;79;2;19;1;1;17;0;0;0
081200026;200;177;178;6;69;130;1;69;4;1;64;0;0;0
081200027;300;319;319;7;58;299;1;0;0;0;0;58;0;58
081200028;400;555;555;7;86;399;1;0;0;0;0;86;1;85
081200029;200;171;171;3;72;127;1;72;3;1;68;0;0;0
081200030;200;160;160;3;72;127;1;72;2;0;70;0;0;0
081200031;100;70;70;7;36;63;1;36;0;1;35;0;0;0
081200032;100;100;52;5;30;69;1;30;0;0;30;0;0;0
081200033;200;189;189;4;75;124;1;75;2;0;73;0;0;0
081200034;300;360;360;7;62;299;1;0;0;0;0;62;1;61
081200035;400;399;399;5;100;399;1;0;0;0;0;100;1;99
081200036;300;227;227;6;68;228;4;68;3;0;65;0;0;0
081200037;100;122;123;6;36;63;1;36;2;0;34;0;0;0
081200038;100;59;59;4;36;63;1;36;2;0;34;0;0;0
081200039;300;349;350;5;81;299;1;0;0;0;0;81;0;81
081200040;100;44;44;6;20;79;1;20;0;0;20;0;0;0
081200041;100;38;76;6;44;55;1;44;1;0;43;0;0;0
081200042;300;233;233;7;75;224;1;75;4;1;70;0;0;0
081200043;300;381;382;5;63;299;1;0;0;0;0;63;0;63
081200044;300;350;351;7;68;299;1;0;0;0;0;68;4;64
081200045;100;50;50;7;17;82;1;17;1;0;16;0;0;0
081200046;100;43;44;5;26;73;1;26;0;0;26;0;0;0
081200047;200;151;151;6;57;142;1;57;4;1;52;0;0;0
081500001;100;96;97;5;60;39;1;60;2;0;58;0;0;0
081500002;300;91;296;5;96;299;1;0;0;0;0;96;0;96
081500003;600;578;578;5;134;599;1;0;0;0;0;134;0;134
081500004;100;45;45;6;36;63;1;36;0;2;34;0;0;0
081500005;700;860;861;8;177;699;1;0;0;0;0;177;1;176
081500006;700;893;894;8;186;699;1;0;0;0;0;186;0;186
081500007;200;140;142;7;82;117;1;82;4;0;78;0;0;0
081500008;900;1098;1098;3;246;899;1;0;0;0;0;246;1;245
081500009;400;377;377;4;128;399;1;0;0;0;0;128;2;126
081500010;500;552;553;8;157;499;1;0;0;0;0;157;2;155
081500011;200;170;170;4;75;124;1;75;2;0;73;0;0;0
081500012;300;364;364;4;115;299;1;0;0;0;0;115;1;114
081500013;50;35;35;8;23;26;1;23;3;0;20;0;0;0
081500014;100;48;48;7;41;57;2;41;1;0;40;0;0;0
081500015;100;79;79;4;57;42;1;57;0;0;57;0;0;0
081500016;100;76;76;6;61;38;1;61;2;0;59;0;0;0
081500017;800;777;778;6;301;799;1;0;0;0;0;301;0;301
081500018;200;163;163;7;70;128;2;70;2;0;68;0;0;0
081500019;50;40;40;9;30;19;1;30;0;0;30;0;0;0
081500020;200;179;179;6;67;132;1;67;5;0;62;0;0;0
081500021;800;716;716;6;286;799;1;0;0;0;0;286;6;280
081500022;200;123;123;6;46;153;1;46;3;0;43;0;0;0
081500023;300;453;453;8;82;299;1;0;0;0;0;82;0;82
081500024;400;353;353;2;81;399;1;0;0;0;0;81;1;80
081500025;200;93;93;7;53;145;2;53;2;0;51;0;0;0
081500026;200;165;165;7;56;143;1;56;1;0;55;0;0;0
081500027;800;892;893;7;234;799;1;0;0;0;0;234;1;233
081500028;400;336;336;6;135;399;1;0;0;0;0;135;0;135
081500029;300;218;218;2;116;183;1;116;4;2;110;0;0;0
081500030;50;30;31;7;29;19;2;29;0;0;29;0;0;0
081500031;600;679;680;6;113;600;0;0;0;0;0;113;1;112
081500032;300;311;311;5;128;171;1;128;0;0;128;0;0;0
081500033;300;281;281;4;85;214;1;85;3;0;82;0;0;0
081500034;100;83;83;9;52;47;1;52;3;0;49;0;0;0
081500035;50;30;30;9;20;29;1;20;0;0;20;0;0;0
081500036;200;163;163;5;86;113;1;86;4;0;82;0;0;0
081500037;100;81;81;8;52;44;4;52;3;1;48;0;0;0
081500038;400;474;474;2;149;399;1;0;0;0;0;149;0;149
081500039;200;176;176;5;117;82;1;117;8;0;109;0;0;0
081500040;500;496;496;5;113;499;1;0;0;0;0;113;0;113
081500041;200;109;109;5;58;141;1;58;2;2;54;0;0;0
081500042;100;70;71;7;46;53;1;46;2;0;44;0;0;0
081500043;500;569;569;8;204;499;1;0;0;0;0;204;1;203
081500044;500;485;485;8;211;499;1;0;0;0;0;211;2;209
081500045;400;478;479;8;112;399;1;0;0;0;0;112;2;110
081500046;150;118;118;5;76;73;1;76;1;1;74;0;0;0
081500047;100;60;60;6;44;55;1;44;3;1;40;0;0;0
081500048;100;53;53;5;41;58;1;41;0;0;41;0;0;0
081500049;100;76;78;6;64;35;1;64;1;0;63;0;0;0
081500050;200;189;189;5;93;106;1;93;1;2;90;0;0;0
081500051;50;51;42;9;34;15;1;34;0;0;34;0;0;0
081500052;200;59;212;6;65;135;0;65;3;0;62;0;0;0
081500053;150;129;129;7;81;68;1;81;2;0;79;0;0;0
081500054;150;122;125;7;61;87;2;61;1;0;60;0;0;0
081500055;200;200;201;6;92;107;1;92;1;0;91;0;0;0
081500056;300;304;311;2;119;299;1;0;0;0;0;119;2;117
081500057;100;56;56;6;37;62;1;37;1;0;36;0;0;0
081500058;700;824;824;5;272;699;1;0;0;0;0;272;1;271
081500059;300;286;286;4;157;142;1;157;2;3;152;0;0;0
081500060;600;697;697;9;230;600;0;0;0;0;0;230;1;229
081500061;500;511;512;9;130;499;1;0;0;0;0;130;0;130
081500062;50;22;22;8;19;30;1;19;1;0;18;0;0;0
081500063;100;121;121;8;46;49;5;46;4;1;41;0;0;0
081500064;800;992;996;7;236;799;1;0;0;0;0;236;2;234
081500065;200;170;170;5;71;128;1;71;0;0;71;0;0;0
081500066;500;342;342;6;145;499;1;0;0;0;0;145;1;144
081500067;700;643;644;6;140;699;1;0;0;0;0;140;1;139
081500068;50;31;31;6;37;12;1;37;0;0;37;0;0;0
081700001;600;603;603;6;268;599;1;0;0;0;0;268;5;263
081700002;800;767;768;5;310;799;1;0;0;0;0;310;10;300
081700003;900;916;916;9;157;899;1;0;0;0;0;157;0;157
081700004;900;926;926;9;185;899;1;0;0;0;0;185;0;185
081700005;700;696;696;7;267;699;1;0;0;0;0;267;2;265
081700006;700;663;663;9;322;699;1;0;0;0;0;322;6;316
081700007;700;687;687;9;259;699;1;0;0;0;0;259;3;256
081700008;600;673;675;7;308;599;1;0;0;0;0;308;3;305
081700009;500;506;507;7;208;499;1;0;0;0;0;208;3;205
081700010;800;781;781;5;320;799;1;0;0;0;0;320;3;317
081700011;600;639;640;9;268;599;1;0;0;0;0;268;2;266
081700012;800;805;806;9;137;799;1;0;0;0;0;137;0;137
081700013;600;641;641;7;244;599;1;0;0;0;0;244;2;242
081700014;615;615;615;3;249;614;1;0;0;0;0;249;1;248
081700015;300;281;281;7;97;202;1;97;2;0;95;0;0;0
081700016;100;87;87;7;53;46;1;53;0;0;53;0;0;0
081700017;500;513;513;4;213;499;1;0;0;0;0;213;10;203
081700018;500;496;496;2;191;499;1;0;0;0;0;191;2;189
081700019;100;89;89;7;37;62;1;37;0;0;37;0;0;0
081700020;200;210;210;7;103;96;1;103;4;3;96;0;0;0
081700021;100;50;51;8;43;56;1;43;1;3;39;0;0;0
081700022;100;65;66;7;45;54;1;45;1;0;44;0;0;0
081700023;100;56;56;8;27;72;1;27;0;0;27;0;0;0
081700024;100;23;24;7;18;81;1;18;0;0;18;0;0;0
081700025;200;178;178;7;46;153;1;46;0;1;45;0;0;0
081700026;100;92;92;8;41;58;1;41;1;0;40;0;0;0
081700027;100;81;81;7;28;71;1;28;0;0;28;0;0;0
081700028;300;33;356;4;37;299;1;0;0;0;0;37;0;37
081700029;200;160;160;7;64;135;1;64;2;2;60;0;0;0
081700030;100;65;65;8;42;57;1;42;0;0;42;0;0;0
081700031;100;52;52;7;30;69;1;30;0;0;30;0;0;0
082000001;600;637;638;5;203;599;1;0;0;0;0;203;5;198
082000002;400;369;371;3;75;399;1;0;0;0;0;75;0;75
082000003;350;310;310;7;68;349;1;0;0;0;0;68;0;68
082000004;300;282;282;5;90;299;1;0;0;0;0;90;0;90
082000005;150;98;98;6;51;98;1;51;3;0;48;0;0;0
082000006;700;685;685;6;113;699;1;0;0;0;0;113;0;113
082000007;400;321;322;7;132;399;1;0;0;0;0;132;0;132
082000008;100;55;55;6;35;64;1;35;4;0;31;0;0;0
082000009;800;755;757;7;228;799;1;0;0;0;0;228;0;228
082000010;200;139;139;9;63;136;1;63;0;0;63;0;0;0
082000011;600;585;585;17;182;599;1;0;0;0;0;182;1;181
082000012;400;324;326;3;129;399;1;0;0;0;0;129;1;128
082000013;200;192;192;7;82;117;1;82;2;0;80;0;0;0
082000014;100;50;50;6;42;57;1;42;0;0;42;0;0;0
082000015;200;200;200;7;80;119;1;80;2;1;77;0;0;0
082000016;100;111;111;8;54;45;1;54;1;1;52;0;0;0
082000017;100;16;16;8;22;77;1;22;2;0;20;0;0;0
082700001;900;826;826;5;309;900;0;0;0;0;0;309;6;303
082700002;800;759;759;8;286;799;1;0;0;0;0;286;2;284
082700003;700;621;624;6;244;699;1;0;0;0;0;244;3;241
082700004;1400;1382;1382;9;222;1399;1;0;0;0;0;222;0;222
082700005;1000;933;933;10;201;998;2;0;0;0;0;201;2;199
082700006;600;630;632;7;243;599;1;0;0;0;0;243;1;242
082700007;800;798;789;8;312;798;2;0;0;0;0;312;5;307
082700008;300;241;242;7;69;230;1;69;2;1;66;0;0;0
082700009;400;384;385;5;134;399;1;0;0;0;0;134;1;133
082700010;1000;1004;1005;4;190;998;2;0;0;0;0;190;1;189
082700011;900;866;866;3;121;899;1;0;0;0;0;121;0;121
082700012;1000;943;943;13;268;999;1;0;0;0;0;268;1;267
082700013;400;376;376;6;48;399;1;0;0;0;0;48;0;48
082700014;300;264;264;11;52;299;1;0;0;0;0;52;1;51
082700015;600;511;511;7;147;598;2;0;0;0;0;147;2;145
082700016;100;114;114;8;24;75;1;24;0;7;17;0;0;0
082700017;1300;1266;1269;9;323;1300;0;0;0;0;0;323;1;322
082700018;1300;1197;1197;9;324;1300;0;0;0;0;0;324;2;322
082700019;1300;1128;1130;11;335;1299;1;0;0;0;0;335;5;330
082700020;600;586;589;7;168;599;1;0;0;0;0;168;0;168
082700021;100;85;85;8;55;44;1;55;0;2;53;0;0;0
082700022;700;623;623;7;209;698;2;0;0;0;0;209;1;208
082700023;200;178;178;5;79;121;0;79;3;0;76;0;0;0
082700024;400;321;321;7;170;398;2;0;0;0;0;170;1;169
082700025;100;41;41;7;20;79;1;20;1;1;18;0;0;0
082700026;1400;1275;1275;10;384;1399;1;0;0;0;0;384;0;384
082700027;1200;1086;1086;9;248;1200;0;0;0;0;0;248;0;248
082700028;400;357;359;9;96;399;1;0;0;0;0;96;0;96
082700029;900;811;812;8;115;899;1;0;0;0;0;115;0;115
082700030;300;238;238;7;80;218;2;80;3;1;76;0;0;0
082700031;500;400;401;5;148;500;0;0;0;0;0;148;0;148
082700032;100;24;24;8;30;69;1;30;8;1;21;0;0;0
082800001;600;567;567;7;188;599;1;0;0;0;0;188;5;183
082800002;600;630;630;7;222;599;1;0;0;0;0;222;2;220
082800003;600;562;565;7;210;599;1;0;0;0;0;210;6;204
082800004;600;565;568;9;223;599;1;0;0;0;0;223;4;219
082800005;700;672;672;7;268;699;1;0;0;0;0;268;5;263
082800006;900;888;931;8;338;899;1;0;0;0;0;338;7;331
082800007;800;799;802;11;384;799;1;0;0;0;0;384;4;380
082800008;700;664;665;2;306;699;1;0;0;0;0;306;3;303
082800009;600;590;590;8;283;599;1;0;0;0;0;283;3;280
082800010;700;640;640;8;286;699;1;0;0;0;0;286;5;281
082800011;600;622;623;7;310;599;1;0;0;0;0;310;4;306
082800012;500;531;531;8;213;499;1;0;0;0;0;213;3;210
082800013;600;561;561;8;266;599;1;0;0;0;0;266;2;264
082800014;800;824;827;7;398;799;1;0;0;0;0;398;4;394
082800015;700;637;698;5;337;699;1;0;0;0;0;337;6;331
082800016;800;754;755;7;347;799;1;0;0;0;0;347;3;344
082800017;600;595;595;9;278;599;1;0;0;0;0;278;3;275
082800018;800;811;810;9;349;799;1;0;0;0;0;349;4;345
082800019;700;624;631;5;280;699;1;0;0;0;0;280;5;275
082800020;600;539;543;9;259;599;1;0;0;0;0;259;5;254
082800021;600;536;537;7;229;599;1;0;0;0;0;229;4;225
082800022;900;825;829;9;369;899;1;0;0;0;0;369;1;368
082800023;600;254;584;8;262;599;1;0;0;0;0;262;5;257
082800024;600;538;540;11;271;599;1;0;0;0;0;271;6;265
082800025;700;690;692;9;346;699;1;0;0;0;0;346;8;338
082800026;700;673;675;9;279;699;1;0;0;0;0;279;2;277
082800027;600;569;570;9;244;599;1;0;0;0;0;244;3;241
082800028;700;682;684;9;317;699;1;0;0;0;0;317;2;315
082800029;700;677;678;4;263;699;1;0;0;0;0;263;6;257
082800030;900;823;827;8;304;899;1;0;0;0;0;304;9;295
082800031;900;852;858;10;282;899;1;0;0;0;0;282;2;280
082800032;800;754;754;9;324;799;1;0;0;0;0;324;1;323
082800033;600;606;606;6;236;599;1;0;0;0;0;236;3;233
082800034;600;585;586;10;214;599;1;0;0;0;0;214;2;212
082800035;600;568;571;8;218;599;1;0;0;0;0;218;2;216
082800036;700;647;649;8;218;699;1;0;0;0;0;218;3;215
082800037;700;654;656;8;261;699;1;0;0;0;0;261;4;257
082800038;700;680;681;7;132;699;1;0;0;0;0;132;2;130
082800039;600;575;575;8;151;599;1;0;0;0;0;151;4;147
082800040;600;617;618;7;262;599;1;0;0;0;0;262;2;260
082800041;700;644;647;5;267;699;1;0;0;0;0;267;5;262
082800042;800;761;762;5;261;799;1;0;0;0;0;261;2;259
082800043;600;632;634;8;249;599;1;0;0;0;0;249;5;244
082800044;800;741;741;9;270;799;1;0;0;0;0;270;3;267
082800045;900;829;829;10;315;899;1;0;0;0;0;315;1;314
082800046;700;681;683;7;272;699;1;0;0;0;0;272;2;270
082800047;900;815;817;8;312;899;1;0;0;0;0;312;2;310
082800048;800;756;758;8;151;799;1;0;0;0;0;151;3;148
082800049;700;668;668;8;111;699;1;0;0;0;0;111;1;110
082800050;900;854;858;10;348;899;1;0;0;0;0;348;5;343
082800051;700;646;649;9;239;699;1;0;0;0;0;239;4;235
082800052;700;624;624;8;228;699;1;0;0;0;0;228;3;225
082800053;600;521;521;9;163;599;1;0;0;0;0;163;3;160
082800054;400;389;390;4;128;399;1;0;0;0;0;128;1;127
082800055;700;661;665;8;195;699;1;0;0;0;0;195;2;193
082800056;900;835;835;9;344;899;1;0;0;0;0;344;5;339
082800057;700;717;718;4;238;699;1;0;0;0;0;238;0;238
082800058;700;690;690;5;242;699;1;0;0;0;0;242;0;242
082800059;800;755;755;6;365;799;1;0;0;0;0;365;3;362
082800060;800;740;741;6;330;799;1;0;0;0;0;330;2;328
082800061;700;690;693;6;340;699;1;0;0;0;0;340;2;338
082800062;800;738;740;0;323;799;1;0;0;0;0;323;4;319
082800063;600;612;612;6;313;599;1;0;0;0;0;313;3;310
082800064;800;744;744;8;360;799;1;0;0;0;0;360;3;357
082800065;600;597;597;2;220;599;1;0;0;0;0;220;4;216
082800066;500;655;656;9;272;499;1;0;0;0;0;272;3;269
082800067;700;666;668;7;252;699;1;0;0;0;0;252;1;251
082800068;500;647;647;8;244;499;1;0;0;0;0;244;3;241
082800069;600;652;654;9;227;599;1;0;0;0;0;227;3;224
082800070;700;675;675;10;232;699;1;0;0;0;0;232;1;231
082800071;700;687;687;11;218;699;1;0;0;0;0;218;3;215
082800072;700;721;722;8;243;699;1;0;0;0;0;243;2;241
082800073;600;549;552;7;197;599;1;0;0;0;0;197;6;191
082800074;600;565;566;8;192;599;1;0;0;0;0;192;2;190
082800075;500;483;484;10;176;499;1;0;0;0;0;176;3;173
082800076;700;743;744;6;310;699;1;0;0;0;0;310;5;305
082800077;700;659;662;6;42;699;1;0;0;0;0;42;0;42
082800078;800;752;752;8;90;799;1;0;0;0;0;90;0;90
082800079;800;757;757;9;168;799;1;0;0;0;0;168;2;166
082800080;800;703;704;8;131;799;1;0;0;0;0;131;1;130
082800081;700;690;690;7;131;699;1;0;0;0;0;131;2;129
082800082;700;697;697;9;119;699;1;0;0;0;0;119;1;118
082800083;700;739;739;7;45;699;1;0;0;0;0;45;0;45
082800084;700;703;704;8;39;699;1;0;0;0;0;39;0;39
082800085;600;585;588;9;114;599;1;0;0;0;0;114;1;113
082800086;500;544;544;11;145;499;1;0;0;0;0;145;1;144
082800087;600;616;616;3;177;599;1;0;0;0;0;177;1;176
082800088;600;583;584;6;168;599;1;0;0;0;0;168;0;168
082800089;400;485;487;12;154;399;1;0;0;0;0;154;1;153
082800090;500;550;553;8;199;499;1;0;0;0;0;199;3;196
082800091;800;813;813;6;282;799;1;0;0;0;0;282;3;279
082800092;600;587;587;8;194;599;1;0;0;0;0;194;2;192
082800093;700;660;660;9;227;699;1;0;0;0;0;227;5;222
082800094;700;684;684;2;210;489;1;210;3;8;199;0;0;0
082800095;600;602;603;8;190;599;1;0;0;0;0;190;0;190
082800096;700;664;665;10;234;699;1;0;0;0;0;234;3;231
082800097;700;722;723;10;243;699;1;0;0;0;0;243;5;238
082800098;700;658;660;6;189;510;1;189;2;4;183;0;0;0
082800099;700;707;707;7;218;699;1;0;0;0;0;218;9;209
082800100;700;723;724;6;195;699;1;0;0;0;0;195;2;193
082800101;400;406;409;8;80;399;1;0;0;0;0;80;1;79
082800102;700;653;653;5;263;699;1;0;0;0;0;263;3;260
082800103;600;605;605;8;267;599;1;0;0;0;0;267;5;262
082800104;100;114;114;8;57;42;1;57;1;2;54;0;0;0
082800105;700;671;671;8;255;699;1;0;0;0;0;255;2;253
082800106;700;716;716;5;258;699;1;0;0;0;0;258;4;254
082800107;500;493;493;8;159;499;1;0;0;0;0;159;1;158
082800108;400;457;458;7;154;399;1;0;0;0;0;154;3;151
082800109;634;168;634;4;169;633;1;0;0;0;0;169;2;167
082800110;800;848;848;5;237;799;1;0;0;0;0;237;5;232
082800111;700;728;729;4;236;699;1;0;0;0;0;236;2;234
082800112;500;527;529;7;164;499;1;0;0;0;0;164;1;163
082800113;642;642;642;10;160;641;1;0;0;0;0;160;1;159
082800114;600;622;626;9;178;599;1;0;0;0;0;178;1;177
082800115;600;653;653;8;228;599;1;0;0;0;0;228;3;225
082800116;500;528;528;5;160;499;1;0;0;0;0;160;0;160
082800117;600;573;575;6;207;599;1;0;0;0;0;207;3;204
082800118;600;599;599;7;212;599;1;0;0;0;0;212;2;210
082800119;700;664;668;7;161;699;1;0;0;0;0;161;1;160
082800120;600;604;606;6;149;599;1;0;0;0;0;149;2;147
082800121;600;622;622;3;88;599;1;0;0;0;0;88;0;88
082800122;700;665;665;2;49;699;1;0;0;0;0;49;1;48
082800123;700;707;708;6;65;699;1;0;0;0;0;65;0;65
082800124;600;586;588;9;29;599;1;0;0;0;0;29;0;29
082800125;600;630;630;8;22;599;1;0;0;0;0;22;0;22
082800126;700;679;680;6;24;699;1;0;0;0;0;24;0;24
082800127;200;76;76;57;81;118;1;81;2;0;79;0;0;0
082800128;200;90;90;18;89;110;1;89;13;2;74;0;0;0
082800130;100;21;21;4;25;74;1;25;0;0;25;0;0;0
082900001;600;698;698;4;326;599;1;0;0;0;0;326;7;319
082900002;500;620;622;6;241;499;1;0;0;0;0;241;3;238
082900003;500;528;528;2;190;499;1;0;0;0;0;190;1;189
082900004;800;932;935;4;319;797;3;0;0;0;0;319;6;313
082900005;200;129;129;6;75;124;1;75;2;0;73;0;0;0
082900006;100;48;48;8;33;66;1;33;0;0;33;0;0;0
082900007;100;69;69;4;41;58;1;41;1;1;39;0;0;0
082900008;100;121;121;6;53;46;1;53;1;0;52;0;0;0
082900009;300;340;340;2;202;96;2;202;3;1;198;0;0;0
082900010;100;109;109;6;66;33;1;66;1;2;63;0;0;0
082900011;100;67;68;7;44;55;1;44;1;0;43;0;0;0
082900012;200;218;219;5;104;95;1;104;2;2;100;0;0;0
082900013;100;26;26;8;22;77;1;22;0;1;21;0;0;0
082900014;100;43;43;7;24;75;1;24;0;2;22;0;0;0
082900015;100;66;66;8;54;45;1;54;1;1;52;0;0;0
082900016;100;35;35;5;17;82;1;17;1;0;16;0;0;0
090200001;1400;1602;1623;3;383;1399;1;0;0;0;0;383;6;377
090200002;1400;1788;1810;4;431;1400;0;0;0;0;0;431;2;429
090200003;1400;2091;2116;10;507;1400;0;0;0;0;0;507;7;500
090200004;1400;1851;1850;13;378;1399;1;0;0;0;0;378;2;376
090200005;200;141;141;5;61;138;1;61;1;1;59;0;0;0
090200006;600;525;528;7;158;600;0;0;0;0;0;158;0;158
090200007;600;497;497;2;81;599;1;0;0;0;0;81;0;81
090200008;700;699;714;6;228;700;0;0;0;0;0;228;1;227
090200009;600;569;579;6;139;599;1;0;0;0;0;139;2;137
090200010;1100;1092;1133;2;302;1099;1;0;0;0;0;302;3;299
090200011;300;268;268;3;94;205;1;94;2;0;92;0;0;0
090200012;900;923;954;5;210;899;1;0;0;0;0;210;6;204
090200013;600;493;493;6;110;600;0;0;0;0;0;110;1;109
090200014;800;692;702;5;103;800;0;0;0;0;0;103;0;103
090200015;600;566;566;3;227;599;1;0;0;0;0;227;0;227
090200016;400;340;340;6;93;400;0;0;0;0;0;93;0;93
090200017;400;336;336;5;67;400;0;0;0;0;0;67;0;67
090200018;200;120;120;7;62;137;1;62;3;0;59;0;0;0
090200019;200;160;160;5;114;84;2;114;1;0;113;0;0;0
090200020;900;800;838;2;309;899;1;0;0;0;0;309;0;309
090200021;200;193;195;5;78;122;0;78;0;0;78;0;0;0
090200022;300;260;260;5;84;216;0;84;2;0;82;0;0;0
090200023;200;200;205;5;74;126;0;74;1;0;73;0;0;0
090200024;600;521;521;5;83;600;0;0;0;0;0;83;1;82
090200025;200;158;158;4;43;157;0;43;0;0;43;0;0;0
090200026;200;145;146;5;32;167;1;32;0;0;32;0;0;0
090200027;1000;931;948;4;193;999;1;0;0;0;0;193;0;193
090200028;800;716;775;6;355;799;1;0;0;0;0;355;4;351
090200029;400;344;350;6;137;400;0;0;0;0;0;137;0;137
090200030;200;157;162;1;70;130;0;70;2;0;68;0;0;0
090200031;700;629;632;6;145;700;0;0;0;0;0;145;0;145
090200032;100;97;97;3;75;22;3;75;2;2;71;0;0;0
090200033;400;358;359;5;71;400;0;0;0;0;0;71;0;71
090200034;200;158;161;5;45;154;1;45;2;0;43;0;0;0
090200035;100;59;59;5;61;38;1;61;6;0;55;0;0;0
090200036;200;168;178;5;81;118;1;81;1;0;80;0;0;0
090200037;100;81;81;6;58;41;1;58;0;0;58;0;0;0
090200038;300;251;251;5;81;217;2;81;1;0;80;0;0;0
090200039;500;432;432;3;100;500;0;0;0;0;0;100;0;100
090200040;800;772;772;6;114;800;0;0;0;0;0;114;0;114
090200041;200;192;196;5;56;143;1;56;0;1;55;0;0;0
090200042;400;311;311;5;63;399;1;0;0;0;0;63;0;63
090200043;300;222;222;2;48;251;1;48;0;0;48;0;0;0
090200044;300;244;244;6;62;237;1;62;2;1;59;0;0;0
090200045;500;44;170;4;44;454;2;44;1;0;43;0;0;0
090200046;200;201;198;3;56;142;2;56;1;0;55;0;0;0
090200047;200;182;182;5;41;158;1;41;0;0;41;0;0;0
090200048;200;205;210;7;67;132;1;67;0;0;67;0;0;0
090200049;100;100;99;0;30;69;1;30;0;0;30;0;0;0
090200050;110;95;95;0;94;16;0;94;1;0;93;0;0;0
090200051;100;82;82;0;82;18;0;82;0;0;82;0;0;0
090200052;100;50;50;0;47;53;0;47;0;0;47;0;0;0
090200053;100;58;58;0;52;47;1;52;0;0;52;0;0;0
090200054;100;45;45;0;45;55;0;45;0;0;45;0;0;0
090200055;100;53;53;0;52;48;0;52;0;0;52;0;0;0
090200056;100;57;57;1;56;44;0;56;0;0;56;0;0;0
090200057;100;22;22;0;21;79;0;21;0;0;21;0;0;0
090200058;100;39;39;1;30;70;0;30;1;0;29;0;0;0
090800001;2000;2340;2340;11;577;1999;1;0;0;0;0;577;2;575
090800002;1300;1261;1262;15;358;1299;1;0;0;0;0;358;1;357
090800003;650;611;611;8;208;650;0;0;0;0;0;208;3;205
090800004;1650;1623;1625;10;524;1649;1;0;0;0;0;524;2;522
090800005;450;413;414;8;138;450;0;0;0;0;0;138;0;138
090800006;500;485;486;5;86;499;1;0;0;0;0;86;0;86
090800007;400;414;414;8;78;400;0;0;0;0;0;78;0;78
090800008;200;173;173;9;61;138;1;61;1;0;60;0;0;0
090800009;500;446;446;5;145;500;0;0;0;0;0;145;0;145
090800010;400;398;398;3;99;400;0;0;0;0;0;99;0;99
090800011;300;263;263;3;78;221;1;78;0;0;78;0;0;0
090800012;250;207;207;6;30;219;1;30;1;0;29;0;0;0
090800013;550;525;525;6;105;549;1;0;0;0;0;105;0;105
090800014;395;95;395;5;100;394;1;0;0;0;0;100;0;100
090800015;340;340;341;3;93;339;1;0;0;0;0;93;0;93
090800016;350;329;329;2;92;350;0;0;0;0;0;92;0;92
090800017;600;579;579;4;126;600;0;0;0;0;0;126;1;125
090800018;650;103;613;8;111;650;0;0;0;0;0;111;1;110
090800019;800;777;790;7;242;800;0;0;0;0;0;242;0;242
090800020;650;612;614;7;128;650;0;0;0;0;0;128;0;128
090800021;950;929;939;6;205;949;1;0;0;0;0;205;0;205
090800022;510;519;510;9;103;509;1;0;0;0;0;103;0;103
090800023;850;845;845;5;208;850;0;0;0;0;0;208;1;207
090800024;300;227;227;8;34;265;1;34;5;0;29;0;0;0
090800025;300;281;281;6;63;236;1;63;4;1;58;0;0;0
090800026;400;379;379;5;48;400;0;0;0;0;0;48;0;48
090800027;300;284;284;5;43;254;3;43;2;0;41;0;0;0
090800028;100;78;78;6;38;62;0;38;2;0;36;0;0;0
090800029;250;220;221;7;27;222;1;27;0;0;27;0;0;0
090800030;800;714;714;1;413;799;1;0;0;0;0;413;3;410
090800031;450;62;403;4;66;449;1;0;0;0;0;66;0;66
090800032;800;769;769;5;144;800;0;0;0;0;0;144;1;143
090800033;650;627;627;3;116;650;0;0;0;0;0;116;0;116
090800034;400;374;374;5;102;399;1;0;0;0;0;102;0;102
090800035;400;369;369;8;115;399;1;0;0;0;0;115;0;115
090800036;200;150;150;5;30;168;2;30;0;0;30;0;0;0
090800037;1100;1028;1028;6;117;1100;0;0;0;0;0;117;0;117
090800038;450;406;407;4;102;450;0;0;0;0;0;102;0;102
090800039;300;279;279;4;109;190;1;109;3;0;106;0;0;0
090800040;300;256;256;6;70;229;1;70;1;1;68;0;0;0
090800041;250;197;197;6;53;196;1;53;2;0;51;0;0;0
090800042;250;187;188;7;41;208;1;41;1;0;40;0;0;0
090800043;250;250;250;8;67;182;1;67;1;0;66;0;0;0
090800044;350;323;324;10;98;350;0;0;0;0;0;98;1;97
090800045;100;43;43;0;43;57;0;43;1;0;42;0;0;0
091400001;700;666;666;0;288;699;1;0;0;0;0;288;1;287
091400002;500;454;454;0;241;499;1;0;0;0;0;241;3;238
091400003;400;376;381;2;153;399;1;0;0;0;0;153;3;150
091400004;200;103;104;2;69;130;1;69;0;0;69;0;0;0
091400005;200;164;171;2;124;75;1;124;1;1;122;0;0;0
091400006;400;289;289;3;169;230;1;169;0;3;166;0;0;0
091400007;400;286;286;3;174;225;1;174;3;1;170;0;0;0
091400008;200;115;115;0;77;123;0;77;0;1;76;0;0;0
091400009;400;318;323;5;114;400;0;0;0;0;0;114;0;114
091400010;400;330;334;2;166;399;1;0;0;0;0;166;0;166
091400011;500;466;466;0;181;499;1;0;0;0;0;181;1;180
091400012;700;660;669;2;313;699;1;0;0;0;0;313;1;312
091400013;100;80;80;0;59;40;1;59;2;0;57;0;0;0
091400014;400;274;274;0;141;258;1;141;2;1;138;0;0;0
091400015;100;55;55;5;38;61;1;38;0;0;38;0;0;0
091400016;400;266;266;0;145;255;0;145;3;0;142;0;0;0
091400017;400;240;240;4;113;286;1;113;4;0;109;0;0;0
091400018;800;1045;1048;5;295;799;1;0;0;0;0;295;5;290
091400019;700;846;848;1;185;699;1;0;0;0;0;185;2;183
091400020;700;950;952;1;174;700;0;0;0;0;0;174;0;174
091400021;800;989;989;10;180;799;1;0;0;0;0;180;1;179
091400022;1000;1275;1275;10;259;999;1;0;0;0;0;259;0;259
091400023;600;566;566;6;127;600;0;0;0;0;0;127;0;127
091400024;400;281;281;6;63;399;1;0;0;0;0;63;0;63
091400025;300;257;257;9;71;228;1;71;4;0;67;0;0;0
091400026;500;601;601;6;145;499;1;0;0;0;0;145;0;145
091400027;300;241;241;3;67;233;0;67;0;1;66;0;0;0
091400028;1000;1168;1176;4;210;1000;0;0;0;0;0;210;0;210
091400029;800;981;984;3;238;800;0;0;0;0;0;238;1;237
091400030;400;368;369;3;112;400;0;0;0;0;0;112;0;112
091400031;800;698;800;7;187;799;1;0;0;0;0;187;0;187
091400032;600;638;643;5;134;600;0;0;0;0;0;134;0;134
091400033;671;671;673;5;205;670;1;0;0;0;0;205;0;205
091400034;600;505;510;2;196;599;1;0;0;0;0;196;2;194
091400035;500;352;363;1;95;499;1;0;0;0;0;95;0;95
091400036;500;454;454;3;130;500;0;0;0;0;0;130;1;129
091400037;800;903;907;13;188;799;1;0;0;0;0;188;0;188
091400038;800;672;680;12;126;799;1;0;0;0;0;126;0;126
091400039;400;391;392;5;118;399;1;0;0;0;0;118;1;117
091400040;700;641;641;9;178;700;0;0;0;0;0;178;0;178
091400041;400;354;356;4;86;400;0;0;0;0;0;86;1;85
091400042;1000;1377;1377;3;297;999;1;0;0;0;0;297;1;296
091400043;900;944;944;4;266;899;1;0;0;0;0;266;5;261
091400044;500;465;465;7;117;500;0;0;0;0;0;117;0;117
091400045;700;626;631;8;215;700;0;0;0;0;0;215;0;215
091400046;700;685;689;10;206;700;0;0;0;0;0;206;0;206
091400047;700;752;752;4;185;699;1;0;0;0;0;185;0;185
091400048;700;644;650;4;190;699;1;0;0;0;0;190;0;190
091400049;200;188;188;5;65;135;0;65;0;0;65;0;0;0
091400050;100;97;97;3;46;53;1;46;0;0;46;0;0;0
091400051;300;286;287;7;157;143;0;157;7;1;149;0;0;0
091400052;300;262;263;0;75;224;1;75;1;0;74;0;0;0
091400053;200;207;207;2;60;139;1;60;0;0;60;0;0;0
091400054;300;231;231;4;70;229;1;70;0;0;70;0;0;0
091400055;400;352;353;0;102;400;0;0;0;0;0;102;0;102
091400056;600;139;508;4;139;600;0;0;0;0;0;139;0;139
091400057;900;918;932;5;330;899;1;0;0;0;0;330;2;328
091400058;600;562;561;6;182;600;0;0;0;0;0;182;0;182
091400059;200;124;124;0;57;142;1;57;0;0;57;0;0;0
091400060;800;743;756;1;207;800;0;0;0;0;0;207;2;205
091400061;200;155;155;1;75;124;1;75;0;0;75;0;0;0
091400062;110;110;110;1;53;57;0;53;0;0;53;0;0;0
091400063;200;183;183;5;91;108;1;91;1;0;90;0;0;0
091400064;300;249;249;4;126;173;1;126;0;0;126;0;0;0
091400065;600;494;494;0;151;600;0;0;0;0;0;151;4;147
091400066;600;527;527;0;142;600;0;0;0;0;0;142;2;140
091400067;500;422;422;3;110;500;0;0;0;0;0;110;0;110
091400068;200;90;326;8;90;200;0;0;0;0;0;90;0;90
091400069;400;380;380;3;84;399;1;0;0;0;0;84;0;84
091400070;300;272;272;4;80;299;1;0;0;0;0;80;0;80
091400071;234;234;234;4;75;158;1;75;0;0;75;0;0;0
091400072;300;291;291;6;60;299;1;0;0;0;0;60;0;60
091400073;200;171;171;4;40;158;2;40;2;1;37;0;0;0
091400074;300;294;294;6;52;300;0;0;0;0;0;52;0;52
091400075;300;248;255;3;67;232;1;67;1;0;66;0;0;0
091400076;300;259;259;4;86;213;1;86;0;0;86;0;0;0
091400077;90;25;25;0;24;66;0;24;0;0;24;0;0;0
091400078;90;29;29;0;27;62;1;27;3;0;24;0;0;0
091400079;100;27;27;0;26;74;0;26;0;0;26;0;0;0
091400080;100;50;50;0;47;53;0;47;0;0;47;0;0;0
091400081;100;47;47;0;45;55;0;45;2;0;43;0;0;0
091500001;1000;1159;1162;3;357;999;1;0;0;0;0;357;3;354
091500002;1100;1315;1315;2;408;1099;1;0;0;0;0;408;12;396
091500003;800;815;829;1;279;799;1;0;0;0;0;279;3;276
091500004;1000;961;968;5;326;999;1;0;0;0;0;326;3;323
091500005;1100;1304;1306;5;303;1099;1;0;0;0;0;303;2;301
091500006;1000;1149;1149;8;306;999;1;0;0;0;0;306;3;303
091500007;500;441;441;5;99;499;1;0;0;0;0;99;0;99
091500008;500;420;426;4;86;500;0;0;0;0;0;86;0;86
091500009;1000;1022;1027;7;196;999;1;0;0;0;0;196;1;195
091500010;300;289;289;7;65;300;0;0;0;0;0;65;0;65
091500011;1100;1155;1165;8;362;1099;1;0;0;0;0;362;0;362
091500012;400;382;390;8;118;399;1;0;0;0;0;118;0;118
091500013;600;588;588;9;225;599;1;0;0;0;0;225;0;225
091500014;1300;1385;1386;7;379;1299;1;0;0;0;0;379;4;375
091500015;200;184;186;6;43;156;1;43;1;1;41;0;0;0
091500016;300;224;224;8;110;188;2;110;5;1;104;0;0;0
091500017;500;475;475;7;93;500;0;0;0;0;0;93;0;93
091500018;300;235;236;7;52;244;4;52;3;0;49;0;0;0
091500019;300;256;257;8;72;227;1;72;2;0;70;0;0;0
091500020;700;685;687;9;143;699;1;0;0;0;0;143;0;143
091500021;600;518;535;7;201;600;0;0;0;0;0;201;1;200
091500022;500;474;490;6;223;499;1;0;0;0;0;223;0;223
091500023;500;507;518;9;129;499;1;0;0;0;0;129;1;128
091500024;200;154;155;8;45;154;1;45;3;0;42;0;0;0
091500025;200;180;180;6;72;127;1;72;0;2;70;0;0;0
091500026;600;553;555;10;149;600;0;0;0;0;0;149;1;148
091500027;700;765;765;12;157;699;1;0;0;0;0;157;0;157
091500028;300;217;221;6;60;239;1;60;3;1;56;0;0;0
091500029;300;282;282;4;69;230;1;69;0;0;69;0;0;0
091500030;700;726;730;9;164;699;1;0;0;0;0;164;0;164
091500031;200;166;166;6;47;152;1;47;3;0;44;0;0;0
091500032;200;141;141;5;48;151;1;48;0;0;48;0;0;0
091500033;500;418;418;5;87;500;0;0;0;0;0;87;0;87
091500034;600;583;583;8;167;600;0;0;0;0;0;167;1;166
091500035;600;649;649;8;183;599;1;0;0;0;0;183;0;183
091500036;900;943;951;11;216;899;1;0;0;0;0;216;1;215
091500037;200;135;136;5;46;153;1;46;0;0;46;0;0;0
091500038;400;331;331;0;56;400;0;0;0;0;0;56;0;56
091500039;300;280;280;8;51;299;1;0;0;0;0;51;0;51
091500040;200;203;203;7;51;147;2;51;1;0;50;0;0;0
091500041;200;174;174;9;36;163;1;36;1;0;35;0;0;0
091500042;600;516;522;7;260;599;1;0;0;0;0;260;1;259
091500043;600;587;615;7;244;599;1;0;0;0;0;244;1;243
091500044;200;156;156;4;83;116;1;83;1;0;82;0;0;0
091500045;200;187;187;1;51;148;1;51;0;0;51;0;0;0
091500046;100;136;136;7;18;81;1;18;0;0;18;0;0;0
091500047;900;1004;1017;10;240;899;1;0;0;0;0;240;0;240
091500048;500;431;432;8;121;499;1;0;0;0;0;121;0;121
091500049;700;679;679;7;106;700;0;0;0;0;0;106;0;106
091500050;300;266;267;4;38;260;2;38;1;0;37;0;0;0
091500051;200;192;192;7;45;154;1;45;0;0;45;0;0;0
091500052;700;632;632;14;146;699;1;0;0;0;0;146;0;146
091500053;300;233;234;8;46;253;1;46;0;1;45;0;0;0
091500054;500;50;341;9;59;500;0;0;0;0;0;59;0;59
091500055;400;328;328;10;54;400;0;0;0;0;0;54;0;54
091500056;200;126;126;3;45;153;2;45;0;0;45;0;0;0
091500057;400;304;321;1;152;399;1;0;0;0;0;152;4;148
091500058;300;201;201;3;122;177;1;122;3;0;119;0;0;0
091500059;300;267;269;1;141;157;2;141;0;0;141;0;0;0
091500060;100;93;93;2;55;43;2;55;1;1;53;0;0;0
091500061;100;50;50;4;34;65;1;34;0;0;34;0;0;0
091500062;100;48;52;5;53;46;1;53;0;0;53;0;0;0
091500063;500;427;427;0;186;499;1;0;0;0;0;186;3;183
091500064;300;251;248;3;134;165;1;134;2;0;132;0;0;0
091500065;300;256;256;3;42;257;1;42;2;0;40;0;0;0
091500066;200;125;125;4;22;178;0;22;0;0;22;0;0;0
091500067;200;268;268;5;28;199;1;0;0;0;0;28;0;28
091500068;100;75;75;5;63;37;0;63;0;0;63;0;0;0
091500069;500;462;465;6;193;499;1;0;0;0;0;193;1;192
091500070;500;415;434;8;137;500;0;0;0;0;0;137;0;137
091500071;300;267;272;8;55;299;1;0;0;0;0;55;0;55
091500072;200;121;121;4;36;163;1;36;0;0;36;0;0;0
091500073;200;102;102;10;28;171;1;28;0;0;28;0;0;0
091500074;100;72;72;8;14;86;0;14;0;0;14;0;0;0
091500075;200;146;146;2;64;135;1;64;1;0;63;0;0;0
091500076;500;430;430;6;104;500;0;0;0;0;0;104;0;104
091500077;200;176;176;5;29;170;1;29;0;0;29;0;0;0
091500078;100;30;30;6;29;71;0;29;0;1;28;0;0;0
091500079;100;47;47;3;50;50;0;50;0;0;50;0;0;0
091500080;100;40;40;0;40;60;0;40;0;0;40;0;0;0
091500081;100;44;44;0;43;57;0;43;0;0;43;0;0;0
091500082;100;48;48;4;52;47;1;52;0;0;52;0;0;0
091500083;100;45;45;2;47;53;0;47;0;0;47;0;0;0
091500084;100;34;34;0;33;67;0;33;0;0;33;0;0;0
091500085;100;51;51;3;51;49;0;51;0;0;51;0;0;0
091500086;100;29;29;3;29;70;1;29;1;0;28;0;0;0
091500087;100;33;33;0;33;63;4;33;2;0;31;0;0;0
091500088;50;14;14;0;14;36;0;14;0;0;14;0;0;0
091600001;900;856;860;6;206;899;1;0;0;0;0;206;5;201
091600002;1100;1064;1060;8;125;1099;1;0;0;0;0;125;1;124
091600003;850;803;805;6;134;850;0;0;0;0;0;134;2;132
091600004;850;826;826;9;166;850;0;0;0;0;0;166;1;165
091600005;500;493;496;8;150;499;1;0;0;0;0;150;2;148
091600006;950;930;930;7;93;950;0;0;0;0;0;93;3;90
091600007;750;738;738;4;82;750;0;0;0;0;0;82;0;82
091600008;800;811;814;9;105;800;0;0;0;0;0;105;0;105
091600009;650;657;658;11;92;649;1;0;0;0;0;92;0;92
091600010;400;389;389;4;99;399;1;0;0;0;0;99;4;95
091600011;850;819;819;7;294;849;1;0;0;0;0;294;7;287
091600012;800;768;768;5;300;799;1;0;0;0;0;300;16;284
091600013;800;757;762;7;300;799;1;0;0;0;0;300;2;298
091600014;600;565;565;7;241;599;1;0;0;0;0;241;1;240
091600015;600;579;579;7;253;599;1;0;0;0;0;253;4;249
091600016;600;577;577;8;161;599;1;0;0;0;0;161;2;159
091600017;500;463;465;8;200;499;1;0;0;0;0;200;4;196
091600018;700;682;687;10;284;699;1;0;0;0;0;284;5;279
091600019;550;543;544;8;233;549;1;0;0;0;0;233;6;227
091600020;900;890;890;6;361;900;0;0;0;0;0;361;9;352
091600021;650;652;660;6;255;649;1;0;0;0;0;255;2;253
091600022;650;633;635;13;239;649;1;0;0;0;0;239;3;236
091600023;650;630;630;4;251;649;1;0;0;0;0;251;4;247
091600024;700;688;688;4;253;699;1;0;0;0;0;253;4;249
091600025;650;627;629;1;222;649;1;0;0;0;0;222;2;220
091600026;700;674;678;3;231;699;1;0;0;0;0;231;3;228
091600027;550;522;523;2;248;549;1;0;0;0;0;248;8;240
091600028;650;654;654;7;195;648;2;0;0;0;0;195;3;192
091600029;500;500;500;6;173;499;1;0;0;0;0;173;6;167
091600030;650;642;648;8;149;649;1;0;0;0;0;149;0;149
091600031;750;723;723;11;210;749;1;0;0;0;0;210;5;205
091600032;600;573;571;7;167;599;1;0;0;0;0;167;3;164
091600033;650;646;646;8;212;649;1;0;0;0;0;212;7;205
091600034;650;611;611;4;161;649;1;0;0;0;0;161;2;159
091600035;650;649;649;4;160;649;1;0;0;0;0;160;1;159
091600036;400;390;393;2;163;399;1;0;0;0;0;163;3;160
091600037;450;460;460;5;183;449;1;0;0;0;0;183;6;177
091600038;600;591;591;4;219;600;0;0;0;0;0;219;5;214
091600039;650;623;623;5;182;649;1;0;0;0;0;182;1;181
091600040;750;711;711;7;172;749;1;0;0;0;0;172;4;168
091600041;600;566;569;5;158;599;1;0;0;0;0;158;5;153
091600042;900;899;900;6;221;899;1;0;0;0;0;221;3;218
091600043;1100;1078;1080;4;259;1099;1;0;0;0;0;259;1;258
091600044;900;881;881;4;240;899;1;0;0;0;0;240;5;235
091600045;900;869;871;5;196;900;0;0;0;0;0;196;2;194
091600046;900;909;911;3;261;899;1;0;0;0;0;261;5;256
091600047;950;939;939;6;248;949;1;0;0;0;0;248;4;244
091600048;950;958;958;5;223;949;1;0;0;0;0;223;6;217
091600049;850;856;857;3;185;850;0;0;0;0;0;185;2;183
091600050;900;875;877;2;206;900;0;0;0;0;0;206;7;199
091600051;950;949;951;8;258;949;1;0;0;0;0;258;7;251
091600052;950;939;939;2;229;949;1;0;0;0;0;229;3;226
091600053;750;760;761;4;247;749;1;0;0;0;0;247;5;242
091600054;950;953;954;4;239;949;1;0;0;0;0;239;2;237
091600055;750;757;757;1;114;749;1;0;0;0;0;114;2;112
091600056;800;806;807;6;231;799;1;0;0;0;0;231;2;229
091600057;800;793;793;5;150;799;1;0;0;0;0;150;8;142
091600058;950;957;960;0;212;949;1;0;0;0;0;212;6;206
091600059;1050;1027;1027;1;189;1049;1;0;0;0;0;189;5;184
091600060;950;932;932;5;178;949;1;0;0;0;0;178;1;177
091600061;900;908;908;5;80;899;1;0;0;0;0;80;2;78
091600062;1000;968;969;3;190;1000;0;0;0;0;0;190;2;188
091600063;850;837;837;10;178;849;1;0;0;0;0;178;2;176
091600064;950;942;942;6;295;950;0;0;0;0;0;295;6;289
091600065;900;869;869;8;187;899;1;0;0;0;0;187;2;185
091600066;650;617;630;8;187;650;0;0;0;0;0;187;0;187
091600067;750;690;696;7;129;749;1;0;0;0;0;129;0;129
091600068;550;524;525;8;159;550;0;0;0;0;0;159;0;159
091600069;850;795;800;8;157;848;2;0;0;0;0;157;0;157
091600070;300;253;253;5;76;220;4;76;3;1;72;0;0;0
091600071;350;328;322;7;79;349;1;0;0;0;0;79;1;78
091600072;650;650;637;8;131;650;0;0;0;0;0;131;3;128
091600073;950;919;920;8;232;950;0;0;0;0;0;232;2;230
091600074;300;275;275;7;81;218;1;81;7;1;73;0;0;0
091600075;600;617;617;9;162;599;1;0;0;0;0;162;0;162
091600076;550;522;522;9;151;549;1;0;0;0;0;151;0;151
091600077;900;897;897;9;127;899;1;0;0;0;0;127;0;127
091600078;300;264;264;7;83;216;1;83;2;0;81;0;0;0
091600079;450;474;475;9;118;449;1;0;0;0;0;118;1;117
091600080;750;749;744;9;161;749;1;0;0;0;0;161;1;160
091600081;550;518;527;9;166;549;1;0;0;0;0;166;1;165
091600082;450;420;420;6;108;450;0;0;0;0;0;108;0;108
091600083;550;505;517;10;147;549;1;0;0;0;0;147;0;147
091600084;450;415;433;5;113;449;1;0;0;0;0;113;0;113
091600085;250;239;239;6;92;157;1;92;1;0;91;0;0;0
091600086;300;269;269;6;65;234;1;65;7;2;56;0;0;0
091600087;150;121;121;6;56;94;0;56;2;0;54;0;0;0
091600088;300;277;282;5;88;210;2;88;2;1;85;0;0;0
091600089;400;397;397;5;83;399;1;0;0;0;0;83;0;83
091600090;600;618;619;7;168;599;1;0;0;0;0;168;2;166
091600091;450;435;448;8;150;449;1;0;0;0;0;150;0;150
091600092;450;441;443;8;158;450;0;0;0;0;0;158;0;158
091600093;700;685;693;13;188;699;1;0;0;0;0;188;2;186
091600094;700;690;690;6;151;551;1;148;5;1;142;3;0;3
091600095;500;493;493;8;167;499;1;0;0;0;0;167;0;167
091600096;750;743;743;12;233;749;1;0;0;0;0;233;1;232
091600097;600;547;565;10;192;600;0;0;0;0;0;192;2;190
091600098;500;472;480;8;166;499;1;0;0;0;0;166;0;166
091600099;700;715;716;5;256;699;1;0;0;0;0;256;0;256
091600100;300;262;262;10;93;206;1;93;2;0;91;0;0;0
091600101;400;414;414;7;144;400;0;0;0;0;0;144;0;144
091600102;950;957;957;10;235;949;1;0;0;0;0;235;2;233
091600103;200;175;175;8;76;123;1;76;3;0;73;0;0;0
091600104;800;742;762;10;192;799;1;0;0;0;0;192;1;191
091600105;800;794;794;10;190;799;1;0;0;0;0;190;1;189
091600106;900;837;871;11;192;899;1;0;0;0;0;192;0;192
091600107;700;714;714;6;218;699;1;0;0;0;0;218;1;217
091600108;750;739;739;9;194;749;1;0;0;0;0;194;2;192
091600109;400;390;391;4;94;400;0;0;0;0;0;94;0;94
091600110;550;530;530;5;169;550;0;0;0;0;0;169;0;169
091600111;400;400;405;14;134;400;0;0;0;0;0;134;1;133
091600112;950;929;929;8;160;949;1;0;0;0;0;160;2;158
091600113;650;611;611;9;218;627;1;22;0;0;22;196;0;196
091600114;515;522;522;8;148;514;1;0;0;0;0;148;1;147
091600115;500;479;479;11;96;499;1;0;0;0;0;96;0;96
091600116;350;324;324;5;87;350;0;0;0;0;0;87;0;87
091600117;950;922;940;7;236;949;1;0;0;0;0;236;0;236
091600118;1050;1006;1042;8;147;1049;1;0;0;0;0;147;1;146
091600119;400;362;365;6;77;399;1;0;0;0;0;77;3;74
091600120;950;178;932;7;185;949;1;0;0;0;0;185;1;184
091600121;450;452;453;6;124;450;0;0;0;0;0;124;0;124
091600122;550;535;533;7;108;549;1;0;0;0;0;108;0;108
091600123;200;150;155;7;51;148;1;51;1;0;50;0;0;0
091600124;700;688;688;12;126;699;1;0;0;0;0;126;2;124
091600125;400;366;366;6;85;400;0;0;0;0;0;85;0;85
091600126;450;429;429;6;156;449;1;0;0;0;0;156;2;154
091600127;750;725;737;6;173;750;0;0;0;0;0;173;2;171
091600128;850;839;850;9;172;850;0;0;0;0;0;172;0;172
091600129;1050;1027;1032;9;219;1050;0;0;0;0;0;219;3;216
091600130;850;831;841;8;134;849;1;0;0;0;0;134;0;134
091600131;650;647;648;7;160;649;1;0;0;0;0;160;1;159
091600132;900;814;837;11;279;900;0;0;0;0;0;279;4;275
091600133;850;806;814;13;179;849;1;0;0;0;0;179;1;178
091600134;300;261;266;8;77;222;1;77;1;0;76;0;0;0
091600135;700;706;704;5;164;699;1;0;0;0;0;164;1;163
091600136;700;665;666;4;148;699;1;0;0;0;0;148;2;146
091600137;850;830;831;0;181;849;1;0;0;0;0;181;5;176
091600138;750;748;748;7;207;749;1;0;0;0;0;207;4;203
091600139;550;539;539;3;125;549;1;0;0;0;0;125;3;122
091600140;750;736;736;7;201;750;0;0;0;0;0;201;3;198
091600141;250;234;234;6;61;188;1;61;4;1;56;0;0;0
091600142;400;374;374;6;115;399;1;0;0;0;0;115;0;115
091600143;350;329;333;4;45;349;1;0;0;0;0;45;0;45
091600144;400;399;399;7;72;399;1;0;0;0;0;72;0;72
091600145;400;374;386;13;85;399;1;0;0;0;0;85;0;85
091600146;400;377;377;5;125;399;1;0;0;0;0;125;28;97
091600147;400;408;408;11;120;399;1;0;0;0;0;120;0;120
091600148;500;490;495;7;121;499;1;0;0;0;0;121;0;121
091600149;346;344;344;5;119;346;0;0;0;0;0;119;0;119
091600150;300;305;314;3;83;299;1;0;0;0;0;83;1;82
091600151;250;214;223;7;77;172;1;77;3;0;74;0;0;0
091600152;300;313;306;7;99;299;1;0;0;0;0;99;0;99
091600153;600;615;614;7;67;599;1;0;0;0;0;67;0;67
091600154;300;254;256;8;97;202;1;97;4;0;93;0;0;0
091600155;350;338;339;7;75;349;1;0;0;0;0;75;0;75
091600156;250;232;232;3;112;137;1;112;3;0;109;0;0;0
091600157;150;132;132;6;57;92;1;57;2;1;54;0;0;0
091600158;100;46;46;50;55;44;1;55;2;2;51;0;0;0
091600159;150;127;127;7;75;74;1;75;19;0;56;0;0;0
091600160;100;60;60;0;58;42;0;58;1;1;56;0;0;0
091600161;100;47;47;2;49;50;1;49;1;0;48;0;0;0
091600162;100;49;49;4;45;53;2;45;1;1;43;0;0;0
091600163;100;41;41;8;48;50;2;48;0;0;48;0;0;0
091600164;100;56;56;0;54;46;0;54;0;0;54;0;0;0
091600165;200;59;59;5;64;136;0;64;15;0;49;0;0;0
091600166;100;61;61;5;64;36;0;64;5;1;58;0;0;0
091600167;100;56;56;6;55;45;0;55;0;0;55;0;0;0
091600168;100;53;53;6;56;43;1;56;4;0;52;0;0;0
091600169;100;57;57;3;60;39;1;60;4;0;56;0;0;0
091600170;100;77;77;3;71;28;1;71;2;0;69;0;0;0
092100001;400;1085;1093;7;307;399;1;0;0;0;0;307;5;302
092100002;300;1294;1306;4;247;300;0;0;0;0;0;247;1;246
092100003;300;948;958;1;195;300;0;0;0;0;0;195;2;193
092100004;300;955;963;5;224;297;3;0;0;0;0;224;2;222
092100005;300;1209;1200;9;291;299;1;0;0;0;0;291;3;288
092100006;300;1346;1358;12;264;299;1;0;0;0;0;264;2;262
092100007;400;1532;1547;17;301;400;0;0;0;0;0;301;4;297
092100008;400;1349;1357;4;344;400;0;0;0;0;0;344;1;343
092100009;300;1028;1028;6;251;300;0;0;0;0;0;251;5;246
092100010;300;1176;1190;6;238;299;1;0;0;0;0;238;0;238
092100011;400;1333;1333;10;350;400;0;0;0;0;0;350;2;348
092100012;200;191;191;5;69;130;1;69;2;0;67;0;0;0
092100013;400;1073;1091;6;296;400;0;0;0;0;0;296;2;294
092100014;300;221;221;10;89;210;1;89;2;0;87;0;0;0
092100015;100;75;76;4;46;53;1;46;5;0;41;0;0;0
092100016;300;281;281;6;80;217;3;80;4;0;76;0;0;0
092100017;100;344;344;6;79;100;0;0;0;0;0;79;0;79
092100018;200;470;470;10;147;199;1;0;0;0;0;147;0;147
092100019;300;216;218;9;43;256;1;43;3;0;40;0;0;0
092100020;200;284;294;9;102;200;0;0;0;0;0;102;0;102
092100021;200;616;618;12;137;199;1;0;0;0;0;137;3;134
092100022;100;16;61;8;24;75;1;24;1;0;23;0;0;0
092100023;200;138;140;8;53;146;1;53;1;0;52;0;0;0
092100024;200;387;388;6;133;200;0;0;0;0;0;133;0;133
092100025;200;594;593;9;167;200;0;0;0;0;0;167;2;165
092100026;200;475;490;12;143;200;0;0;0;0;0;143;0;143
092100027;200;286;286;5;104;199;1;0;0;0;0;104;0;104
092100028;100;92;92;6;45;54;1;45;0;0;45;0;0;0
092100029;300;1000;1000;9;238;299;1;0;0;0;0;238;0;238
092100030;193;193;194;8;45;147;1;45;1;0;44;0;0;0
092100031;100;52;53;8;25;74;1;25;1;1;23;0;0;0
092100032;100;45;45;6;12;87;1;12;0;0;12;0;0;0
092100033;200;452;454;4;141;200;0;0;0;0;0;141;1;140
092100034;300;980;1006;8;255;299;1;0;0;0;0;255;0;255
092100035;200;342;349;6;138;200;0;0;0;0;0;138;0;138
092100036;200;516;516;8;142;200;0;0;0;0;0;142;0;142
092100037;200;645;645;8;195;200;0;0;0;0;0;195;0;195
092100038;200;498;502;8;149;199;1;0;0;0;0;149;0;149
092100039;200;190;192;6;79;120;1;79;2;0;77;0;0;0
092100040;200;773;777;9;153;199;1;0;0;0;0;153;0;153
092100041;100;89;91;5;22;77;1;22;0;0;22;0;0;0
092100042;200;124;117;7;61;138;1;61;3;0;58;0;0;0
092100043;200;837;837;6;169;199;1;0;0;0;0;169;0;169
092100044;100;305;305;4;53;100;0;0;0;0;0;53;0;53
092100045;200;474;483;7;127;199;1;0;0;0;0;127;1;126
092100046;200;659;671;5;157;199;1;0;0;0;0;157;1;156
092100047;300;811;822;6;226;299;1;0;0;0;0;226;0;226
092100048;300;199;206;4;76;223;1;76;5;0;71;0;0;0
092100049;200;311;335;7;127;199;1;0;0;0;0;127;1;126
092100050;200;139;137;4;59;141;0;59;0;0;59;0;0;0
092100051;200;425;440;6;173;200;0;0;0;0;0;173;1;172
092100052;300;238;247;6;104;195;1;104;8;0;96;0;0;0
092100053;200;115;115;7;55;144;1;55;0;0;55;0;0;0
092100054;200;96;97;6;47;153;0;47;3;0;44;0;0;0
092100055;100;89;89;6;33;66;1;33;1;0;32;0;0;0
092100056;400;1129;1126;10;292;399;1;0;0;0;0;292;2;290
092100057;200;113;113;6;116;84;0;116;0;0;116;0;0;0
092100058;100;52;52;0;49;51;0;49;0;0;49;0;0;0
092100059;100;29;29;0;28;72;0;28;0;0;28;0;0;0
092100060;100;37;37;0;37;63;0;37;0;0;37;0;0;0
092100061;100;56;56;1;57;43;0;57;0;0;57;0;0;0
092100062;100;35;35;0;35;65;0;35;0;0;35;0;0;0
092100063;100;22;22;11;29;70;1;29;1;1;27;0;0;0
093500001;300;282;291;4;123;176;1;123;2;2;119;0;0;0
093500002;700;601;601;6;140;700;0;0;0;0;0;140;1;139
093500003;300;292;299;7;126;173;1;126;2;0;124;0;0;0
093500004;300;319;323;7;98;299;1;0;0;0;0;98;0;98
093500005;300;250;250;4;111;188;1;111;0;6;105;0;0;0
093500006;300;359;359;9;86;218;1;81;0;2;79;5;0;5
093500007;300;341;341;6;108;299;1;0;0;0;0;108;0;108
093500008;300;281;281;4;79;220;1;79;6;1;72;0;0;0
093500009;300;304;333;7;122;299;1;0;0;0;0;122;0;122
093500010;300;320;320;6;145;299;1;0;0;0;0;145;0;145
093500011;800;812;824;10;189;799;1;0;0;0;0;189;0;189
093500012;500;488;491;6;183;500;0;0;0;0;0;183;1;182
093500013;500;442;445;2;176;499;1;0;0;0;0;176;2;174
093500014;200;183;183;3;57;142;1;57;1;2;54;0;0;0
093500015;300;264;264;9;90;209;1;90;3;1;86;0;0;0
093500016;100;97;97;2;72;27;1;72;3;1;68;0;0;0
093500017;1000;940;942;4;249;999;1;0;0;0;0;249;0;249
093500018;300;327;328;4;117;300;0;0;0;0;0;117;0;117
093500019;600;384;684;1;384;599;1;0;0;0;0;384;0;384
093500020;800;792;823;5;324;799;1;0;0;0;0;324;0;324
093500021;900;924;936;3;279;899;1;0;0;0;0;279;0;279
093500022;500;439;443;4;163;499;1;0;0;0;0;163;0;163
093500023;200;223;225;3;77;122;1;77;0;1;76;0;0;0
093500024;200;129;130;4;70;129;1;70;1;0;69;0;0;0
093500025;200;173;173;1;57;142;1;57;2;0;55;0;0;0
093500026;100;41;55;3;44;56;0;44;0;0;44;0;0;0
093500027;300;379;382;3;143;300;0;0;0;0;0;143;0;143
093500028;100;129;132;2;83;16;1;83;2;0;81;0;0;0
093500029;100;73;73;5;41;58;1;41;0;0;41;0;0;0
093500030;300;306;306;0;114;300;0;0;0;0;0;114;0;114
093500031;300;249;257;6;102;196;2;102;1;1;100;0;0;0
093500032;300;268;269;3;121;179;0;121;1;2;118;0;0;0
093500033;200;142;142;2;55;144;1;55;0;0;55;0;0;0
093500034;100;104;104;4;68;31;1;68;0;0;68;0;0;0
093500035;100;119;119;5;39;60;1;39;5;0;34;0;0;0
093500036;100;129;130;8;48;51;1;48;0;0;48;0;0;0
093500037;100;89;89;5;57;42;1;57;0;1;56;0;0;0
093500038;300;248;248;6;95;204;1;95;1;0;94;0;0;0
093500039;200;100;100;1;101;98;1;101;0;0;101;0;0;0
093500040;100;80;80;3;82;17;1;82;0;0;82;0;0;0
100400001;500;550;552;7;184;499;1;0;0;0;0;184;5;179
100400002;400;516;516;4;140;399;1;0;0;0;0;140;3;137
100400003;600;627;628;2;183;599;1;0;0;0;0;183;0;183
100400004;400;495;496;8;139;399;1;0;0;0;0;139;0;139
100400005;600;669;669;7;208;599;1;0;0;0;0;208;3;205
100400006;700;750;755;6;278;699;1;0;0;0;0;278;3;275
100400007;300;346;348;8;164;299;1;0;0;0;0;164;2;162
100400008;500;540;541;6;218;499;1;0;0;0;0;218;6;212
100400009;500;560;561;5;229;499;1;0;0;0;0;229;4;225
100400010;300;241;244;9;141;157;2;141;4;3;134;0;0;0
100400011;300;360;360;2;154;299;1;0;0;0;0;154;2;152
100400012;200;209;210;5;101;98;1;101;6;1;94;0;0;0
100400013;100;80;81;4;41;57;2;41;1;0;40;0;0;0
100400014;200;164;167;6;100;98;2;100;0;2;98;0;0;0
100400015;100;63;63;7;40;59;1;40;1;0;39;0;0;0
100400016;100;96;96;6;66;32;2;66;0;0;66;0;0;0
100400017;100;98;99;6;53;46;1;53;1;0;52;0;0;0
100400018;100;73;72;5;53;46;1;53;3;0;50;0;0;0
100400019;100;37;38;7;22;76;2;22;0;2;20;0;0;0
100400020;100;79;80;6;55;44;1;55;1;0;54;0;0;0
100400021;100;37;38;5;29;70;1;29;0;1;28;0;0;0
100400022;100;42;42;8;29;70;1;29;0;1;28;0;0;0
100400023;200;118;118;7;55;144;1;55;1;0;54;0;0;0
100400024;100;3;13;8;11;87;2;11;0;0;11;0;0;0
100400025;100;33;33;6;35;64;1;35;1;1;33;0;0;0
100400026;100;22;22;8;10;89;1;10;0;0;10;0;0;0
100400027;100;13;13;0;13;87;0;13;0;1;12;0;0;0
100500001;470;470;470;1;163;469;1;0;0;0;0;163;3;160
100500002;500;517;517;2;218;499;1;0;0;0;0;218;3;215
100500003;340;329;329;4;156;339;1;0;0;0;0;156;0;156
100500004;300;266;263;3;127;172;1;127;1;2;124;0;0;0
100500005;300;323;324;7;174;299;1;0;0;0;0;174;1;173
100500006;60;46;46;4;35;24;1;35;0;0;35;0;0;0
100500007;60;46;47;7;41;18;1;41;0;0;41;0;0;0
100500008;50;26;27;7;18;31;1;18;0;1;17;0;0;0
100500009;80;58;58;6;43;36;1;43;2;0;41;0;0;0
100500010;40;28;28;7;24;15;1;24;2;0;22;0;0;0
102700001;350;324;324;0;165;184;1;165;3;1;161;0;0;0
102700002;450;461;461;2;218;449;1;0;0;0;0;218;2;216
102700003;500;473;473;3;172;499;1;0;0;0;0;172;0;172
102700004;350;356;356;4;136;349;1;0;0;0;0;136;3;133
102700005;250;231;231;1;98;151;1;98;4;1;93;0;0;0
102700006;250;219;219;2;99;150;1;99;2;3;94;0;0;0
102700007;250;241;241;1;88;161;1;88;1;0;87;0;0;0
102700008;300;285;285;2;125;174;1;125;3;2;120;0;0;0
102700009;300;276;276;6;114;185;1;114;3;1;110;0;0;0
102700010;50;44;44;1;37;12;1;37;2;0;35;0;0;0
102700011;150;115;115;5;79;69;2;79;3;1;75;0;0;0
102700012;50;49;49;2;27;22;1;27;1;0;26;0;0;0
102700013;50;48;48;3;31;18;1;31;0;0;31;0;0;0
102700014;50;48;48;6;26;23;1;26;0;0;26;0;0;0
102700015;100;64;64;2;36;63;1;36;1;0;35;0;0;0
102700016;50;28;28;4;28;21;1;28;0;0;28;0;0;0
102900001;1000;1025;1025;6;116;999;1;0;0;0;0;116;5;111
102900002;1000;943;945;3;305;999;1;0;0;0;0;305;5;300
102900003;1000;922;923;2;259;999;1;0;0;0;0;259;2;257
102900004;1000;1010;1012;6;351;999;1;0;0;0;0;351;13;338
102900005;1000;948;951;2;215;999;1;0;0;0;0;215;5;210
102900006;500;555;555;0;183;499;1;0;0;0;0;183;0;183
102900007;499;239;598;6;245;498;1;0;0;0;0;245;6;239
102900008;600;672;672;5;232;599;1;0;0;0;0;232;4;228
102900009;900;951;952;7;312;899;1;0;0;0;0;312;5;307
102900010;700;718;720;4;246;699;1;0;0;0;0;246;6;240
102900011;600;548;552;5;200;599;1;0;0;0;0;200;2;198
102900012;700;687;689;7;288;699;1;0;0;0;0;288;5;283
102900013;900;907;908;8;254;899;1;0;0;0;0;254;7;247
102900014;1000;940;1010;5;154;999;1;0;0;0;0;154;3;151
102900015;1000;958;959;10;307;999;1;0;0;0;0;307;3;304
102900016;1000;997;998;4;90;999;1;0;0;0;0;90;1;89
102900017;900;927;929;8;116;899;1;0;0;0;0;116;1;115
102900018;1000;966;968;8;250;999;1;0;0;0;0;250;4;246
102900019;800;815;818;5;162;799;1;0;0;0;0;162;5;157
102900020;1000;995;999;9;283;999;1;0;0;0;0;283;5;278
102900021;900;922;922;5;334;899;1;0;0;0;0;334;6;328
102900022;700;693;693;8;264;699;1;0;0;0;0;264;4;260
102900023;1000;1068;1068;5;140;999;1;0;0;0;0;140;0;140
102900024;900;958;960;9;340;899;1;0;0;0;0;340;4;336
102900025;900;884;887;5;294;899;1;0;0;0;0;294;6;288
102900026;700;763;763;4;261;699;1;0;0;0;0;261;5;256
102900027;800;776;774;2;262;799;1;0;0;0;0;262;7;255
102900028;986;986;986;7;348;985;1;0;0;0;0;348;5;343
102900029;800;831;831;4;216;799;1;0;0;0;0;216;7;209
102900030;700;715;718;5;207;699;1;0;0;0;0;207;1;206
102900031;1000;979;981;5;366;999;1;0;0;0;0;366;8;358
102900032;1000;1080;1080;8;255;999;1;0;0;0;0;255;1;254
102900033;1000;995;997;7;308;999;1;0;0;0;0;308;0;308
102900034;700;776;776;9;230;699;1;0;0;0;0;230;5;225
102900035;800;824;825;7;275;800;0;0;0;0;0;275;2;273
102900036;700;699;701;8;228;699;1;0;0;0;0;228;2;226
102900037;800;804;807;8;257;799;1;0;0;0;0;257;2;255
102900038;800;845;848;7;327;799;1;0;0;0;0;327;7;320
102900039;1000;925;926;8;341;998;2;0;0;0;0;341;2;339
102900040;700;729;731;7;246;699;1;0;0;0;0;246;3;243
102900041;700;759;759;4;276;699;1;0;0;0;0;276;4;272
102900042;800;874;875;7;257;799;1;0;0;0;0;257;4;253
102900043;600;614;616;7;189;599;1;0;0;0;0;189;1;188
102900044;900;914;915;1;344;899;1;0;0;0;0;344;9;335
102900045;1000;968;969;4;320;999;1;0;0;0;0;320;6;314
102900046;700;729;730;0;236;699;1;0;0;0;0;236;4;232
102900047;800;813;814;3;259;799;1;0;0;0;0;259;3;256
102900048;1000;1005;1006;5;334;999;1;0;0;0;0;334;7;327
102900049;700;707;707;4;228;699;1;0;0;0;0;228;6;222
102900050;1000;979;983;6;136;999;1;0;0;0;0;136;2;134
102900051;1000;926;926;6;260;999;1;0;0;0;0;260;3;257
102900052;700;781;781;3;280;699;1;0;0;0;0;280;3;277
102900053;600;596;596;8;193;599;1;0;0;0;0;193;3;190
102900054;1000;934;938;6;297;999;1;0;0;0;0;297;2;295
102900055;1000;974;975;6;317;999;1;0;0;0;0;317;6;311
102900056;900;899;899;11;230;899;1;0;0;0;0;230;7;223
102900057;700;738;738;6;238;699;1;0;0;0;0;238;1;237
102900058;800;858;858;4;136;799;1;0;0;0;0;136;1;135
102900059;800;788;792;5;177;799;1;0;0;0;0;177;2;175
102900060;700;693;695;8;183;699;1;0;0;0;0;183;4;179
102900061;600;649;646;6;173;599;1;0;0;0;0;173;2;171
102900062;100;50;50;7;36;63;1;36;0;0;36;0;0;0
102900063;600;574;575;4;153;599;1;0;0;0;0;153;1;152
102900064;200;219;220;5;86;112;2;86;3;0;83;0;0;0
102900065;100;49;49;6;24;75;1;24;0;0;24;0;0;0
102900066;100;26;26;6;11;88;1;11;0;0;11;0;0;0
102900067;100;82;82;7;35;64;1;35;1;0;34;0;0;0
102900068;100;73;73;4;24;75;1;24;0;0;24;0;0;0
102900069;100;18;18;7;15;84;1;15;0;0;15;0;0;0
102900070;100;14;14;7;10;89;1;10;0;0;10;0;0;0
102900071;200;201;201;3;64;135;1;64;0;0;64;0;0;0
102900072;300;251;252;5;92;207;1;92;4;1;87;0;0;0
102900073;100;61;61;6;19;80;1;19;0;0;19;0;0;0
102900074;500;518;520;4;186;499;1;0;0;0;0;186;2;184
102900075;400;424;425;0;165;399;1;0;0;0;0;165;4;161
102900076;300;267;267;4;112;187;1;112;4;5;103;0;0;0
102900077;300;362;362;4;147;299;1;0;0;0;0;147;3;144
102900078;100;92;92;5;42;56;2;42;1;0;41;0;0;0
102900079;100;40;40;8;19;80;1;19;1;1;17;0;0;0
102900080;800;776;777;6;283;799;1;0;0;0;0;283;3;280
102900081;900;876;877;3;306;899;1;0;0;0;0;306;6;300
102900082;600;581;583;3;186;599;1;0;0;0;0;186;0;186
102900083;100;28;28;4;17;81;2;17;1;0;16;0;0;0
102900084;100;126;127;5;69;30;1;69;0;0;69;0;0;0
102900085;100;148;148;5;79;20;1;79;0;0;79;0;0;0
102900086;100;123;123;6;42;57;1;42;0;1;41;0;0;0
102900087;600;560;560;3;187;599;1;0;0;0;0;187;1;186
102900088;800;833;833;1;282;799;1;0;0;0;0;282;7;275
102900089;200;158;158;4;78;121;1;78;0;2;76;0;0;0
102900090;800;872;872;4;220;799;1;0;0;0;0;220;5;215
102900091;800;770;771;6;269;799;1;0;0;0;0;269;3;266
102900092;100;109;109;4;65;34;1;65;3;1;61;0;0;0
102900093;700;746;746;2;260;699;1;0;0;0;0;260;6;254
102900094;100;85;85;7;42;57;1;42;0;1;41;0;0;0
102900095;100;120;120;6;57;40;3;57;2;1;54;0;0;0
102900096;400;418;418;10;98;399;1;0;0;0;0;98;1;97
102900097;100;120;120;9;58;41;1;58;1;1;56;0;0;0
102900098;200;230;230;3;120;79;1;120;5;0;115;0;0;0
102900099;100;81;81;4;54;45;1;54;1;0;53;0;0;0
102900100;300;346;347;3;171;299;1;0;0;0;0;171;1;170
102900101;200;201;202;5;93;106;1;93;5;1;87;0;0;0
102900102;500;530;530;7;181;499;1;0;0;0;0;181;2;179
102900103;100;76;76;6;52;47;1;52;2;1;49;0;0;0
102900104;400;461;462;9;182;399;1;0;0;0;0;182;5;177
102900105;300;301;302;3;134;164;2;134;4;0;130;0;0;0
102900106;700;684;684;3;260;699;1;0;0;0;0;260;4;256
102900107;200;156;156;4;75;124;1;75;4;0;71;0;0;0
102900108;800;818;818;3;223;799;1;0;0;0;0;223;1;222
102900109;100;73;73;6;57;40;3;57;10;1;46;0;0;0
102900110;100;33;33;20;33;66;1;33;0;0;33;0;0;0
102900111;100;52;52;19;50;49;1;50;2;1;47;0;0;0
102900112;100;14;14;7;19;80;1;19;4;0;15;0;0;0
102900113;100;19;19;2;21;79;0;21;4;0;17;0;0;0
103100001;280;313;313;5;119;279;1;0;0;0;0;119;1;118
103100002;40;24;24;5;17;22;1;17;1;0;16;0;0;0
103100003;120;108;108;7;55;63;2;55;1;2;52;0;0;0
103100004;50;35;35;6;35;14;1;35;2;0;33;0;0;0
103100005;100;89;89;7;56;43;1;56;2;2;52;0;0;0
103100006;80;66;67;6;44;35;1;44;0;0;44;0;0;0
103100007;65;54;54;5;34;30;1;34;0;0;34;0;0;0
103100008;40;29;29;5;23;16;1;23;0;0;23;0;0;0
103100009;45;32;32;7;24;20;1;24;0;0;24;0;0;0
103100010;120;111;111;6;34;85;1;34;0;0;34;0;0;0
103100011;40;16;19;6;22;17;1;22;3;0;19;0;0;0
103100012;350;460;460;6;204;349;1;0;0;0;0;204;4;200
103100013;90;76;76;6;52;37;1;52;1;0;51;0;0;0
103100014;55;43;43;8;39;15;1;39;1;1;37;0;0;0
103100015;75;64;64;5;39;35;1;39;1;1;37;0;0;0
103100016;60;47;47;6;17;42;1;17;0;0;17;0;0;0
103100017;110;98;98;7;45;64;1;45;0;0;45;0;0;0
103100018;40;17;24;5;17;22;1;17;0;0;17;0;0;0
103100019;40;24;24;8;12;27;1;12;0;0;12;0;0;0
103800001;670;667;673;2;244;669;1;0;0;0;0;244;5;239
103800002;700;699;699;1;280;699;1;0;0;0;0;280;6;274
103800003;740;733;739;3;239;739;1;0;0;0;0;239;5;234
103800004;50;31;31;7;24;25;1;24;0;0;24;0;0;0
103800005;130;117;117;5;60;68;2;60;6;1;53;0;0;0
103800006;155;141;141;4;74;78;3;74;0;1;73;0;0;0
103800007;30;17;17;7;22;7;1;22;0;0;22;0;0;0
103800008;25;14;14;0;13;11;1;13;0;2;11;0;0;0
104100001;400;382;387;0;137;399;1;0;0;0;0;137;1;136
104100002;700;648;651;0;255;699;1;0;0;0;0;255;5;250
104100003;800;756;756;1;356;799;1;0;0;0;0;356;3;353
104100004;900;889;890;0;401;899;1;0;0;0;0;401;3;398
104100005;1000;949;951;5;426;999;1;0;0;0;0;426;4;422
104100006;800;804;804;2;325;799;1;0;0;0;0;325;3;322
104100007;800;841;840;1;366;799;1;0;0;0;0;366;4;362
104100008;500;565;565;0;187;499;1;0;0;0;0;187;0;187
104100009;500;466;467;0;184;499;1;0;0;0;0;184;3;181
104100010;100;23;23;0;23;76;1;23;2;0;21;0;0;0
104800001;500;490;490;4;158;499;1;0;0;0;0;158;0;158
104800002;700;704;705;4;225;699;1;0;0;0;0;225;3;222
104800003;700;750;751;4;230;699;1;0;0;0;0;230;1;229
104800004;600;651;651;0;220;599;1;0;0;0;0;220;1;219
104800005;500;520;520;5;164;499;1;0;0;0;0;164;2;162
104800006;600;584;585;3;208;599;1;0;0;0;0;208;0;208
104800007;400;395;396;6;170;399;1;0;0;0;0;170;0;170
104800008;500;457;457;4;217;499;1;0;0;0;0;217;2;215
104800009;400;372;373;3;158;399;1;0;0;0;0;158;4;154
104800010;600;639;639;6;243;599;1;0;0;0;0;243;2;241
104800011;600;652;654;5;269;599;1;0;0;0;0;269;6;263
104800012;500;445;448;6;188;499;1;0;0;0;0;188;2;186
104800013;700;682;682;6;299;699;1;0;0;0;0;299;3;296
104800014;400;405;405;4;185;399;1;0;0;0;0;185;7;178
104800015;700;654;660;7;271;699;1;0;0;0;0;271;1;270
104800016;600;610;611;6;234;599;1;0;0;0;0;234;5;229
104800017;600;633;634;3;223;599;1;0;0;0;0;223;2;221
104800018;700;690;690;0;239;699;1;0;0;0;0;239;3;236
104800019;900;987;990;7;193;899;1;0;0;0;0;193;0;193
104800020;900;876;876;2;348;899;1;0;0;0;0;348;8;340
104800021;800;691;692;1;253;799;1;0;0;0;0;253;7;246
104800022;900;822;822;7;306;899;1;0;0;0;0;306;5;301
104800023;900;888;889;4;278;899;1;0;0;0;0;278;10;268
104800024;800;863;863;4;325;799;1;0;0;0;0;325;8;317
104800025;800;839;839;6;289;799;1;0;0;0;0;289;7;282
104800026;800;806;806;6;273;799;1;0;0;0;0;273;1;272
104800027;500;460;462;0;177;499;1;0;0;0;0;177;2;175
104800028;700;656;656;3;295;699;1;0;0;0;0;295;7;288
104800029;600;575;575;0;221;599;1;0;0;0;0;221;2;219
104800030;700;730;730;3;301;699;1;0;0;0;0;301;5;296
104800031;700;691;691;3;303;699;1;0;0;0;0;303;2;301
104800032;500;542;542;1;193;499;1;0;0;0;0;193;1;192
104800033;700;653;654;1;234;699;1;0;0;0;0;234;2;232
104800034;900;892;894;1;272;899;1;0;0;0;0;272;4;268
104800035;700;717;717;7;252;699;1;0;0;0;0;252;3;249
104800036;600;598;598;4;206;599;1;0;0;0;0;206;2;204
104800037;400;441;441;4;164;399;1;0;0;0;0;164;3;161
104800038;700;668;668;0;241;699;1;0;0;0;0;241;3;238
104800039;700;704;705;7;273;699;1;0;0;0;0;273;2;271
104800040;700;732;733;2;300;699;1;0;0;0;0;300;6;294
104800041;800;754;754;6;342;799;1;0;0;0;0;342;5;337
104800042;800;772;774;6;267;799;1;0;0;0;0;267;3;264
104800043;500;467;467;6;170;499;1;0;0;0;0;170;1;169
104800044;600;574;574;0;250;599;1;0;0;0;0;250;3;247
104800045;700;689;690;4;245;699;1;0;0;0;0;245;2;243
104800046;800;817;821;6;226;799;1;0;0;0;0;226;5;221
104800047;900;919;921;3;210;899;1;0;0;0;0;210;2;208
104800048;500;528;528;1;168;499;1;0;0;0;0;168;3;165
104800049;800;788;789;3;313;799;1;0;0;0;0;313;5;308
104800050;500;485;498;2;203;499;1;0;0;0;0;203;1;202
104800051;600;593;609;3;233;599;1;0;0;0;0;233;1;232
104800052;100;30;30;9;37;62;1;37;0;0;37;0;0;0
104800053;700;651;654;3;259;699;1;0;0;0;0;259;3;256
104800054;800;767;767;1;297;799;1;0;0;0;0;297;9;288
104800055;200;150;147;4;82;117;1;82;1;1;80;0;0;0
104800056;200;126;126;5;70;128;2;70;9;0;61;0;0;0
104800057;600;558;559;5;217;599;1;0;0;0;0;217;2;215
104800058;500;505;506;1;183;499;1;0;0;0;0;183;2;181
104800059;600;601;601;3;233;599;1;0;0;0;0;233;2;231
104800060;300;289;291;3;143;156;1;143;5;4;134;0;0;0
104800061;100;83;83;5;52;47;1;52;1;0;51;0;0;0
104800062;100;22;22;6;14;85;1;14;0;0;14;0;0;0
104800063;200;205;206;5;107;90;3;107;3;0;104;0;0;0
104800064;100;40;40;7;35;63;2;35;1;0;34;0;0;0
104800065;100;61;64;5;41;58;1;41;1;1;39;0;0;0
104800066;100;102;102;6;66;32;2;66;2;0;64;0;0;0
104800067;400;399;399;3;125;399;1;0;0;0;0;125;8;117
104800068;500;501;502;5;163;499;1;0;0;0;0;163;4;159
104800069;500;537;538;1;205;499;1;0;0;0;0;205;1;204
104800070;600;605;606;3;151;599;1;0;0;0;0;151;1;150
104800071;400;361;365;2;130;399;1;0;0;0;0;130;0;130
104800072;500;476;477;0;86;499;1;0;0;0;0;86;0;86
104800074;100;23;23;7;30;68;2;30;0;1;29;0;0;0
104800076;100;50;50;3;51;48;1;51;3;1;47;0;0;0
105000001;200;189;189;5;123;75;2;123;3;1;119;0;0;0
105000002;30;25;25;6;24;5;1;24;1;0;23;0;0;0
105000003;40;31;31;6;29;10;1;29;0;0;29;0;0;0
105000004;55;57;57;3;40;14;1;40;4;0;36;0;0;0
105000005;50;50;50;5;36;13;1;36;3;0;33;0;0;0
105000006;30;22;22;5;19;10;1;19;0;0;19;0;0;0
105000007;29;22;27;7;22;7;0;22;0;1;21;0;0;0
105000008;29;21;21;7;25;3;1;25;0;0;25;0;0;0
105000009;40;33;33;5;24;15;1;24;2;0;22;0;0;0
110200001;500;655;660;4;348;500;0;0;0;0;0;348;3;345
110200002;600;574;574;0;291;599;1;0;0;0;0;291;1;290
110200003;400;452;456;1;191;399;1;0;0;0;0;191;2;189
110200004;600;579;579;0;267;332;1;267;2;1;264;0;0;0
110200005;100;54;54;4;45;54;1;45;1;1;43;0;0;0
110200006;100;105;106;7;58;40;2;58;3;0;55;0;0;0
110200007;100;56;56;8;40;59;1;40;0;0;40;0;0;0
111700001;600;624;624;1;208;599;1;0;0;0;0;208;1;207
111700002;500;539;542;3;228;499;1;0;0;0;0;228;2;226
111700003;500;517;517;1;124;500;0;0;0;0;0;124;1;123
111700004;800;775;776;2;87;799;1;0;0;0;0;87;0;87
111700005;800;796;796;1;117;799;1;0;0;0;0;117;1;116
111700006;450;452;452;4;173;449;1;0;0;0;0;173;2;171
111700007;350;318;320;4;149;198;3;149;7;3;139;0;0;0
111700008;100;90;90;3;56;42;2;56;3;0;53;0;0;0
111800001;600;691;691;9;185;599;1;0;0;0;0;185;1;184
111800002;600;630;631;7;291;599;1;0;0;0;0;291;6;285
111800003;500;574;576;7;242;499;1;0;0;0;0;242;4;238
111800004;500;570;570;7;227;499;1;0;0;0;0;227;1;226
111800005;500;507;511;8;222;500;0;0;0;0;0;222;1;221
111800006;700;765;765;9;310;699;1;0;0;0;0;310;5;305
111800007;500;549;550;10;264;499;1;0;0;0;0;264;4;260
111800008;600;620;621;6;232;599;1;0;0;0;0;232;10;222
111800009;400;459;460;0;180;399;1;0;0;0;0;180;3;177
111800010;500;505;505;7;205;499;1;0;0;0;0;205;5;200
111800011;500;507;507;10;181;499;1;0;0;0;0;181;3;178
111800012;400;483;483;4;196;399;1;0;0;0;0;196;1;195
111800013;600;680;681;7;249;599;1;0;0;0;0;249;6;243
111800014;500;573;575;9;214;499;1;0;0;0;0;214;1;213
111800015;700;713;714;7;339;699;1;0;0;0;0;339;3;336
111800016;500;562;562;8;230;499;1;0;0;0;0;230;2;228
111800017;400;489;489;9;233;399;1;0;0;0;0;233;0;233
111800018;500;547;547;5;216;499;1;0;0;0;0;216;2;214
111800019;600;683;684;7;239;599;1;0;0;0;0;239;2;237
111800020;700;790;790;4;290;699;1;0;0;0;0;290;3;287
111800021;600;646;649;5;285;599;1;0;0;0;0;285;6;279
111800022;400;473;475;5;199;399;1;0;0;0;0;199;1;198
111800023;400;468;468;3;211;399;1;0;0;0;0;211;4;207
111800024;500;517;518;8;208;499;1;0;0;0;0;208;5;203
111800025;500;501;502;8;184;499;1;0;0;0;0;184;1;183
111800026;600;643;643;6;270;599;1;0;0;0;0;270;7;263
111800027;500;532;533;5;239;499;1;0;0;0;0;239;4;235
111800028;600;617;623;7;223;599;1;0;0;0;0;223;0;223
111800029;600;643;647;5;194;599;1;0;0;0;0;194;3;191
111800030;600;641;643;4;192;599;1;0;0;0;0;192;3;189
111800031;600;657;652;6;222;599;1;0;0;0;0;222;6;216
111800032;600;646;648;0;206;599;1;0;0;0;0;206;3;203
111800033;400;454;454;7;101;399;1;0;0;0;0;101;6;95
111800034;400;431;431;7;96;399;1;0;0;0;0;96;1;95
111800035;600;601;603;5;268;599;1;0;0;0;0;268;3;265
111800036;500;510;511;7;218;499;1;0;0;0;0;218;1;217
111800037;300;223;223;4;92;207;1;92;3;1;88;0;0;0
111800038;500;525;538;2;207;499;1;0;0;0;0;207;5;202
111800040;200;186;188;6;82;117;1;82;2;0;80;0;0;0
111800041;300;265;267;7;183;114;3;183;6;1;176;0;0;0
111800042;800;803;806;7;317;799;1;0;0;0;0;317;4;313
111800044;500;573;580;6;277;500;0;0;0;0;0;277;2;275
111800046;400;489;489;2;202;400;0;0;0;0;0;202;1;201
111800048;500;502;502;2;189;499;1;0;0;0;0;189;0;189
111800050;200;145;146;3;108;91;1;108;6;1;101;0;0;0
111800051;100;80;80;6;53;46;1;53;0;0;53;0;0;0
111800052;500;576;591;5;247;499;1;0;0;0;0;247;0;247
111800054;200;146;146;2;92;107;1;92;6;0;86;0;0;0
111800055;200;100;102;4;84;115;1;84;1;0;83;0;0;0
111800057;100;34;34;7;28;71;1;28;0;0;28;0;0;0
111800058;200;184;184;0;101;98;1;101;3;0;98;0;0;0
111800059;200;122;122;6;96;103;1;96;7;1;88;0;0;0
111800060;100;64;69;7;44;55;1;44;0;0;44;0;0;0
111800061;200;102;102;7;80;117;3;80;2;0;78;0;0;0
111800062;100;88;89;3;65;34;1;65;0;1;64;0;0;0
111800063;300;227;228;3;118;181;1;118;1;3;114;0;0;0
111800064;300;215;216;7;124;175;1;124;4;4;116;0;0;0
111800065;300;204;204;4;110;189;1;110;4;1;105;0;0;0
111800066;100;78;79;5;58;41;1;58;3;0;55;0;0;0
111800067;700;791;791;0;276;699;1;0;0;0;0;276;4;272
111800068;700;752;754;8;275;699;1;0;0;0;0;275;3;272
111800069;500;504;504;4;143;499;1;0;0;0;0;143;2;141
111800070;600;688;689;5;254;599;1;0;0;0;0;254;6;248
111800071;800;885;885;6;186;799;1;0;0;0;0;186;0;186
111800072;500;716;716;6;115;500;0;0;0;0;0;115;0;115
111800074;200;176;176;4;102;96;2;102;6;0;96;0;0;0
111800075;200;196;196;5;91;108;1;91;4;2;85;0;0;0
111800076;900;850;857;3;259;900;0;0;0;0;0;259;5;254
111800078;200;117;113;4;84;113;3;84;3;0;81;0;0;0
111800079;300;270;270;7;104;195;1;104;0;1;103;0;0;0
111800080;300;227;227;3;115;184;1;115;1;4;110;0;0;0
111800081;100;38;32;6;25;73;2;25;1;0;24;0;0;0
111800082;600;608;608;7;232;599;1;0;0;0;0;232;3;229
111800083;600;668;670;5;243;599;1;0;0;0;0;243;6;237
111800084;500;530;531;6;197;499;1;0;0;0;0;197;1;196
111800085;700;753;753;5;281;699;1;0;0;0;0;281;2;279
111800086;500;576;576;2;205;499;1;0;0;0;0;205;4;201
111800087;400;488;490;4;239;399;1;0;0;0;0;239;1;238
111800088;400;476;477;7;219;399;1;0;0;0;0;219;2;217
111800089;500;586;586;5;257;499;1;0;0;0;0;257;8;249
111800090;400;437;439;4;181;399;1;0;0;0;0;181;2;179
111800091;600;643;645;7;266;599;1;0;0;0;0;266;7;259
111800092;700;719;719;9;340;698;2;0;0;0;0;340;1;339
111800093;700;789;791;6;302;699;1;0;0;0;0;302;9;293
111800094;500;590;590;10;214;499;1;0;0;0;0;214;2;212
111800096;500;546;546;0;153;499;1;0;0;0;0;153;2;151
111800097;100;78;78;5;45;54;1;45;0;0;45;0;0;0
111800098;100;43;43;6;29;70;1;29;1;2;26;0;0;0
111800099;400;482;488;7;215;399;1;0;0;0;0;215;2;213
111800100;489;489;489;1;201;488;1;0;0;0;0;201;0;201
111800101;500;521;522;5;236;499;1;0;0;0;0;236;8;228
111800102;100;15;15;44;52;47;1;52;0;2;50;0;0;0
111800103;100;58;58;23;68;31;1;68;6;2;60;0;0;0
111800104;100;34;34;12;42;57;1;42;4;0;38;0;0;0
111800105;100;19;19;12;31;68;1;31;2;0;29;0;0;0
111800106;200;123;123;24;91;108;1;91;9;1;81;0;0;0
111800108;100;52;52;0;51;48;1;51;0;0;51;0;0;0
111900001;800;831;832;7;246;799;1;0;0;0;0;246;4;242
111900002;700;660;661;0;230;699;1;0;0;0;0;230;0;230
111900003;800;760;762;2;281;516;3;281;0;4;277;0;0;0
111900004;500;536;538;0;224;499;1;0;0;0;0;224;1;223
111900005;700;734;734;3;310;700;0;0;0;0;0;310;3;307
111900006;800;807;809;1;352;800;0;0;0;0;0;352;4;348
111900007;800;820;828;0;230;800;0;0;0;0;0;230;4;226
111900008;900;902;904;6;85;899;1;0;0;0;0;85;0;85
111900009;800;779;781;0;234;799;1;0;0;0;0;234;4;230
111900010;900;917;916;0;100;899;1;0;0;0;0;100;0;100
111900011;500;505;506;3;167;499;1;0;0;0;0;167;0;167
111900012;300;300;300;1;140;158;2;140;2;1;137;0;0;0
111900013;600;609;617;4;239;599;1;0;0;0;0;239;2;237
111900014;400;462;464;3;166;400;0;0;0;0;0;166;2;164
111900015;300;332;332;3;107;299;1;0;0;0;0;107;1;106
111900016;100;96;96;2;70;29;1;70;1;0;69;0;0;0
111900017;100;65;66;6;48;50;2;48;1;0;47;0;0;0
111900018;600;640;645;2;179;599;1;0;0;0;0;179;1;178
111900019;600;638;638;3;206;600;0;0;0;0;0;206;2;204
111900020;500;575;576;1;185;499;1;0;0;0;0;185;2;183
111900021;400;468;470;0;163;399;1;0;0;0;0;163;3;160
111900022;800;812;812;1;166;799;1;0;0;0;0;166;0;166
111900023;600;616;618;3;185;599;1;0;0;0;0;185;3;182
111900024;500;490;490;4;105;500;0;0;0;0;0;105;0;105
111900025;400;428;428;3;99;399;1;0;0;0;0;99;0;99
111900026;100;12;12;16;19;80;1;19;0;0;19;0;0;0
111900027;100;76;76;13;41;58;1;41;2;0;39;0;0;0
111900028;100;18;18;0;16;82;2;16;2;0;14;0;0;0
113300001;300;264;264;3;103;196;1;103;0;0;103;0;0;0
113300002;500;458;460;2;218;499;1;0;0;0;0;218;0;218
113300003;500;544;544;1;254;499;1;0;0;0;0;254;2;252
113300004;200;197;197;3;89;109;2;89;0;3;86;0;0;0
113300005;900;857;859;1;354;899;1;0;0;0;0;354;0;354
113300006;700;652;652;4;235;699;1;0;0;0;0;235;0;235
113300007;500;532;534;3;213;499;1;0;0;0;0;213;1;212
113300008;600;640;638;2;255;599;1;0;0;0;0;255;2;253
113300009;700;689;694;0;203;699;1;0;0;0;0;203;0;203
113300010;800;771;771;4;303;799;1;0;0;0;0;303;2;301
113300012;100;61;61;5;30;69;1;30;1;0;29;0;0;0
113300014;300;298;296;5;226;73;1;226;8;3;215;0;0;0
113300015;100;57;58;4;42;57;1;42;0;0;42;0;0;0
113300016;600;602;605;3;214;599;1;0;0;0;0;214;0;214
113300017;900;322;913;2;324;899;1;0;0;0;0;324;2;322
113300018;100;123;124;4;57;42;1;57;1;1;55;0;0;0
113300019;100;52;52;7;39;60;1;39;2;0;37;0;0;0
113300020;500;473;474;6;222;499;1;0;0;0;0;222;1;221
113300021;300;258;259;3;129;169;2;129;1;1;127;0;0;0
113300022;100;138;139;3;76;23;1;76;1;1;74;0;0;0
113300023;700;718;720;6;284;699;1;0;0;0;0;284;3;281
113300024;500;495;497;9;185;499;1;0;0;0;0;185;2;183
113300025;500;507;508;1;208;499;1;0;0;0;0;208;4;204
113300026;700;716;716;6;269;699;1;0;0;0;0;269;4;265
113300027;800;855;864;5;321;799;1;0;0;0;0;321;3;318
113300028;700;691;691;6;290;699;1;0;0;0;0;290;3;287
113300029;600;643;648;6;219;599;1;0;0;0;0;219;0;219
113300031;600;564;566;4;239;599;1;0;0;0;0;239;6;233
113300032;800;870;871;7;214;799;1;0;0;0;0;214;3;211
113300033;500;543;543;5;251;499;1;0;0;0;0;251;0;251
113300034;500;510;511;10;255;499;1;0;0;0;0;255;6;249
113300035;400;419;420;6;114;399;1;0;0;0;0;114;0;114
113300036;800;806;808;5;312;799;1;0;0;0;0;312;3;309
113300038;300;353;358;4;174;299;1;0;0;0;0;174;1;173
113300040;200;160;160;4;103;96;1;103;0;0;103;0;0;0
113300041;100;27;27;14;32;67;1;32;0;1;31;0;0;0
113300042;100;25;25;3;28;71;1;28;0;0;28;0;0;0
113400001;600;602;602;8;168;599;1;0;0;0;0;168;2;166
113400002;500;555;555;6;210;499;1;0;0;0;0;210;3;207
113400003;600;609;609;3;221;599;1;0;0;0;0;221;4;217
113400004;600;635;635;5;250;599;1;0;0;0;0;250;5;245
113400005;700;732;734;6;261;699;1;0;0;0;0;261;3;258
113400006;500;477;480;3;183;499;1;0;0;0;0;183;2;181
113400007;500;544;546;0;206;499;1;0;0;0;0;206;3;203
113400008;500;467;469;2;199;499;1;0;0;0;0;199;2;197
113400009;300;253;255;1;126;173;1;126;0;1;125;0;0;0
113400010;610;610;610;9;280;609;1;0;0;0;0;280;2;278
113400011;300;336;337;0;148;299;1;0;0;0;0;148;2;146
113400012;500;504;506;6;198;499;1;0;0;0;0;198;2;196
113400013;500;537;537;4;234;499;1;0;0;0;0;234;1;233
113400014;600;612;612;7;235;599;1;0;0;0;0;235;4;231
113400015;600;665;667;4;280;599;1;0;0;0;0;280;6;274
113400016;600;636;637;6;273;599;1;0;0;0;0;273;3;270
113400017;500;514;516;5;229;499;1;0;0;0;0;229;2;227
113400018;600;608;609;5;284;599;1;0;0;0;0;284;1;283
113400019;600;581;581;5;234;599;1;0;0;0;0;234;1;233
113400020;500;490;490;7;219;499;1;0;0;0;0;219;3;216
113400021;700;742;746;4;297;699;1;0;0;0;0;297;2;295
113400022;500;491;491;7;196;499;1;0;0;0;0;196;5;191
113400023;400;386;386;5;141;399;1;0;0;0;0;141;0;141
113400024;800;857;860;7;278;799;1;0;0;0;0;278;2;276
113400025;500;431;433;5;123;499;1;0;0;0;0;123;1;122
113400026;200;197;197;1;51;148;1;51;0;2;49;0;0;0
113400027;100;94;94;0;39;60;1;39;2;1;36;0;0;0
113400030;637;637;637;5;219;636;1;0;0;0;0;219;5;214
113400032;200;163;163;5;90;109;1;90;3;1;86;0;0;0
113400033;500;466;467;2;158;499;1;0;0;0;0;158;1;157
113400035;150;140;140;4;75;74;1;75;1;1;73;0;0;0
113400037;100;82;82;8;49;49;2;49;1;0;48;0;0;0
113400038;150;105;105;7;57;92;1;57;2;2;53;0;0;0
113400039;300;278;278;3;171;127;2;171;1;1;169;0;0;0
113400041;300;262;262;3;148;151;1;148;7;6;135;0;0;0
113400044;300;254;256;2;155;144;1;155;4;2;149;0;0;0
113400045;300;258;260;0;120;179;1;120;1;1;118;0;0;0
113400048;500;465;475;0;215;499;1;0;0;0;0;215;2;213
113400050;800;826;826;4;362;799;1;0;0;0;0;362;3;359
113400051;800;837;837;3;315;799;1;0;0;0;0;315;4;311
113400052;700;698;699;4;316;699;1;0;0;0;0;316;2;314
113400054;100;61;61;5;45;52;3;45;0;0;45;0;0;0
113400055;500;556;557;0;235;499;1;0;0;0;0;235;1;234
113400058;200;170;170;3;103;96;1;103;0;2;101;0;0;0
113400059;600;593;593;2;312;599;1;0;0;0;0;312;2;310
113400061;300;256;258;4;141;157;2;141;5;1;135;0;0;0
113400062;250;230;230;6;112;137;1;112;6;4;102;0;0;0
113400063;250;214;215;3;115;134;1;115;5;2;108;0;0;0
113400065;700;687;687;2;332;699;1;0;0;0;0;332;4;328
113400066;200;161;161;3;109;90;1;109;2;1;106;0;0;0
113400067;450;487;487;3;236;449;1;0;0;0;0;236;3;233
113400069;500;515;516;3;210;499;1;0;0;0;0;210;4;206
113400070;500;532;532;8;214;499;1;0;0;0;0;214;7;207
113400071;700;692;692;9;293;699;1;0;0;0;0;293;9;284
113400072;500;464;464;7;192;499;1;0;0;0;0;192;5;187
113400073;600;581;583;7;206;600;0;0;0;0;0;206;3;203
113400074;600;597;598;2;203;599;1;0;0;0;0;203;0;203
113400075;500;494;494;4;186;499;1;0;0;0;0;186;0;186
113400076;400;403;405;3;97;399;1;0;0;0;0;97;1;96
113400077;50;14;14;18;29;20;1;29;0;0;29;0;0;0
113400078;50;19;19;9;22;27;1;22;1;0;21;0;0;0
113400079;50;25;25;5;30;19;1;30;0;1;29;0;0;0
113600001;700;843;844;1;216;699;1;0;0;0;0;216;0;216
113600002;700;793;803;7;280;699;1;0;0;0;0;280;4;276
113600003;400;406;410;1;120;399;1;0;0;0;0;120;1;119
113600004;200;143;143;3;110;88;2;110;1;0;109;0;0;0
113600005;300;287;290;1;88;210;2;88;2;4;82;0;0;0
113600006;100;111;111;1;54;45;1;54;1;2;51;0;0;0
113600007;100;71;71;5;54;45;1;54;6;2;46;0;0;0
113600008;800;840;844;3;371;799;1;0;0;0;0;371;7;364
113600009;900;970;973;3;223;899;1;0;0;0;0;223;3;220
113600010;100;34;34;3;27;72;1;27;1;0;26;0;0;0
113600011;100;127;127;5;74;25;1;74;6;1;67;0;0;0
113600012;100;105;105;3;60;39;1;60;2;0;58;0;0;0
113600013;100;101;101;6;65;34;1;65;2;0;63;0;0;0
113600014;100;18;18;0;17;82;1;17;3;0;14;0;0;0
113800001;600;756;757;0;311;599;1;0;0;0;0;311;0;311
113800002;600;694;694;0;247;599;1;0;0;0;0;247;0;247
113800003;700;778;780;1;375;699;1;0;0;0;0;375;0;375
113800006;100;113;113;4;62;37;1;62;1;0;61;0;0;0
113800007;700;715;715;6;158;699;1;0;0;0;0;158;1;157
113800008;100;88;88;5;46;53;1;46;2;0;44;0;0;0
113800009;400;377;381;5;161;399;1;0;0;0;0;161;0;161
113800010;100;52;52;7;39;60;1;39;1;0;38;0;0;0
113800011;700;660;662;4;194;699;1;0;0;0;0;194;1;193
113800012;200;181;181;6;126;73;1;126;0;0;126;0;0;0
113800013;200;211;214;4;82;117;1;82;2;1;79;0;0;0
120200001;300;270;274;3;139;160;1;139;3;0;136;0;0;0
120200002;600;653;653;0;264;599;1;0;0;0;0;264;5;259
120200003;700;718;718;6;276;700;0;0;0;0;0;276;4;272
120200004;500;503;506;7;210;499;1;0;0;0;0;210;4;206
120200005;400;479;483;5;210;399;1;0;0;0;0;210;3;207
120200006;500;545;549;6;224;499;1;0;0;0;0;224;4;220
120200007;500;529;532;6;250;499;1;0;0;0;0;250;7;243
120200008;600;675;682;3;262;599;1;0;0;0;0;262;7;255
120200009;400;451;452;0;191;399;1;0;0;0;0;191;5;186
120200010;300;372;372;3;159;299;1;0;0;0;0;159;1;158
120200011;500;558;560;6;226;499;1;0;0;0;0;226;0;226
120200012;500;542;543;5;210;500;0;0;0;0;0;210;0;210
120200013;500;515;516;5;227;499;1;0;0;0;0;227;4;223
120200014;500;496;502;5;246;499;1;0;0;0;0;246;2;244
120200015;500;547;551;5;209;499;1;0;0;0;0;209;3;206
120200016;500;563;563;2;200;499;1;0;0;0;0;200;1;199
120200017;500;525;526;7;180;499;1;0;0;0;0;180;3;177
120200018;1000;1019;1019;5;185;999;1;0;0;0;0;185;1;184
120200019;900;915;915;7;207;899;1;0;0;0;0;207;0;207
120200020;900;942;942;5;183;899;1;0;0;0;0;183;0;183
120200021;100;89;74;3;57;42;1;57;14;0;43;0;0;0
120200022;200;146;147;6;61;137;2;61;1;0;60;0;0;0
120200023;100;79;79;7;47;52;1;47;1;1;45;0;0;0
120200024;100;35;35;5;21;78;1;21;0;1;20;0;0;0
120200025;100;49;48;7;37;62;1;37;0;0;37;0;0;0
120200026;50;13;13;6;16;33;1;16;1;0;15;0;0;0
120200027;50;27;27;7;21;29;0;21;0;1;20;0;0;0
120200028;300;217;217;3;142;157;1;142;3;2;137;0;0;0
120200029;100;94;95;6;54;45;1;54;0;1;53;0;0;0
120200030;200;100;100;5;73;126;1;73;0;0;73;0;0;0
120200031;50;34;34;7;34;15;1;34;2;0;32;0;0;0
120200032;100;39;39;6;32;66;2;32;0;0;32;0;0;0
120200033;100;23;43;7;30;69;1;30;0;0;30;0;0;0
120200034;200;93;149;4;97;102;1;97;2;3;92;0;0;0
120200035;200;159;160;7;91;108;1;91;3;0;88;0;0;0
120200036;500;588;588;7;190;500;0;0;0;0;0;190;6;184
120200037;600;613;615;7;266;600;0;0;0;0;0;266;5;261
120200038;400;469;477;6;237;400;0;0;0;0;0;237;0;237
120200039;500;493;494;6;209;499;1;0;0;0;0;209;1;208
120200040;400;443;443;5;183;399;1;0;0;0;0;183;0;183
120200041;50;34;34;0;34;16;0;34;1;0;33;0;0;0
120400001;550;640;641;3;243;549;1;0;0;0;0;243;3;240
120400002;400;497;497;7;174;399;1;0;0;0;0;174;0;174
120400003;200;148;149;4;69;130;1;69;1;0;68;0;0;0
120400004;400;497;495;2;219;400;0;0;0;0;0;220;0;220
120400005;500;532;534;2;242;500;0;0;0;0;0;242;2;240
120400006;600;678;680;4;256;599;1;0;0;0;0;256;0;256
120400007;500;531;532;2;223;499;1;0;0;0;0;223;0;223
120400008;400;439;439;6;177;400;0;0;0;0;0;177;0;177
120400009;300;282;283;4;115;183;2;115;5;5;105;0;0;0
120400010;300;353;353;2;191;300;0;0;0;0;0;191;2;189
120400011;50;41;41;6;30;18;2;30;1;1;28;0;0;0
120400012;100;53;53;7;41;58;1;41;1;1;39;0;0;0
120400013;200;151;152;3;74;123;3;74;2;0;72;0;0;0
120400014;300;389;389;2;175;299;1;0;0;0;0;175;1;174
120400015;500;545;546;4;202;499;1;0;0;0;0;202;0;202
120400016;400;497;497;1;233;399;1;0;0;0;0;233;2;231
120400017;500;582;582;2;271;499;1;0;0;0;0;271;1;270
120400018;250;227;227;3;144;105;1;144;4;1;139;0;0;0
120400019;50;35;35;2;32;17;1;32;2;0;30;0;0;0
120700001;500;547;571;2;199;300;1;199;2;2;195;0;0;0
120700002;400;383;398;4;163;399;1;0;0;0;0;163;1;162
120700003;350;338;354;4;188;349;1;0;0;0;0;188;4;184
120700004;100;77;82;1;53;46;1;53;1;2;50;0;0;0
120700005;130;113;118;2;74;55;1;74;2;2;70;0;0;0
120700006;120;107;108;4;73;46;1;73;5;0;68;0;0;0
120700007;500;483;500;0;231;499;1;0;0;0;0;231;1;230
120700008;350;322;333;2;166;349;1;0;0;0;0;166;2;164
120700009;400;460;467;1;177;400;0;0;0;0;0;177;1;176
120700010;500;525;543;2;176;499;1;0;0;0;0;176;2;174
120700011;300;166;301;2;168;130;2;168;7;0;161;0;0;0
120700012;150;127;131;6;73;75;2;73;1;0;72;0;0;0
120700013;50;39;39;4;37;11;2;37;5;0;32;0;0;0
120700014;50;26;26;4;28;21;1;28;1;0;27;0;0;0
120700015;50;38;38;1;36;13;1;36;3;0;33;0;0;0
120700016;50;29;29;1;28;22;0;28;1;0;27;0;0;0
121100001;500;484;484;0;175;499;1;0;0;0;0;175;4;171
121100002;500;503;504;3;251;499;1;0;0;0;0;251;2;249
121100003;500;486;487;5;173;500;0;0;0;0;0;173;4;169
121100004;600;648;649;6;233;599;1;0;0;0;0;233;2;231
121100005;700;714;714;6;243;699;1;0;0;0;0;243;3;240
121100006;50;28;28;9;17;32;1;17;3;0;14;0;0;0
121100007;300;357;358;2;168;299;1;0;0;0;0;168;0;168
121100008;400;448;448;3;248;400;0;0;0;0;0;248;2;246
121100009;300;338;338;1;158;300;0;0;0;0;0;157;1;156
121100010;100;31;64;4;35;64;1;35;0;0;35;0;0;0
121100011;300;355;355;5;136;299;1;0;0;0;0;136;0;136
121100012;200;89;242;1;89;110;1;89;1;0;88;0;0;0
121100013;50;38;38;5;27;22;1;27;0;0;27;0;0;0
121100014;150;178;178;2;64;85;1;64;1;2;61;0;0;0
121100015;300;338;338;1;138;299;1;0;0;0;0;138;0;138
121100016;250;292;291;4;105;143;2;105;1;1;103;0;0;0
121100017;250;266;266;1;98;150;2;98;6;3;89;0;0;0
121100018;150;151;151;1;78;71;1;78;1;0;77;0;0;0
121100019;800;761;761;0;361;800;0;0;0;0;0;361;3;358
121100020;500;471;471;5;263;500;0;0;0;0;0;262;1;261
121100021;100;103;103;2;68;31;1;68;0;0;68;0;0;0
121200001;670;698;700;1;295;669;1;0;0;0;0;295;2;293
121200002;1060;1044;1045;3;176;1059;1;0;0;0;0;176;1;175
121200003;480;511;511;0;250;479;1;0;0;0;0;250;3;247
121200004;750;775;780;0;367;749;1;0;0;0;0;367;2;365
121200005;670;703;703;0;339;669;1;0;0;0;0;339;2;337
121200006;470;494;495;0;217;469;1;0;0;0;0;217;3;214
121200007;330;358;361;0;153;329;1;0;0;0;0;153;1;152
121200008;410;434;439;2;191;409;1;0;0;0;0;191;0;191
121200009;320;344;349;0;223;319;1;0;0;0;0;223;2;221
121200010;90;77;78;6;65;24;1;65;1;0;64;0;0;0
121200011;60;50;50;1;41;18;1;41;1;0;40;0;0;0
121200012;320;295;297;3;166;153;1;166;3;1;162;0;0;0
121200013;200;180;180;1;100;96;4;100;1;1;98;0;0;0
121200014;50;34;34;7;27;22;1;27;0;0;27;0;0;0
121200015;190;171;173;5;108;81;1;108;11;0;97;0;0;0
121200016;170;152;154;5;110;59;1;110;3;3;104;0;0;0
121200017;40;25;25;0;24;15;1;24;0;0;24;0;0;0
121200018;220;66;66;35;76;143;1;76;0;3;73;0;0;0
121400001;100;77;79;3;66;33;1;66;0;1;65;0;0;0
121400002;200;196;196;4;137;61;2;137;2;1;134;0;0;0
121400003;300;348;350;4;199;300;0;0;0;0;0;199;2;197
121400004;100;55;55;2;35;64;1;35;0;0;35;0;0;0
121400005;300;293;303;4;193;101;6;193;6;4;183;0;0;0
121400006;100;82;82;2;61;38;1;61;0;0;61;0;0;0
121400007;120;127;127;1;95;24;1;95;5;0;90;0;0;0
121400008;50;21;21;4;20;29;1;20;1;0;19;0;0;0
121400009;100;91;92;3;61;38;1;61;4;0;57;0;0;0
121400010;400;415;425;3;219;400;0;0;0;0;0;220;2;218
121400011;100;133;134;4;96;3;1;96;4;2;90;0;0;0
121400012;50;57;57;4;44;4;2;44;2;0;42;0;0;0
121400013;50;15;15;2;16;34;0;16;2;0;14;0;0;0
121400014;30;13;13;5;18;12;0;18;1;0;17;0;0;0
122400001;600;611;613;7;188;599;1;0;0;0;0;188;1;187
122400002;600;604;607;6;204;599;1;0;0;0;0;204;3;201
122400003;500;509;511;7;170;499;1;0;0;0;0;170;2;168
122400004;300;360;362;5;131;299;1;0;0;0;0;131;4;127
122400005;400;436;438;4;178;399;1;0;0;0;0;178;1;177
122400006;400;151;444;6;157;400;0;0;0;0;0;157;1;156
122400007;700;637;640;10;248;699;1;0;0;0;0;248;3;245
122400008;600;579;584;4;218;600;0;0;0;0;0;218;3;215
122400009;500;500;504;6;160;499;1;0;0;0;0;160;1;159
122400010;500;478;478;8;165;499;1;0;0;0;0;165;3;162
122400011;600;619;625;8;231;599;1;0;0;0;0;231;2;229
122400012;549;549;549;6;207;549;0;0;0;0;0;207;3;204
122400013;400;411;411;6;169;399;1;0;0;0;0;169;3;166
122400014;600;585;589;7;225;600;0;0;0;0;0;225;4;221
122400015;600;614;617;4;207;599;1;0;0;0;0;207;5;202
122400016;600;596;600;5;196;600;0;0;0;0;0;196;2;194
122400017;700;696;696;6;124;700;0;0;0;0;0;124;0;124
122400018;700;666;673;6;161;699;1;0;0;0;0;161;0;161
122400019;500;510;512;6;180;499;1;0;0;0;0;180;4;176
122400020;600;629;631;8;210;599;1;0;0;0;0;210;1;209
122400021;500;520;522;7;163;499;1;0;0;0;0;163;1;162
122400022;500;461;462;5;151;499;1;0;0;0;0;151;1;150
122400023;500;534;538;6;211;499;1;0;0;0;0;211;1;210
122400024;600;556;557;7;150;600;0;0;0;0;0;150;0;150
122400025;500;503;503;8;119;499;1;0;0;0;0;119;2;117
122400026;500;501;502;7;112;499;1;0;0;0;0;112;0;112
122400027;700;700;706;6;134;700;0;0;0;0;0;134;0;134
122400028;600;553;553;4;57;599;1;0;0;0;0;57;0;57
122400029;500;524;525;2;114;499;1;0;0;0;0;114;2;112
122400030;500;549;549;6;144;500;0;0;0;0;0;144;2;142
122400031;700;745;747;5;95;699;1;0;0;0;0;95;0;95
122400032;500;537;539;8;47;499;1;0;0;0;0;47;2;45
122400033;1000;1096;1096;8;136;1000;0;0;0;0;0;136;0;136
122400034;400;368;368;6;110;400;0;0;0;0;0;110;1;109
122400035;200;168;169;2;80;120;0;80;4;5;71;0;0;0
122400036;400;444;444;4;142;399;1;0;0;0;0;142;1;141
122400037;300;303;303;2;88;299;1;0;0;0;0;88;0;88
122400038;200;243;243;0;82;117;1;82;3;0;79;0;0;0
122400039;400;393;395;11;167;400;0;0;0;0;0;167;1;166
122400040;600;564;579;3;228;599;1;0;0;0;0;228;0;228
122400041;500;489;493;3;211;499;1;0;0;0;0;211;3;208
122400042;100;127;127;6;72;27;1;72;4;1;67;0;0;0
122400043;200;181;181;5;83;116;1;83;10;2;71;0;0;0
122400044;100;34;38;5;20;79;1;20;1;0;19;0;0;0
122400045;400;475;477;0;135;400;0;0;0;0;0;135;0;135
122400046;400;382;384;0;148;399;1;0;0;0;0;148;0;148
122400047;200;192;192;7;84;115;1;84;2;0;82;0;0;0
122400048;400;379;379;6;133;399;1;0;0;0;0;132;0;132
122400049;100;33;33;11;28;71;1;28;6;0;22;0;0;0
122400050;700;618;619;4;202;700;0;0;0;0;0;202;5;197
122400051;100;16;16;34;50;49;1;50;0;0;50;0;0;0
122400052;100;60;60;7;65;34;1;65;1;0;64;0;0;0
122400053;100;26;26;4;29;70;1;29;0;2;27;0;0;0
122600001;250;241;241;4;136;113;1;136;10;0;126;0;0;0
122600002;100;82;82;7;53;46;1;53;2;0;51;0;0;0
122600003;700;788;801;4;383;700;0;0;0;0;0;383;1;382
122600004;500;581;581;4;256;499;1;0;0;0;0;256;3;253
122600005;400;394;395;3;185;399;1;0;0;0;0;185;1;184
122600006;500;441;446;1;207;499;1;0;0;0;0;207;1;206
122600007;500;492;492;0;226;499;1;0;0;0;0;226;4;222
122600008;50;26;26;1;27;22;1;27;0;0;27;0;0;0
122900001;200;592;592;2;272;200;0;0;0;0;0;272;4;268
122900002;200;602;605;8;279;199;1;0;0;0;0;279;5;274
122900003;200;747;749;7;338;200;0;0;0;0;0;338;6;332
122900004;200;808;809;7;361;200;0;0;0;0;0;361;6;355
122900005;200;537;538;6;229;199;1;0;0;0;0;229;2;227
122900006;200;802;802;9;370;199;1;0;0;0;0;370;7;363
122900007;200;833;833;3;387;200;0;0;0;0;0;387;2;385
122900008;200;613;613;11;267;200;0;0;0;0;0;267;3;264
122900009;200;865;866;5;383;200;0;0;0;0;0;383;3;380
122900010;200;573;575;5;259;199;1;0;0;0;0;259;2;257
122900011;200;634;634;4;271;199;1;0;0;0;0;271;2;269
122900012;200;752;753;8;310;199;1;0;0;0;0;310;2;308
122900013;200;710;710;6;329;200;0;0;0;0;0;329;11;318
122900014;200;490;490;5;189;199;1;0;0;0;0;189;3;186
122900015;200;753;754;8;322;200;0;0;0;0;0;322;0;322
122900016;200;684;685;9;268;199;1;0;0;0;0;268;4;264
122900017;200;778;779;7;317;200;0;0;0;0;0;317;2;315
122900018;200;609;611;6;235;199;1;0;0;0;0;235;6;229
122900019;200;599;599;7;233;200;0;0;0;0;0;233;3;230
122900020;200;604;605;7;224;199;1;0;0;0;0;224;4;220
122900021;200;537;539;12;254;199;1;0;0;0;0;254;4;250
122900022;200;598;598;5;274;200;0;0;0;0;0;274;1;273
122900023;200;647;647;1;249;199;1;0;0;0;0;249;3;246
122900024;200;653;653;7;240;200;0;0;0;0;0;240;5;235
122900025;200;819;819;3;299;199;1;0;0;0;0;299;7;292
122900026;200;809;809;5;350;200;0;0;0;0;0;350;1;349
122900027;200;832;834;10;332;199;1;0;0;0;0;332;6;326
122900028;200;728;728;7;295;200;0;0;0;0;0;295;2;293
122900029;200;625;628;9;236;200;0;0;0;0;0;236;4;232
122900030;200;810;810;7;238;200;0;0;0;0;0;238;6;232
122900031;200;737;738;8;257;200;0;0;0;0;0;257;6;251
122900032;200;891;891;9;346;200;0;0;0;0;0;346;2;344
122900033;200;846;846;8;357;200;0;0;0;0;0;357;10;347
122900034;200;747;749;3;301;200;0;0;0;0;0;301;1;300
122900035;200;645;645;6;243;199;1;0;0;0;0;243;5;238
122900036;200;287;686;7;294;200;0;0;0;0;0;294;4;290
122900037;200;715;718;9;289;199;1;0;0;0;0;289;3;286
122900038;200;585;585;4;236;200;0;0;0;0;0;236;4;232
122900039;200;809;811;7;358;199;1;0;0;0;0;358;5;353
122900040;200;629;630;5;262;199;1;0;0;0;0;262;6;256
122900041;200;635;635;7;318;199;1;0;0;0;0;318;7;311
122900042;200;478;480;9;203;199;1;0;0;0;0;203;0;203
122900043;200;468;469;3;209;199;1;0;0;0;0;209;3;206
122900044;200;518;518;6;222;200;0;0;0;0;0;222;1;221
122900045;200;572;572;5;185;199;1;0;0;0;0;185;2;183
122900046;200;964;964;5;158;199;1;0;0;0;0;158;2;156
122900047;200;623;623;4;242;200;0;0;0;0;0;242;5;237
122900048;200;549;549;6;195;199;1;0;0;0;0;195;0;195
122900049;200;725;726;9;276;199;1;0;0;0;0;276;1;275
122900050;680;679;680;3;278;679;1;0;0;0;0;278;2;276
122900051;200;690;690;4;242;199;1;0;0;0;0;242;5;237
122900052;200;728;728;2;289;200;0;0;0;0;0;289;6;283
122900053;200;577;578;9;213;200;0;0;0;0;0;213;3;210
122900054;200;623;623;4;257;200;0;0;0;0;0;257;2;255
122900055;200;993;993;6;538;199;1;0;0;0;0;538;2;536
122900056;200;974;973;1;598;200;0;0;0;0;0;598;0;598
122900057;200;227;227;5;115;84;1;115;0;0;115;0;0;0
122900058;300;312;312;3;170;129;1;170;10;2;158;0;0;0
122900059;200;466;466;4;196;200;0;0;0;0;0;196;1;195
122900060;200;472;513;4;322;200;0;0;0;0;0;322;3;319
122900061;200;215;215;7;113;86;1;113;4;0;109;0;0;0
122900062;200;290;291;4;143;56;1;143;1;1;141;0;0;0
122900063;100;55;55;6;44;55;1;44;1;0;43;0;0;0
122900064;400;854;853;5;327;400;0;0;0;0;0;327;1;326
122900065;100;100;130;4;75;24;1;75;5;0;70;0;0;0
122900066;300;317;328;3;183;116;1;183;8;2;173;0;0;0
122900067;300;504;505;8;238;300;0;0;0;0;0;238;3;235
122900068;200;166;166;4;118;81;1;118;2;1;115;0;0;0
122900069;100;149;152;3;86;13;1;86;2;3;81;0;0;0
122900070;100;84;84;3;66;33;1;66;6;5;55;0;0;0
122900071;200;228;233;1;139;60;1;139;1;1;137;0;0;0
122900072;200;255;256;5;176;23;1;176;3;0;173;0;0;0
122900073;300;330;330;5;183;300;0;0;0;0;0;183;2;181
122900074;200;243;245;3;133;66;1;133;5;1;127;0;0;0
122900075;400;708;767;3;354;400;0;0;0;0;0;354;6;348
122900076;200;429;429;3;187;200;0;0;0;0;0;187;3;184
122900077;200;390;390;4;168;200;0;0;0;0;0;168;1;167
122900078;200;174;175;4;104;94;2;104;2;3;99;0;0;0
122900079;100;75;75;7;53;46;1;53;0;1;52;0;0;0
122900080;100;41;41;6;44;55;1;44;2;0;42;0;0;0
122900081;100;42;42;0;42;58;0;42;1;0;41;0;0;0
122900082;100;49;49;0;39;61;0;39;0;0;39;0;0;0
122900083;100;61;61;6;66;33;1;66;1;3;62;0;0;0
122900084;100;19;19;41;56;43;1;56;2;0;54;0;0;0
123600001;500;504;507;2;247;500;0;0;0;0;0;247;3;244
123600002;550;581;582;5;287;550;0;0;0;0;0;287;8;279
123600003;450;480;480;2;228;449;1;0;0;0;0;228;9;219
123600004;200;235;236;2;119;80;1;119;8;1;110;0;0;0
123600005;250;278;279;4;150;98;2;150;3;4;143;0;0;0
123600006;300;354;377;1;231;299;1;0;0;0;0;231;1;230
123600007;150;164;163;4;120;29;1;120;4;2;114;0;0;0
123600008;160;171;173;5;150;9;1;150;2;1;147;0;0;0
123600009;180;175;177;3;123;55;2;123;1;0;122;0;0;0
123600010;70;61;61;4;47;22;1;47;1;1;45;0;0;0
123600011;100;90;95;5;72;27;1;72;4;0;68;0;0;0
123600012;40;24;25;3;21;18;1;21;2;0;19;0;0;0
123600013;50;39;39;3;42;6;2;42;2;0;40;0;0;0
123800001;250;266;266;3;138;111;1;138;2;3;133;0;0;0
123800002;300;334;334;1;157;299;1;0;0;0;0;157;5;152
123800003;380;405;406;2;170;379;1;0;0;0;0;170;1;169
123800004;250;259;259;5;130;118;2;130;4;1;125;0;0;0
123800005;360;384;384;3;99;359;1;0;0;0;0;99;2;97
123800006;260;278;278;2;121;138;1;121;2;0;119;0;0;0
123800007;540;194;576;2;194;540;0;0;0;0;0;194;2;192
123800008;340;364;364;2;138;339;1;0;0;0;0;138;1;137
123800009;330;330;330;0;144;329;1;0;0;0;0;144;4;140
130300001;500;470;474;0;260;499;1;0;0;0;0;260;4;256
130300002;500;426;429;2;222;499;1;0;0;0;0;222;6;216
130300003;600;619;619;1;322;599;1;0;0;0;0;322;8;314
130300004;500;527;528;1;240;499;1;0;0;0;0;240;3;237
130300005;500;496;524;0;203;499;1;0;0;0;0;203;2;201
130300006;800;752;790;3;394;800;0;0;0;0;0;394;1;393
130300007;600;639;663;7;330;600;0;0;0;0;0;330;2;328
130300008;700;647;686;4;431;700;0;0;0;0;0;431;5;426
130300009;500;509;524;7;284;499;1;0;0;0;0;284;4;280
130300010;100;50;50;0;49;50;1;49;0;0;49;0;0;0
130300011;200;100;100;1;101;96;3;101;2;1;98;0;0;0
130400001;1000;866;872;0;408;999;1;0;0;0;0;408;1;407
130400002;1000;874;878;1;439;999;1;0;0;0;0;439;4;435
130400003;1000;804;806;2;395;999;1;0;0;0;0;395;1;394
130400004;500;830;834;2;349;499;1;0;0;0;0;349;2;347
130400005;500;385;386;0;191;499;1;0;0;0;0;191;0;191
130400006;500;767;775;4;392;500;0;0;0;0;0;392;1;391
130400007;500;394;395;3;174;499;1;0;0;0;0;174;4;170
130400008;500;774;777;0;389;500;0;0;0;0;0;389;4;385
130400009;500;468;473;2;282;500;0;0;0;0;0;282;5;277
130400010;500;452;456;1;239;500;0;0;0;0;0;239;4;235
130400011;500;365;368;3;168;499;1;0;0;0;0;168;3;165
130400012;400;349;350;1;182;399;1;0;0;0;0;182;2;180
130400013;100;24;24;0;24;76;0;24;0;0;24;0;0;0
130600001;700;711;711;0;276;699;1;0;0;0;0;276;4;272
130600002;600;592;593;1;225;599;1;0;0;0;0;225;3;222
130600003;500;471;472;1;186;499;1;0;0;0;0;186;4;182
130600004;500;521;521;3;220;499;1;0;0;0;0;220;1;219
130600005;600;627;627;0;246;599;1;0;0;0;0;246;3;243
130600006;400;422;422;5;92;399;1;0;0;0;0;92;0;92
130600007;400;437;437;7;192;399;1;0;0;0;0;192;1;191
130600008;300;334;334;4;176;300;0;0;0;0;0;176;1;175
130600009;500;534;535;2;219;499;1;0;0;0;0;219;5;214
130600010;600;597;599;3;189;599;1;0;0;0;0;189;0;189
130600011;400;450;451;5;210;399;1;0;0;0;0;210;2;208
130600012;600;575;575;2;35;599;1;0;0;0;0;35;0;35
130600013;600;542;542;2;97;599;1;0;0;0;0;97;0;97
130600014;400;356;356;4;158;399;1;0;0;0;0;158;0;158
130600015;300;326;326;7;140;299;1;0;0;0;0;140;4;136
130600016;100;47;47;7;29;70;1;29;1;0;28;0;0;0
130800001;500;878;878;0;340;500;0;0;0;0;0;340;5;335
130800002;500;977;977;8;298;499;1;0;0;0;0;298;1;297
130800003;500;929;931;0;358;499;1;0;0;0;0;358;3;355
130800004;500;926;926;6;395;499;1;0;0;0;0;395;5;390
130800005;500;896;899;0;387;499;1;0;0;0;0;387;4;383
130800006;600;860;862;8;447;599;1;0;0;0;0;447;4;443
130800007;500;857;877;9;364;499;1;0;0;0;0;364;3;361
130800008;700;1019;1018;1;92;700;0;0;0;0;0;92;1;91
130800009;500;864;865;6;398;499;1;0;0;0;0;398;5;393
130800010;500;931;938;4;402;499;1;0;0;0;0;402;3;399
130800011;500;974;976;6;402;500;0;0;0;0;0;402;7;395
130800012;500;975;976;5;301;499;1;0;0;0;0;301;2;299
130800013;500;854;857;4;391;499;1;0;0;0;0;391;4;387
130800014;500;958;962;1;413;499;1;0;0;0;0;413;3;410
130800015;500;903;908;0;402;500;0;0;0;0;0;402;2;400
130800016;500;941;942;5;349;499;1;0;0;0;0;349;0;349
130800017;500;899;905;5;399;500;0;0;0;0;0;399;2;397
130800018;500;852;852;7;341;500;0;0;0;0;0;341;4;337
130800019;500;843;844;6;277;500;0;0;0;0;0;277;2;275
130800020;700;1105;1105;2;36;699;1;0;0;0;0;36;0;36
130800021;500;1000;1000;7;298;499;1;0;0;0;0;298;0;298
130800022;500;853;855;5;313;499;1;0;0;0;0;313;1;312
130800023;300;249;249;5;119;179;2;119;0;2;117;0;0;0
130800024;300;209;209;3;98;201;1;98;3;4;91;0;0;0
130800025;200;157;157;2;110;88;2;110;3;0;107;0;0;0
130800026;200;63;63;16;65;133;2;65;2;2;61;0;0;0
130800027;100;27;27;0;27;72;1;27;3;0;24;0;0;0
130800028;200;47;47;35;78;120;2;78;3;1;74;0;0;0
130800029;200;54;54;0;54;145;1;54;0;1;53;0;0;0
130800036;700;1058;1058;2;318;699;1;0;0;0;0;318;2;316
130800037;600;983;984;2;347;599;1;0;0;0;0;347;1;346
130800038;600;996;998;7;343;599;1;0;0;0;0;343;1;342
130800039;600;949;949;3;312;599;1;0;0;0;0;312;2;310
130800041;600;319;796;6;325;600;0;0;0;0;0;325;2;323
130800042;300;226;226;3;88;210;2;88;0;0;88;0;0;0
130800043;700;669;670;3;207;699;1;0;0;0;0;207;1;206
130800044;600;572;573;5;234;599;1;0;0;0;0;234;3;231
130800045;300;203;203;1;112;187;1;112;4;0;108;0;0;0
130800046;800;679;678;1;350;799;1;0;0;0;0;350;2;348
130800047;100;328;325;3;187;99;1;0;0;0;0;187;0;187
130800048;200;125;125;5;79;121;0;79;0;0;79;0;0;0
130800049;200;172;172;4;96;99;5;96;5;2;89;0;0;0
130800050;200;87;139;3;90;109;1;90;0;0;90;0;0;0
130800051;400;311;311;5;157;400;0;0;0;0;0;157;0;157
130800052;200;155;157;5;65;135;0;65;0;1;64;0;0;0
130800053;200;116;116;4;55;144;1;55;2;0;53;0;0;0
130800054;200;154;154;5;93;106;1;93;2;0;91;0;0;0
130800055;400;302;302;5;182;400;0;0;0;0;0;182;0;182
130800056;900;391;835;2;391;900;0;0;0;0;0;391;1;390
130800057;200;148;148;3;73;126;1;73;2;0;71;0;0;0
130800058;100;32;32;6;19;80;1;19;0;0;19;0;0;0
130800059;100;35;35;1;33;67;0;33;0;0;33;0;0;0
131400001;600;654;654;2;299;599;1;0;0;0;0;299;3;296
131400002;450;469;469;2;216;449;1;0;0;0;0;216;1;215
131400003;300;317;317;0;124;299;1;0;0;0;0;124;1;123
131400004;450;489;489;1;227;449;1;0;0;0;0;227;1;226
131400005;450;475;475;4;197;449;1;0;0;0;0;197;3;194
131400006;300;297;297;2;161;136;3;161;5;2;154;0;0;0
131400007;700;701;701;0;210;699;1;0;0;0;0;210;2;208
131400008;200;224;224;3;116;83;1;116;3;1;112;0;0;0
131400009;50;30;32;2;20;29;1;20;2;0;18;0;0;0
131400010;500;586;587;2;140;499;1;0;0;0;0;140;0;140
131900001;600;612;613;7;262;599;1;0;0;0;0;262;1;261
131900002;700;749;753;6;329;699;1;0;0;0;0;329;3;326
131900003;600;659;662;5;302;599;1;0;0;0;0;302;9;293
131900004;700;678;678;8;331;699;1;0;0;0;0;331;3;328
131900005;800;816;819;5;396;799;1;0;0;0;0;396;14;382
131900006;900;952;954;7;446;899;1;0;0;0;0;446;8;438
131900007;800;916;920;7;388;799;1;0;0;0;0;388;2;386
131900008;800;821;821;8;387;799;1;0;0;0;0;387;9;378
131900009;800;819;819;12;365;799;1;0;0;0;0;365;2;363
131900010;600;556;558;7;197;599;1;0;0;0;0;197;0;197
131900011;700;739;743;3;349;699;1;0;0;0;0;349;5;344
131900012;600;635;640;9;284;599;1;0;0;0;0;284;1;283
131900013;600;602;604;11;270;599;1;0;0;0;0;270;3;267
131900014;800;831;831;7;383;799;1;0;0;0;0;383;2;381
131900015;803;803;803;0;299;802;1;0;0;0;0;299;4;295
131900016;900;864;865;6;352;899;1;0;0;0;0;352;9;343
131900017;700;714;715;10;314;700;0;0;0;0;0;314;5;309
131900018;800;800;811;7;362;799;1;0;0;0;0;362;3;359
131900019;600;649;650;3;311;600;0;0;0;0;0;311;6;305
131900020;600;596;598;8;289;599;1;0;0;0;0;289;4;285
131900021;800;854;854;9;406;799;1;0;0;0;0;406;5;401
131900022;700;733;736;5;316;699;1;0;0;0;0;316;6;310
131900023;700;732;732;7;321;700;0;0;0;0;0;321;10;311
131900024;700;705;712;10;306;699;1;0;0;0;0;306;3;303
131900025;800;773;778;8;245;799;1;0;0;0;0;245;4;241
131900026;600;623;625;0;222;599;1;0;0;0;0;222;1;221
131900027;700;669;669;10;141;699;1;0;0;0;0;141;1;140
131900028;800;859;861;5;324;799;1;0;0;0;0;324;3;321
131900029;565;565;565;7;217;564;1;0;0;0;0;217;4;213
131900030;600;601;604;5;248;599;1;0;0;0;0;248;3;245
131900031;800;772;775;5;355;799;1;0;0;0;0;355;1;354
131900032;769;318;769;8;326;768;1;0;0;0;0;326;4;322
131900033;700;700;703;7;361;699;1;0;0;0;0;361;8;353
131900034;900;942;942;3;436;899;1;0;0;0;0;436;5;431
131900035;800;856;856;13;334;799;1;0;0;0;0;334;5;329
131900036;900;899;900;7;331;899;1;0;0;0;0;331;3;328
131900037;700;767;767;9;168;699;1;0;0;0;0;168;0;168
131900038;798;786;786;3;325;797;1;0;0;0;0;325;7;318
131900039;300;290;290;6;126;173;1;126;1;4;121;0;0;0
131900040;700;758;761;4;332;699;1;0;0;0;0;332;8;324
131900041;800;846;847;9;380;799;1;0;0;0;0;380;6;374
131900042;600;593;592;6;148;599;1;0;0;0;0;148;1;147
131900043;900;948;948;5;82;900;0;0;0;0;0;82;0;82
131900044;900;980;981;9;63;899;1;0;0;0;0;63;0;63
131900045;600;636;639;7;251;599;1;0;0;0;0;251;1;250
131900046;700;692;694;7;297;699;1;0;0;0;0;297;4;293
131900047;800;794;797;3;265;799;1;0;0;0;0;265;3;262
131900048;800;761;762;4;323;799;1;0;0;0;0;323;6;317
131900049;500;530;530;0;188;499;1;0;0;0;0;188;6;182
131900050;700;718;717;6;269;699;1;0;0;0;0;269;2;267
131900051;500;531;533;8;106;498;2;0;0;0;0;106;0;106
131900052;700;707;706;6;169;699;1;0;0;0;0;169;5;164
131900053;600;674;674;0;54;599;1;0;0;0;0;54;0;54
131900054;600;631;631;10;95;599;1;0;0;0;0;95;1;94
131900055;500;540;537;3;191;500;0;0;0;0;0;191;5;186
131900056;681;681;685;5;251;680;1;0;0;0;0;251;2;249
131900057;800;816;815;5;282;799;1;0;0;0;0;282;3;279
131900058;800;830;830;5;327;799;1;0;0;0;0;327;5;322
131900059;700;740;744;4;291;699;1;0;0;0;0;291;6;285
131900060;800;819;820;6;64;799;1;0;0;0;0;64;0;64
131900061;700;693;694;9;36;700;0;0;0;0;0;36;0;36
131900062;800;836;838;4;345;800;0;0;0;0;0;345;3;342
131900063;500;502;503;1;181;499;1;0;0;0;0;181;3;178
131900064;500;528;529;4;209;499;1;0;0;0;0;209;3;206
131900065;900;886;889;11;302;899;1;0;0;0;0;302;2;300
131900066;800;791;792;8;296;799;1;0;0;0;0;296;9;287
131900067;800;764;764;7;288;799;1;0;0;0;0;288;4;284
131900068;600;657;657;5;251;599;1;0;0;0;0;251;6;245
131900069;800;798;797;5;301;799;1;0;0;0;0;301;5;296
131900070;800;781;780;7;284;799;1;0;0;0;0;284;9;275
131900071;700;667;669;3;260;699;1;0;0;0;0;260;3;257
131900072;700;689;691;6;143;699;1;0;0;0;0;143;3;140
131900073;800;771;768;7;192;799;1;0;0;0;0;192;2;190
131900074;700;731;734;0;237;699;1;0;0;0;0;237;7;230
131900075;700;707;708;5;357;699;1;0;0;0;0;357;5;352
131900076;700;682;680;9;87;699;1;0;0;0;0;87;1;86
131900077;900;949;949;7;39;899;1;0;0;0;0;39;0;39
131900078;800;805;810;11;270;799;1;0;0;0;0;270;4;266
131900079;700;676;676;0;296;699;1;0;0;0;0;296;3;293
131900080;700;660;662;6;310;699;1;0;0;0;0;310;4;306
131900081;700;759;759;5;267;699;1;0;0;0;0;267;0;267
131900082;600;578;580;6;207;599;1;0;0;0;0;207;5;202
131900083;900;955;954;0;46;899;1;0;0;0;0;46;1;45
131900084;900;902;903;6;46;899;1;0;0;0;0;46;1;45
131900085;900;987;987;5;69;900;0;0;0;0;0;69;0;69
131900086;700;703;702;6;65;700;0;0;0;0;0;65;1;64
131900087;600;622;625;6;247;599;1;0;0;0;0;247;1;246
131900088;200;222;223;0;115;83;2;115;2;1;112;0;0;0
131900089;600;634;636;8;54;599;1;0;0;0;0;54;0;54
131900090;600;576;578;5;264;599;1;0;0;0;0;264;4;260
131900091;700;782;782;7;40;699;1;0;0;0;0;40;0;40
131900092;100;15;15;59;64;34;2;64;1;0;63;0;0;0
131900093;100;48;48;4;24;75;1;24;4;0;20;0;0;0
131900094;100;36;36;25;56;42;2;56;7;2;47;0;0;0
131900095;200;106;106;8;61;138;1;61;17;1;43;0;0;0
131900096;100;12;12;14;24;75;1;24;5;0;19;0;0;0
131900100;100;27;27;1;25;75;0;25;1;0;24;0;0;0
131900101;100;17;17;1;18;81;1;18;1;0;17;0;0;0
131900151;800;813;815;5;68;799;1;0;0;0;0;68;2;66
131900152;900;926;926;5;78;899;1;0;0;0;0;78;1;77
131900153;600;661;664;2;174;599;1;0;0;0;0;174;0;174
131900154;400;352;354;6;79;399;1;0;0;0;0;79;0;79
131900155;700;739;738;5;273;699;1;0;0;0;0;273;2;271
131900156;900;1013;1015;1;100;900;0;0;0;0;0;100;0;100
131900157;700;771;774;1;315;699;1;0;0;0;0;315;2;313
131900158;500;563;562;5;195;499;1;0;0;0;0;195;2;193
131900159;600;591;591;2;188;599;1;0;0;0;0;188;1;187
131900160;600;587;585;2;222;599;1;0;0;0;0;222;5;217
131900161;500;495;495;3;187;499;1;0;0;0;0;187;0;187
131900162;600;674;675;0;50;599;1;0;0;0;0;50;1;49
131900163;700;743;743;1;340;699;1;0;0;0;0;340;1;339
131900164;600;615;615;5;206;599;1;0;0;0;0;206;3;203
131900165;500;494;493;1;173;499;1;0;0;0;0;173;1;172
131900166;800;860;863;3;187;799;1;0;0;0;0;187;4;183
131900167;700;703;703;2;225;699;1;0;0;0;0;225;2;223
131900168;800;873;875;2;190;799;1;0;0;0;0;190;5;185
131900169;700;763;768;2;272;699;1;0;0;0;0;272;0;272
131900170;800;873;873;1;185;799;1;0;0;0;0;185;4;181
131900171;340;341;340;1;166;339;1;0;0;0;0;166;0;166
131900172;800;760;763;1;237;799;1;0;0;0;0;237;2;235
131900173;800;808;812;1;204;799;1;0;0;0;0;204;2;202
131900174;900;952;952;2;41;899;1;0;0;0;0;41;0;41
131900175;700;733;734;1;228;699;1;0;0;0;0;228;6;222
131900176;500;492;495;2;235;499;1;0;0;0;0;235;1;234
131900177;700;784;785;4;161;699;1;0;0;0;0;161;2;159
131900178;800;830;832;5;296;799;1;0;0;0;0;296;2;294
131900179;590;590;592;1;215;589;1;0;0;0;0;215;2;213
131900180;700;742;743;3;91;699;1;0;0;0;0;91;2;89
131900181;500;521;521;4;224;499;1;0;0;0;0;224;5;219
131900182;400;444;446;2;173;399;1;0;0;0;0;173;4;169
131900183;400;457;459;1;216;399;1;0;0;0;0;216;0;216
131900184;200;170;172;3;75;125;0;75;2;3;70;0;0;0
131900185;800;748;843;2;260;799;1;0;0;0;0;260;5;255
131900186;800;843;751;1;235;799;1;0;0;0;0;235;2;233
131900187;800;887;900;0;288;800;0;0;0;0;0;288;3;285
131900188;400;430;430;2;202;399;1;0;0;0;0;202;5;197
131900189;600;645;645;1;193;600;0;0;0;0;0;193;0;193
131900190;500;567;568;2;96;499;1;0;0;0;0;96;2;94
131900191;700;768;769;0;271;699;1;0;0;0;0;271;2;269
131900192;800;891;892;0;208;799;1;0;0;0;0;208;1;207
131900193;700;756;757;4;348;699;1;0;0;0;0;348;4;344
131900194;200;181;181;2;90;109;1;90;0;0;90;0;0;0
131900195;400;407;405;5;166;399;1;0;0;0;0;166;2;164
131900196;300;216;217;2;114;184;2;114;1;1;112;0;0;0
131900197;700;766;767;4;235;699;1;0;0;0;0;235;0;235
131900198;200;147;148;2;91;108;1;91;2;4;85;0;0;0
131900200;500;506;506;3;194;499;1;0;0;0;0;194;4;190
131900201;600;636;635;2;71;599;1;0;0;0;0;71;0;71
131900202;400;451;451;2;182;399;1;0;0;0;0;182;5;177
131900203;600;656;660;1;162;599;1;0;0;0;0;162;3;159
131900204;800;799;801;4;261;799;1;0;0;0;0;261;3;258
131900205;600;645;646;2;77;599;1;0;0;0;0;77;0;77
131900206;100;35;35;0;34;65;1;34;6;0;28;0;0;0
132000001;500;940;940;0;366;499;1;0;0;0;0;366;4;362
132000002;500;834;834;0;316;499;1;0;0;0;0;316;5;311
132000003;500;954;954;3;392;500;0;0;0;0;0;392;7;385
132000004;500;926;928;1;351;499;1;0;0;0;0;351;9;342
132000005;500;895;896;0;347;500;0;0;0;0;0;347;4;343
132000006;500;889;889;0;352;499;1;0;0;0;0;352;6;346
132000007;500;861;861;0;182;500;0;0;0;0;0;182;6;176
132000008;500;907;909;0;316;499;1;0;0;0;0;316;5;311
132000009;500;950;953;0;403;500;0;0;0;0;0;403;4;399
132000010;500;915;917;0;366;499;1;0;0;0;0;366;8;358
132000011;500;916;918;3;318;499;1;0;0;0;0;318;5;313
132000012;500;776;777;0;347;499;1;0;0;0;0;347;5;342
132000013;500;691;691;0;266;499;1;0;0;0;0;266;6;260
132000014;500;943;947;0;341;499;1;0;0;0;0;341;3;338
132000015;899;899;902;0;250;898;1;0;0;0;0;250;0;250
132000016;500;821;821;7;275;499;1;0;0;0;0;275;2;273
132000017;500;958;960;1;383;499;1;0;0;0;0;383;8;375
132000018;500;571;571;5;235;499;1;0;0;0;0;235;1;234
132000019;500;871;871;1;367;499;1;0;0;0;0;367;6;361
132000020;500;553;554;2;215;499;1;0;0;0;0;215;2;213
132000021;500;527;527;3;165;500;0;0;0;0;0;165;1;164
132000022;500;930;934;2;353;499;1;0;0;0;0;353;5;348
132000023;500;237;237;5;97;402;1;97;1;0;96;0;0;0
132000024;600;608;608;3;122;600;0;0;0;0;0;122;0;122
132000025;500;819;820;1;272;499;1;0;0;0;0;272;3;269
132000026;500;756;757;2;245;499;1;0;0;0;0;245;0;245
132000027;500;57;57;62;106;393;1;106;1;2;103;0;0;0
132100001;1000;1160;1162;9;51;999;1;0;0;0;0;51;0;51
132100002;1151;1151;1151;7;44;1150;1;0;0;0;0;44;0;44
132100003;500;451;453;5;194;499;1;0;0;0;0;194;1;193
132100004;900;856;857;7;230;899;1;0;0;0;0;230;6;224
132100005;1000;1034;1035;5;57;999;1;0;0;0;0;57;0;57
132100006;1000;1121;1121;0;67;999;1;0;0;0;0;67;0;67
132100007;600;565;566;0;203;599;1;0;0;0;0;203;5;198
132100008;600;620;620;6;201;599;1;0;0;0;0;201;3;198
132100009;800;807;810;6;289;799;1;0;0;0;0;289;6;283
132100010;500;259;541;6;261;499;1;0;0;0;0;261;1;260
132100011;600;613;614;5;249;599;1;0;0;0;0;249;2;247
132100012;600;549;551;1;220;599;1;0;0;0;0;220;2;218
132100013;500;459;459;4;167;499;1;0;0;0;0;167;2;165
132100014;600;601;602;5;234;599;1;0;0;0;0;234;5;229
132100015;500;464;466;0;215;499;1;0;0;0;0;215;0;215
132100016;600;590;593;7;258;599;1;0;0;0;0;258;2;256
132100017;600;547;547;5;230;599;1;0;0;0;0;230;4;226
132100018;600;617;619;4;231;599;1;0;0;0;0;231;10;221
132100019;900;848;849;2;356;899;1;0;0;0;0;356;5;351
132100020;800;737;740;5;296;799;1;0;0;0;0;296;4;292
132100021;800;741;741;5;315;799;1;0;0;0;0;315;4;311
132100022;500;449;449;0;178;499;1;0;0;0;0;178;2;176
132100023;1000;1171;1173;10;91;999;1;0;0;0;0;91;1;90
132100024;100;14;14;3;17;82;1;17;0;0;17;0;0;0
132100026;600;595;595;4;262;599;1;0;0;0;0;262;8;254
132100027;600;530;531;1;241;599;1;0;0;0;0;241;2;239
132100028;600;598;598;7;236;599;1;0;0;0;0;236;1;235
132400001;500;687;691;2;250;499;1;0;0;0;0;250;1;249
132400002;500;700;700;3;265;499;1;0;0;0;0;265;6;259
132400003;500;661;661;0;262;499;1;0;0;0;0;262;1;261
132400004;500;704;704;0;214;499;1;0;0;0;0;214;1;213
132400005;500;534;560;0;187;499;1;0;0;0;0;187;0;187
132400006;600;799;802;0;224;599;1;0;0;0;0;224;3;221
132400007;500;1095;1095;3;107;499;1;0;0;0;0;107;0;107
132400008;600;86;1037;6;92;599;1;0;0;0;0;92;0;92
132400009;600;766;766;2;171;599;1;0;0;0;0;171;1;170
132400010;600;801;802;0;198;600;0;0;0;0;0;198;1;197
132400011;600;984;987;0;277;600;0;0;0;0;0;277;7;270
132400012;600;1013;1014;0;210;600;0;0;0;0;0;210;2;208
132400013;500;721;722;0;306;499;1;0;0;0;0;306;0;306
132400014;500;924;924;0;261;499;1;0;0;0;0;261;0;261
132400015;500;678;678;0;238;500;0;0;0;0;0;238;0;238
132400016;658;658;658;7;118;657;1;0;0;0;0;118;1;117
132400017;100;16;16;0;16;83;1;16;0;0;16;0;0;0
132900001;1000;1026;1026;1;84;999;1;0;0;0;0;84;0;84
132900002;1000;1028;1028;4;103;999;1;0;0;0;0;103;0;103
132900003;800;864;867;2;289;799;1;0;0;0;0;289;1;288
132900004;700;773;773;1;258;699;1;0;0;0;0;258;3;255
132900005;800;833;836;3;373;799;1;0;0;0;0;373;6;367
132900006;800;787;789;1;330;799;1;0;0;0;0;330;4;326
132900007;800;803;803;0;340;799;1;0;0;0;0;340;6;334
132900008;800;843;843;3;350;799;1;0;0;0;0;350;5;345
132900009;600;641;646;5;315;599;1;0;0;0;0;315;6;309
132900010;900;902;902;4;295;899;1;0;0;0;0;295;6;289
132900011;800;842;844;1;322;799;1;0;0;0;0;322;2;320
132900012;600;609;610;0;176;599;1;0;0;0;0;176;2;174
132900013;700;686;687;3;187;699;1;0;0;0;0;187;2;185
132900014;900;934;935;0;180;899;1;0;0;0;0;180;2;178
132900015;600;574;577;2;234;599;1;0;0;0;0;234;2;232
132900016;500;533;535;1;186;499;1;0;0;0;0;186;1;185
132900017;600;550;550;0;226;599;1;0;0;0;0;226;2;224
132900018;600;589;589;2;178;599;1;0;0;0;0;178;4;174
132900019;600;547;552;2;254;599;1;0;0;0;0;254;0;254
132900020;100;21;21;0;12;87;1;12;2;0;10;0;0;0
132900021;700;731;731;5;205;699;1;0;0;0;0;205;3;202
132900022;900;892;895;4;306;900;0;0;0;0;0;306;4;302
132900023;1000;1060;1060;0;31;999;1;0;0;0;0;31;0;31
132900024;500;464;464;1;243;499;1;0;0;0;0;243;0;243
132900025;600;594;594;1;142;600;0;0;0;0;0;142;1;141
132900026;800;794;795;2;321;799;1;0;0;0;0;321;2;319
132900027;700;762;764;1;318;699;1;0;0;0;0;318;4;314
132900028;800;837;837;4;156;799;1;0;0;0;0;156;1;155
132900029;800;756;757;3;297;799;1;0;0;0;0;297;4;293
132900030;400;247;249;5;109;290;1;109;2;2;105;0;0;0
132900031;100;31;31;1;30;69;1;30;0;0;30;0;0;0
133200001;700;748;748;1;332;699;1;0;0;0;0;332;8;324
133200002;800;878;879;2;356;799;1;0;0;0;0;356;1;355
133200003;700;739;739;1;264;699;1;0;0;0;0;264;1;263
133200004;500;560;561;0;218;499;1;0;0;0;0;218;4;214
133200005;601;601;601;0;247;600;1;0;0;0;0;247;2;245
133200006;200;132;132;5;89;110;1;89;8;2;79;0;0;0
133200007;200;189;191;6;111;88;1;111;4;0;107;0;0;0
133200008;100;119;119;3;57;42;1;57;3;0;54;0;0;0
133200009;200;137;137;5;62;137;1;62;2;0;60;0;0;0
133900001;1000;958;1024;9;596;999;1;0;0;0;0;596;3;593
133900002;1000;908;983;1;533;999;1;0;0;0;0;533;3;530
133900003;1000;947;1005;2;536;999;1;0;0;0;0;536;2;534
133900004;500;544;544;1;327;499;1;0;0;0;0;327;0;327
133900005;500;608;608;1;222;499;1;0;0;0;0;222;0;222
133900006;300;199;199;0;198;102;0;198;3;0;195;0;0;0
133900007;200;121;121;0;118;82;0;118;0;0;118;0;0;0
140800001;700;838;840;9;251;699;1;0;0;0;0;251;6;245
140800002;700;846;846;7;327;699;1;0;0;0;0;327;5;322
140800003;700;826;840;6;382;700;0;0;0;0;0;382;6;376
140800004;700;850;860;1;325;699;1;0;0;0;0;325;3;322
140800005;100;28;28;7;19;80;1;19;1;0;18;0;0;0
140800006;100;19;19;5;24;75;1;24;1;0;23;0;0;0
140800007;100;25;25;6;16;84;0;16;0;0;16;0;0;0
140800008;100;43;44;5;24;75;1;24;0;0;24;0;0;0
140800009;100;65;65;6;45;54;1;45;1;1;43;0;0;0
140800010;100;42;42;7;31;67;2;31;0;0;31;0;0;0
140800011;100;26;29;4;21;78;1;21;1;0;20;0;0;0
140800012;100;66;66;6;44;54;2;44;0;1;43;0;0;0
140800013;100;77;77;5;42;57;1;42;1;0;41;0;0;0
140800014;100;65;60;5;33;66;1;33;0;1;32;0;0;0
140800015;100;101;101;3;49;50;1;49;2;1;46;0;0;0
140800016;100;46;46;4;27;72;1;27;0;0;27;0;0;0
140800017;100;38;38;5;31;68;1;31;0;0;31;0;0;0
140800018;100;17;17;3;20;79;1;20;0;0;20;0;0;0
140800019;200;121;121;4;77;122;1;77;2;1;74;0;0;0
140800020;200;163;168;1;87;112;1;87;4;2;81;0;0;0
140800021;100;89;90;6;61;37;2;61;0;1;60;0;0;0
140800022;100;42;43;4;28;71;1;28;0;0;28;0;0;0
140800023;500;442;442;3;207;500;0;0;0;0;0;207;1;206
140800024;200;129;129;4;63;136;1;63;2;0;61;0;0;0
140800025;100;80;80;5;50;49;1;50;2;2;46;0;0;0
140800026;200;179;179;4;105;94;1;105;2;0;103;0;0;0
141900001;300;296;298;6;166;133;1;166;3;1;162;0;0;0
141900002;600;538;543;3;265;599;1;0;0;0;0;265;4;261
141900003;500;472;478;5;228;499;1;0;0;0;0;228;3;225
141900004;100;59;53;6;39;60;1;39;1;0;38;0;0;0
141900005;100;69;69;6;47;52;1;47;1;1;45;0;0;0
141900006;200;134;136;3;93;106;1;93;6;2;85;0;0;0
141900007;100;43;43;6;31;67;2;31;2;0;29;0;0;0
141900008;100;89;89;6;53;46;1;53;1;0;52;0;0;0
141900009;100;32;33;6;21;78;1;21;0;0;21;0;0;0
141900010;100;66;67;7;49;50;1;49;2;1;46;0;0;0
141900011;100;43;43;6;35;62;3;35;2;0;33;0;0;0
141900012;200;120;120;4;81;118;1;81;0;0;81;0;0;0
141900013;100;59;59;5;46;53;1;46;1;1;44;0;0;0
141900014;100;15;15;4;19;81;0;19;0;0;19;0;0;0
142200001;100;78;78;5;54;44;2;54;0;0;54;0;0;0
142200002;100;70;71;6;47;52;1;47;4;1;42;0;0;0
142200003;200;164;184;4;98;101;1;98;0;3;95;0;0;0
142200004;200;194;194;5;118;79;3;118;2;2;114;0;0;0
142200005;100;55;55;5;48;51;1;48;1;0;47;0;0;0
142200006;200;160;160;2;116;83;1;116;4;1;111;0;0;0
142200007;300;250;250;3;143;156;1;143;5;0;138;0;0;0
142200008;200;125;125;5;73;126;1;73;1;1;71;0;0;0
142200009;100;25;25;7;16;83;1;16;1;0;15;0;0;0
142200010;100;20;20;8;19;80;1;19;2;0;17;0;0;0
143200001;500;588;591;8;196;500;0;0;0;0;0;196;3;193
143200002;500;584;584;10;198;500;0;0;0;0;0;198;3;195
143200003;700;937;938;10;339;700;0;0;0;0;0;339;6;333
143200004;500;550;551;3;226;500;0;0;0;0;0;226;5;221
143200005;400;512;512;5;183;399;1;0;0;0;0;183;1;182
143200006;500;496;496;9;213;500;0;0;0;0;0;213;1;212
143200007;500;535;536;4;201;500;0;0;0;0;0;201;5;196
143200008;500;578;580;6;219;500;0;0;0;0;0;219;3;216
143200009;500;644;644;8;256;500;0;0;0;0;0;256;5;251
143200010;700;864;866;5;344;700;0;0;0;0;0;344;4;340
143200011;500;582;582;8;251;499;1;0;0;0;0;251;3;248
143200012;500;538;538;8;269;500;0;0;0;0;0;269;6;263
143200013;600;763;763;6;319;599;1;0;0;0;0;319;12;307
143200014;500;468;468;8;195;499;1;0;0;0;0;195;5;190
143200015;500;578;578;7;247;500;0;0;0;0;0;247;1;246
143200016;500;517;519;5;151;500;0;0;0;0;0;151;2;149
143200017;500;622;622;5;250;500;0;0;0;0;0;250;6;244
143200018;700;898;898;4;345;700;0;0;0;0;0;345;7;338
143200019;500;548;551;5;239;500;0;0;0;0;0;239;2;237
143200020;500;656;657;7;256;500;0;0;0;0;0;256;7;249
143200021;500;499;498;6;177;500;0;0;0;0;0;177;1;176
143200022;500;592;592;3;200;500;0;0;0;0;0;200;0;200
143200023;500;677;677;8;252;500;0;0;0;0;0;252;4;248
143200024;500;540;540;4;226;500;0;0;0;0;0;226;3;223
143200025;500;548;548;9;193;500;0;0;0;0;0;193;2;191
143200026;500;638;638;8;218;500;0;0;0;0;0;218;2;216
143200027;500;692;693;3;269;500;0;0;0;0;0;269;4;265
143200028;500;691;692;10;255;500;0;0;0;0;0;255;4;251
143200029;400;455;455;2;159;400;0;0;0;0;0;159;2;157
143200030;400;174;443;4;178;399;1;0;0;0;0;178;4;174
143200031;500;721;722;3;281;500;0;0;0;0;0;281;3;278
143200032;500;555;555;7;222;500;0;0;0;0;0;222;2;220
143200033;923;923;923;4;351;923;0;0;0;0;0;351;6;345
143200034;700;848;848;6;309;700;0;0;0;0;0;309;7;302
143200035;600;516;516;3;285;600;0;0;0;0;0;285;7;278
143200036;600;532;534;5;221;599;1;0;0;0;0;221;6;215
143200037;600;485;487;4;207;600;0;0;0;0;0;207;1;206
143200038;600;565;565;5;254;599;1;0;0;0;0;254;1;253
143200039;600;620;620;3;244;600;0;0;0;0;0;244;2;242
143200040;800;749;752;7;282;799;1;0;0;0;0;282;1;281
143200041;600;593;596;7;219;599;1;0;0;0;0;219;4;215
143200042;700;665;665;3;261;699;1;0;0;0;0;261;5;256
143200043;700;704;705;5;232;700;0;0;0;0;0;232;2;230
143200044;600;615;615;5;220;599;1;0;0;0;0;220;5;215
143200045;800;789;790;8;275;800;0;0;0;0;0;275;3;272
143200046;800;797;797;2;325;800;0;0;0;0;0;325;9;316
143200047;600;537;537;7;230;600;0;0;0;0;0;230;5;225
143200048;600;561;561;3;351;599;1;0;0;0;0;351;4;347
143200049;500;509;512;4;251;500;0;0;0;0;0;251;1;250
143200050;1000;933;933;9;433;1000;0;0;0;0;0;433;8;425
143200051;200;139;140;7;102;97;1;102;2;2;98;0;0;0
143200052;100;31;31;0;27;73;0;27;2;0;25;0;0;0
143200053;400;493;493;4;213;400;0;0;0;0;0;213;4;209
143200054;500;679;680;5;275;500;0;0;0;0;0;275;3;272
143200055;500;554;555;0;212;500;0;0;0;0;0;212;3;209
143200056;500;614;614;4;224;500;0;0;0;0;0;224;7;217
143200057;500;606;606;2;231;500;0;0;0;0;0;231;5;226
143200058;500;580;580;1;198;500;0;0;0;0;0;198;7;191
143200059;500;580;582;3;222;500;0;0;0;0;0;222;4;218
143200060;500;591;591;6;227;500;0;0;0;0;0;227;6;221
143200061;500;667;667;2;249;500;0;0;0;0;0;249;4;245
143200062;800;808;808;9;145;800;0;0;0;0;0;145;2;143
143200063;700;647;649;5;88;700;0;0;0;0;0;88;0;88
143200064;700;869;871;9;280;700;0;0;0;0;0;280;7;273
143200065;600;683;686;8;281;600;0;0;0;0;0;281;3;278
143200066;600;817;820;5;309;600;0;0;0;0;0;309;5;304
143200067;400;446;447;5;190;400;0;0;0;0;0;190;6;184
143200068;600;772;772;3;291;600;0;0;0;0;0;291;7;284
143200069;400;493;495;6;216;400;0;0;0;0;0;216;0;216
143200070;600;800;801;1;329;600;0;0;0;0;0;329;14;315
143200071;600;775;777;6;328;600;0;0;0;0;0;328;7;321
143200072;800;799;799;10;103;800;0;0;0;0;0;103;0;103
143200073;1000;936;938;1;358;1000;0;0;0;0;0;358;5;353
143200074;500;673;673;7;327;500;0;0;0;0;0;327;4;323
143200075;400;473;475;7;212;399;1;0;0;0;0;212;6;206
143200076;600;749;751;8;333;600;0;0;0;0;0;333;7;326
143200077;500;688;689;7;332;500;0;0;0;0;0;332;6;326
143200078;400;569;572;4;242;400;0;0;0;0;0;242;2;240
143200079;400;485;485;12;193;400;0;0;0;0;0;193;3;190
143200080;500;647;648;9;287;500;0;0;0;0;0;287;5;282
143200081;500;629;629;8;283;500;0;0;0;0;0;283;2;281
143200082;500;530;530;5;264;500;0;0;0;0;0;264;7;257
143200083;600;753;753;6;321;599;1;0;0;0;0;321;6;315
143200084;600;801;803;8;388;600;0;0;0;0;0;388;5;383
143200085;400;549;549;7;235;399;1;0;0;0;0;235;3;232
143200086;400;546;546;1;250;400;0;0;0;0;0;250;2;248
143200087;400;549;549;6;212;399;1;0;0;0;0;212;6;206
143200088;600;815;818;4;303;599;1;0;0;0;0;303;3;300
143200089;400;455;457;5;211;400;0;0;0;0;0;211;2;209
143200090;500;650;652;4;252;500;0;0;0;0;0;252;3;249
143200091;500;559;559;5;297;500;0;0;0;0;0;297;6;291
143200092;800;818;819;9;359;800;0;0;0;0;0;359;3;356
143200093;600;568;569;6;228;600;0;0;0;0;0;228;5;223
143200094;800;857;858;8;291;800;0;0;0;0;0;291;6;285
143200095;700;690;684;6;272;700;0;0;0;0;0;272;3;269
143200096;700;696;699;8;311;700;0;0;0;0;0;311;5;306
143200097;500;510;513;6;197;500;0;0;0;0;0;197;3;194
143200098;600;713;715;7;294;600;0;0;0;0;0;294;11;283
143200099;600;573;573;6;249;600;0;0;0;0;0;249;4;245
143200100;500;492;493;5;211;500;0;0;0;0;0;211;1;210
143200101;600;821;821;8;357;599;1;0;0;0;0;357;2;355
143200102;500;422;422;3;134;499;1;0;0;0;0;134;0;134
143200103;500;485;485;2;218;499;1;0;0;0;0;218;1;217
143200104;500;538;538;5;193;499;1;0;0;0;0;193;4;189
143200105;600;713;714;8;289;599;1;0;0;0;0;289;2;287
143200106;600;704;704;1;305;600;0;0;0;0;0;305;5;300
143200107;500;582;583;5;226;500;0;0;0;0;0;226;3;223
143200108;500;530;533;2;210;500;0;0;0;0;0;210;3;207
143200109;500;538;539;5;199;500;0;0;0;0;0;199;1;198
143200110;700;823;826;6;341;699;1;0;0;0;0;341;6;335
143200111;500;545;545;6;217;500;0;0;0;0;0;217;6;211
143200112;600;795;795;4;335;600;0;0;0;0;0;335;5;330
143200113;400;476;476;5;207;400;0;0;0;0;0;207;6;201
143200114;500;583;584;5;258;500;0;0;0;0;0;258;4;254
143200115;600;726;726;8;294;600;0;0;0;0;0;294;6;288
143200116;400;386;386;18;177;400;0;0;0;0;0;177;4;173
143200117;600;744;744;7;351;600;0;0;0;0;0;351;5;346
143200118;700;631;631;5;262;700;0;0;0;0;0;262;4;258
143200119;800;753;755;6;333;800;0;0;0;0;0;333;7;326
143200120;800;720;722;4;311;800;0;0;0;0;0;311;2;309
143200121;700;688;690;6;306;700;0;0;0;0;0;306;3;303
143200122;200;172;175;2;87;111;2;87;3;0;84;0;0;0
143200123;300;280;280;4;126;173;1;126;6;2;118;0;0;0
143200124;100;57;57;8;50;49;1;50;2;1;47;0;0;0
143200125;100;25;25;9;29;70;1;29;3;0;26;0;0;0
143200126;600;589;589;5;268;599;1;0;0;0;0;268;3;265
143200127;600;607;608;1;244;599;1;0;0;0;0;244;2;242
143200128;600;594;598;5;282;599;1;0;0;0;0;282;4;278
143200129;300;232;232;5;134;164;2;134;2;1;131;0;0;0
143200130;400;364;364;7;151;400;0;0;0;0;0;151;3;148
143200131;400;381;386;0;170;400;0;0;0;0;0;170;1;169
143200132;500;462;469;9;264;500;0;0;0;0;0;264;4;260
143200133;100;74;76;3;60;39;1;60;0;1;59;0;0;0
143200134;100;81;81;5;59;38;3;59;4;0;55;0;0;0
143200135;100;92;92;5;60;38;2;60;1;4;55;0;0;0
143200136;600;538;538;5;272;600;0;0;0;0;0;272;3;269
143200137;100;12;12;0;12;88;0;12;0;0;12;0;0;0
143200138;100;19;19;3;21;78;1;21;1;0;20;0;0;0
143200139;100;36;36;43;51;48;1;51;0;2;49;0;0;0
143200140;100;22;22;10;19;80;1;19;2;0;17;0;0;0
143600001;500;528;528;5;215;499;1;0;0;0;0;215;5;210
143600002;800;255;843;6;255;800;0;0;0;0;0;255;2;253
143600003;800;880;881;10;349;799;1;0;0;0;0;349;3;346
143600004;700;753;754;4;277;699;1;0;0;0;0;277;6;271
143600005;600;657;657;9;271;599;1;0;0;0;0;271;1;270
143600006;600;629;629;2;290;599;1;0;0;0;0;290;6;284
143600007;700;699;700;8;226;699;1;0;0;0;0;226;7;219
143600008;500;521;521;5;201;499;1;0;0;0;0;201;2;199
143600009;500;526;527;8;149;500;0;0;0;0;0;149;3;146
143600010;700;690;690;2;245;699;1;0;0;0;0;245;5;240
143600011;400;400;400;7;158;399;1;0;0;0;0;158;0;158
143600012;800;827;827;7;211;800;0;0;0;0;0;211;5;206
143600013;700;750;750;6;224;699;1;0;0;0;0;224;4;220
143600014;700;699;699;3;213;699;1;0;0;0;0;213;4;209
143600015;800;813;815;9;191;798;2;0;0;0;0;191;2;189
143600016;400;395;395;6;153;399;1;0;0;0;0;153;1;152
143600017;800;829;829;7;260;799;1;0;0;0;0;260;3;257
143600018;500;557;557;8;222;499;1;0;0;0;0;222;6;216
143600019;300;233;233;4;87;210;3;87;1;1;85;0;0;0
143600020;400;327;327;5;93;400;0;0;0;0;0;93;0;93
143600021;200;170;170;4;84;114;2;84;1;0;83;0;0;0
143600022;300;303;303;5;169;130;1;169;9;2;158;0;0;0
143600023;200;139;139;8;94;105;1;94;3;1;90;0;0;0
143600024;200;177;177;4;108;91;1;108;6;3;99;0;0;0
143600025;400;328;329;6;155;243;2;155;3;10;142;0;0;0
143600026;200;115;115;7;71;128;1;71;0;1;70;0;0;0
143600027;100;101;101;6;54;45;1;54;2;0;52;0;0;0
143600028;200;95;118;6;101;98;1;101;6;1;94;0;0;0
143600029;100;99;99;8;67;32;1;67;4;1;62;0;0;0
143600030;100;34;34;8;23;76;1;23;0;0;23;0;0;0
143600031;100;64;64;7;57;42;1;57;2;1;54;0;0;0
143600032;300;235;235;4;113;186;1;113;0;6;107;0;0;0
143600033;400;329;329;3;173;224;3;173;2;2;169;0;0;0
143600035;100;75;75;6;48;49;3;48;2;0;46;0;0;0
143600036;200;195;195;5;93;106;1;93;4;1;88;0;0;0
143600037;400;400;400;4;214;400;0;0;0;0;0;214;2;212
143600038;100;86;85;6;57;42;1;57;2;0;55;0;0;0
143600039;100;44;44;8;31;68;1;31;1;0;30;0;0;0
143600040;100;57;57;5;36;63;1;36;0;1;35;0;0;0
143600041;200;117;117;6;82;117;1;82;4;0;78;0;0;0
143600042;200;124;124;7;67;132;1;67;2;0;65;0;0;0
143600043;100;64;64;8;33;66;1;33;0;0;33;0;0;0
143600044;100;54;54;6;44;55;1;44;1;0;43;0;0;0
143600045;100;47;47;8;46;53;1;46;6;0;40;0;0;0
143600046;200;119;119;5;74;125;1;74;0;1;73;0;0;0
143600047;100;30;30;6;29;70;1;29;2;0;27;0;0;0
143600048;100;15;28;8;23;76;1;23;0;0;23;0;0;0
143600049;100;30;30;7;28;71;1;28;3;0;25;0;0;0
143600050;100;47;48;7;37;62;1;37;0;0;37;0;0;0
143600051;100;49;50;20;62;36;2;62;6;1;55;0;0;0
145100001;500;485;493;1;200;499;1;0;0;0;0;200;7;193
145100002;500;422;416;1;175;499;1;0;0;0;0;175;5;170
145100003;600;582;578;3;228;599;1;0;0;0;0;228;7;221
145100004;600;613;611;2;182;599;1;0;0;0;0;182;3;179
145100005;200;114;114;5;79;118;3;79;2;1;76;0;0;0
145100006;200;139;143;6;93;106;1;93;2;1;90;0;0;0
145100007;200;128;128;6;93;106;1;93;4;1;88;0;0;0
145100008;100;77;79;4;52;47;1;52;1;2;49;0;0;0
145100009;100;46;46;6;42;57;1;42;0;0;42;0;0;0
145100010;200;113;121;5;82;117;1;82;5;0;77;0;0;0
145100011;100;37;37;4;24;75;1;24;1;1;22;0;0;0
145100012;100;54;55;7;37;62;1;37;0;1;36;0;0;0
145100013;100;34;34;3;28;71;1;28;0;1;27;0;0;0
145100014;100;50;54;5;28;71;1;28;1;0;27;0;0;0
145100015;100;40;40;6;25;74;1;25;1;0;24;0;0;0
145100016;100;105;105;5;78;21;1;78;2;0;76;0;0;0
145100017;200;83;134;4;83;117;0;83;0;0;83;0;0;0
145100018;100;66;66;4;47;51;2;47;1;0;46;0;0;0
145100019;100;39;39;7;28;71;1;28;1;0;27;0;0;0
145100020;100;34;34;6;29;70;1;29;3;2;24;0;0;0
145100021;100;67;67;4;21;78;1;21;2;0;19;0;0;0
145100022;100;11;11;0;11;89;0;11;0;0;11;0;0;0
150300001;900;831;851;1;373;900;0;0;0;0;0;373;8;365
150300002;700;621;645;0;274;699;1;0;0;0;0;274;3;271
150300003;900;839;869;0;357;899;1;0;0;0;0;357;5;352
150300004;600;534;545;1;222;599;1;0;0;0;0;222;2;220
150300005;500;465;487;0;208;499;1;0;0;0;0;208;5;203
150300006;600;597;617;2;219;599;1;0;0;0;0;219;3;216
150300007;800;770;782;0;266;799;1;0;0;0;0;266;5;261
150300008;1000;877;902;1;354;999;1;0;0;0;0;354;2;352
150300009;400;363;368;5;167;399;1;0;0;0;0;167;3;164
150300010;200;213;214;4;114;85;1;114;10;3;101;0;0;0
150300011;300;276;279;5;177;122;1;177;3;1;173;0;0;0
150300012;100;133;137;3;82;17;1;82;2;0;80;0;0;0
150300013;300;238;239;3;99;200;1;99;6;0;93;0;0;0
150300014;100;38;38;0;35;64;1;35;3;1;31;0;0;0
150300015;300;298;298;5;129;170;1;129;0;0;129;0;0;0
150300016;700;706;706;1;297;699;1;0;0;0;0;297;8;289
150300017;100;19;19;0;19;81;0;19;0;0;19;0;0;0
150800001;500;632;634;1;183;499;1;0;0;0;0;183;1;182
150800002;500;496;496;0;140;499;1;0;0;0;0;140;0;140
150800003;500;802;802;1;293;499;1;0;0;0;0;293;2;291
150800004;500;741;745;2;229;499;1;0;0;0;0;229;2;227
150800005;200;250;258;0;158;40;2;158;3;0;155;0;0;0
150800006;200;245;245;0;97;102;1;97;2;1;94;0;0;0
150800007;300;298;298;2;162;135;3;162;0;7;155;0;0;0
150800008;500;803;803;1;274;499;1;0;0;0;0;274;1;273
150800009;500;653;653;2;202;499;1;0;0;0;0;202;1;201
150800010;300;404;404;0;169;300;0;0;0;0;0;169;1;168
150800011;400;513;514;0;190;399;1;0;0;0;0;190;1;189
150800012;500;544;545;8;169;499;1;0;0;0;0;169;1;168
150800013;500;621;622;0;189;499;1;0;0;0;0;189;2;187
150800014;500;484;486;1;123;499;1;0;0;0;0;123;4;119
150800015;500;509;511;0;139;499;1;0;0;0;0;139;0;139
150800016;500;615;618;0;126;499;1;0;0;0;0;126;1;125
150800017;300;411;414;2;87;299;1;0;0;0;0;87;0;87
150800018;200;173;173;4;65;134;1;65;2;0;63;0;0;0
150800019;200;258;260;1;103;97;0;103;3;2;98;0;0;0
150800020;200;348;362;5;139;199;1;0;0;0;0;139;4;135
150800021;100;25;25;0;25;74;1;25;0;0;25;0;0;0
151000001;300;341;345;1;128;299;1;0;0;0;0;128;0;128
151000002;500;473;474;2;127;500;0;0;0;0;0;127;1;126
151000003;800;787;793;3;195;799;1;0;0;0;0;195;0;195
151000004;400;435;439;1;210;399;1;0;0;0;0;210;4;206
151000005;500;514;516;2;156;499;1;0;0;0;0;156;3;153
151000006;500;458;458;3;169;499;1;0;0;0;0;169;3;166
151000007;500;461;463;4;166;500;0;0;0;0;0;166;3;163
151000008;200;180;182;4;105;94;1;105;1;0;104;0;0;0
151000009;600;638;639;1;245;599;1;0;0;0;0;245;2;243
151000010;700;664;664;5;212;699;1;0;0;0;0;212;4;208
151000011;600;664;665;11;275;599;1;0;0;0;0;275;3;272
151000012;800;801;801;9;207;799;1;0;0;0;0;207;0;207
151000013;500;481;484;3;161;499;1;0;0;0;0;161;1;160
151000014;400;353;353;2;114;399;1;0;0;0;0;114;1;113
151000015;300;339;340;2;110;300;0;0;0;0;0;110;0;110
151000016;400;431;434;4;148;400;0;0;0;0;0;148;0;148
151000017;400;369;369;2;164;399;1;0;0;0;0;164;2;162
151000018;400;401;404;0;122;399;1;0;0;0;0;122;0;122
151000019;300;268;269;0;128;171;1;128;1;0;127;0;0;0
151000020;500;447;450;5;206;499;1;0;0;0;0;206;1;205
151000021;700;676;676;4;284;699;1;0;0;0;0;284;3;281
151000022;600;560;562;7;238;599;1;0;0;0;0;238;1;237
151000023;400;379;379;1;193;399;1;0;0;0;0;193;2;191
151000024;300;343;344;1;100;299;1;0;0;0;0;100;0;100
151000025;500;487;490;1;104;499;1;0;0;0;0;104;1;103
151000026;500;481;484;1;103;499;1;0;0;0;0;103;0;103
151000027;600;565;567;1;140;599;1;0;0;0;0;140;4;136
151000028;400;422;423;3;175;399;1;0;0;0;0;175;1;174
151000029;500;460;460;1;224;500;0;0;0;0;0;224;1;223
151000030;400;443;445;0;129;399;1;0;0;0;0;129;0;129
151000031;600;630;631;3;155;600;0;0;0;0;0;155;1;154
151000032;700;661;663;1;149;699;1;0;0;0;0;149;2;147
151000033;500;483;486;0;137;499;1;0;0;0;0;137;1;136
151000034;100;30;30;3;33;66;1;33;0;1;32;0;0;0
151100001;300;708;710;4;162;299;1;0;0;0;0;162;2;160
151100002;300;543;544;1;218;300;0;0;0;0;0;218;4;214
151100003;300;474;474;4;179;299;1;0;0;0;0;179;1;178
151100004;300;550;551;2;245;299;1;0;0;0;0;245;2;243
151100005;300;490;490;2;201;299;1;0;0;0;0;201;3;198
151100006;300;455;455;2;171;299;1;0;0;0;0;171;4;167
151100007;300;432;432;4;156;299;1;0;0;0;0;156;1;155
151100008;300;887;887;6;158;299;1;0;0;0;0;158;2;156
151100009;300;507;508;2;150;299;1;0;0;0;0;150;2;148
151100010;300;639;640;3;138;299;1;0;0;0;0;138;0;138
151100011;300;579;580;5;146;299;1;0;0;0;0;146;0;146
151100012;300;797;797;5;120;299;1;0;0;0;0;120;1;119
151100013;300;484;484;2;175;299;1;0;0;0;0;175;2;173
151100014;300;607;608;0;167;299;1;0;0;0;0;167;2;165
151100015;300;455;457;3;212;300;0;0;0;0;0;212;1;211
151100016;300;764;765;0;179;299;1;0;0;0;0;179;0;179
151100017;300;311;311;0;141;299;1;0;0;0;0;141;0;141
151100018;300;393;395;1;124;299;1;0;0;0;0;124;0;124
151100019;300;599;599;0;176;299;1;0;0;0;0;176;1;175
151100020;300;481;481;0;144;299;1;0;0;0;0;144;0;144
151100021;300;532;532;2;103;239;1;60;1;0;59;43;0;43
151600001;600;570;571;0;254;600;0;0;0;0;0;254;4;250
151600002;750;742;744;0;306;750;0;0;0;0;0;306;0;306
151600003;740;737;739;0;315;740;0;0;0;0;0;315;2;313
151600004;600;567;567;2;232;599;1;0;0;0;0;232;4;228
151600005;500;479;479;1;196;500;0;0;0;0;0;196;3;193
151600006;800;802;806;2;304;800;0;0;0;0;0;304;2;302
151600007;800;783;785;0;249;800;0;0;0;0;0;249;2;247
151600008;900;883;883;0;155;900;0;0;0;0;0;155;0;155
151600009;1050;1073;1075;0;177;1050;0;0;0;0;0;177;2;175
151600010;900;864;870;0;235;899;1;0;0;0;0;235;1;234
151600011;500;517;517;2;224;500;0;0;0;0;0;224;2;222
151600012;600;596;599;0;235;599;1;0;0;0;0;235;4;231
151600013;450;450;451;0;209;449;1;0;0;0;0;209;0;209
151600014;40;23;23;13;17;22;1;17;1;1;15;0;0;0
151600015;650;652;652;3;218;650;0;0;0;0;0;218;1;217
151600016;650;638;639;0;166;650;0;0;0;0;0;166;0;166
151600017;500;478;478;1;121;500;0;0;0;0;0;121;1;120
151600018;100;79;80;5;44;55;1;44;2;1;41;0;0;0
151600019;700;667;679;0;280;699;1;0;0;0;0;280;5;275
151600020;20;14;14;0;5;15;0;5;0;0;5;0;0;0
151600021;500;494;494;0;147;500;0;0;0;0;0;147;0;147
151600022;350;330;330;2;94;350;0;0;0;0;0;94;4;90
151600023;350;348;348;1;140;349;1;0;0;0;0;140;1;139
151600024;650;631;633;0;310;650;0;0;0;0;0;310;4;306
151600025;550;526;528;1;199;549;1;0;0;0;0;199;0;199
151600026;640;620;620;0;237;639;1;0;0;0;0;237;0;237
151600027;400;408;410;0;148;400;0;0;0;0;0;148;0;148
151600028;550;530;530;5;184;549;1;0;0;0;0;184;1;183
151600029;700;688;688;2;125;699;1;0;0;0;0;125;0;125
151600030;350;353;353;1;127;349;1;0;0;0;0;127;3;124
151600031;500;488;488;4;276;499;1;0;0;0;0;276;2;274
151600032;40;26;26;0;24;16;0;24;0;0;24;0;0;0
151600033;40;25;25;0;24;16;0;24;3;0;21;0;0;0
152100001;1000;1031;1031;6;398;999;1;0;0;0;0;398;1;397
152100002;700;610;631;7;220;699;1;0;0;0;0;220;3;217
152100003;1000;1028;1028;5;306;999;1;0;0;0;0;306;0;306
152100004;800;726;738;6;289;799;1;0;0;0;0;289;4;285
152100005;400;455;473;2;226;399;1;0;0;0;0;226;2;224
152100006;500;572;572;3;272;499;1;0;0;0;0;272;0;272
152100007;200;138;141;2;94;105;1;94;1;0;93;0;0;0
152100008;200;175;175;3;109;89;2;109;3;0;106;0;0;0
152100009;300;372;372;0;153;299;1;0;0;0;0;153;1;152
152100010;100;73;73;2;48;51;1;48;0;0;48;0;0;0
152100011;500;581;582;3;287;499;1;0;0;0;0;287;0;287
152100012;100;63;63;3;44;55;1;44;3;0;41;0;0;0
152100013;500;449;452;2;211;500;0;0;0;0;0;211;4;207
152100014;200;167;167;2;72;127;1;72;5;2;65;0;0;0
152100015;900;870;885;3;374;900;0;0;0;0;0;374;0;374
152100016;300;244;244;2;130;169;1;130;1;1;128;0;0;0
152100017;400;389;389;2;202;399;1;0;0;0;0;202;1;201
152100018;100;96;96;3;95;5;0;95;8;0;87;0;0;0
152100019;200;119;119;1;119;81;0;119;5;0;114;0;0;0
152100020;100;61;61;1;60;39;1;60;1;0;59;0;0;0
152300001;900;868;873;0;166;900;0;0;0;0;0;166;3;163
152300002;700;624;636;2;181;700;0;0;0;0;0;181;3;178
152300003;700;681;681;4;246;699;1;0;0;0;0;246;3;243
152300004;700;656;660;2;197;699;1;0;0;0;0;197;1;196
152300005;500;460;467;2;180;499;1;0;0;0;0;180;0;180
152300006;500;508;508;1;132;500;0;0;0;0;0;132;0;132
152300007;500;505;506;0;105;499;1;0;0;0;0;105;0;105
152300008;500;638;654;2;256;500;0;0;0;0;0;256;1;255
152300009;400;388;388;5;133;399;1;0;0;0;0;133;2;131
152300010;500;438;442;0;110;499;1;0;0;0;0;110;0;110
152300011;100;60;60;0;58;42;0;58;1;0;57;0;0;0
152400001;900;853;853;11;372;900;0;0;0;0;0;372;3;369
152400002;800;770;770;19;338;799;1;0;0;0;0;338;5;333
152400003;900;854;854;18;370;899;1;0;0;0;0;370;5;365
152400004;500;469;470;9;197;499;1;0;0;0;0;197;3;194
152400005;700;704;705;16;261;699;1;0;0;0;0;261;1;260
152400006;1000;927;929;16;267;1000;0;0;0;0;0;267;2;265
152400007;900;915;917;16;429;899;1;0;0;0;0;429;5;424
152400008;900;895;899;19;428;899;1;0;0;0;0;428;2;426
152400009;1000;798;799;16;378;1000;0;0;0;0;0;378;3;375
152400010;800;793;795;6;357;800;0;0;0;0;0;357;6;351
152400011;900;873;876;5;366;899;1;0;0;0;0;366;2;364
152400012;900;846;850;7;304;899;1;0;0;0;0;304;1;303
152400013;800;835;836;8;310;799;1;0;0;0;0;310;1;309
152400014;900;854;853;4;266;899;1;0;0;0;0;266;4;262
152400015;800;772;772;5;321;799;1;0;0;0;0;321;4;317
152400016;800;821;823;9;318;799;1;0;0;0;0;318;3;315
152400017;700;697;698;7;238;699;1;0;0;0;0;238;2;236
152400018;700;740;745;6;270;700;0;0;0;0;0;270;2;268
152400019;900;863;863;6;305;899;1;0;0;0;0;305;2;303
152400020;800;807;808;5;307;799;1;0;0;0;0;307;4;303
152400021;800;823;825;8;319;799;1;0;0;0;0;319;4;315
152400022;800;847;851;5;346;799;1;0;0;0;0;346;1;345
152400023;900;867;869;5;302;899;1;0;0;0;0;302;5;297
152400024;900;937;937;7;342;899;1;0;0;0;0;342;5;337
152400025;800;792;792;6;300;799;1;0;0;0;0;300;4;296
152400026;800;789;790;2;283;799;1;0;0;0;0;283;1;282
152400027;700;714;714;8;199;699;1;0;0;0;0;199;1;198
152400028;1000;958;959;5;337;999;1;0;0;0;0;337;4;333
152400029;900;916;916;7;350;899;1;0;0;0;0;350;4;346
152400030;800;832;823;6;267;799;1;0;0;0;0;267;3;264
152400031;800;778;779;4;326;799;1;0;0;0;0;326;2;324
152400032;800;795;798;4;306;799;1;0;0;0;0;306;4;302
152400033;800;788;787;6;267;799;1;0;0;0;0;267;4;263
152400034;900;849;850;5;355;899;1;0;0;0;0;355;7;348
152400035;800;821;822;7;288;711;2;87;5;0;82;201;0;201
152400036;900;934;935;10;425;899;1;0;0;0;0;425;10;415
152400037;900;906;909;5;337;899;1;0;0;0;0;337;3;334
152400038;800;770;770;6;317;799;1;0;0;0;0;317;4;313
152400039;800;774;774;9;308;799;1;0;0;0;0;308;4;304
152400040;900;854;854;5;341;899;1;0;0;0;0;341;2;339
152400041;700;733;735;6;271;699;1;0;0;0;0;271;2;269
152400042;700;748;748;7;275;700;0;0;0;0;0;275;4;271
152400043;800;760;761;3;343;799;1;0;0;0;0;343;7;336
152400044;800;327;814;6;333;800;0;0;0;0;0;333;2;331
152400045;800;770;770;4;226;799;1;0;0;0;0;226;2;224
152400046;800;790;791;2;261;799;1;0;0;0;0;261;2;259
152400047;900;863;863;3;344;899;1;0;0;0;0;344;7;337
152400048;500;541;540;7;213;500;0;0;0;0;0;213;3;210
152400049;900;875;876;14;367;900;0;0;0;0;0;367;6;361
152400050;700;708;709;7;270;509;1;190;0;4;186;80;0;80
152400051;800;837;837;5;330;799;1;0;0;0;0;330;7;323
152400052;700;728;727;5;260;699;1;0;0;0;0;260;7;253
152400053;800;762;762;7;345;799;1;0;0;0;0;345;3;342
152400054;700;707;708;6;235;700;0;0;0;0;0;235;1;234
152400055;800;814;814;0;322;799;1;0;0;0;0;322;11;311
152400056;700;743;743;7;281;699;1;0;0;0;0;281;2;279
152400057;600;633;633;10;264;599;1;0;0;0;0;264;3;261
152400058;700;726;726;6;225;699;1;0;0;0;0;225;0;225
152400059;700;746;744;8;230;699;1;0;0;0;0;230;4;226
152400060;700;718;721;11;264;699;1;0;0;0;0;264;3;261
152400061;600;577;569;8;198;600;0;0;0;0;0;198;2;196
152400062;900;882;883;9;321;899;1;0;0;0;0;321;2;319
152400063;600;629;621;8;171;599;1;0;0;0;0;171;3;168
152400064;1000;984;982;9;311;1000;0;0;0;0;0;311;6;305
152400065;1000;1024;1025;5;488;999;1;0;0;0;0;488;3;485
152400066;900;905;907;10;403;899;1;0;0;0;0;403;7;396
152400067;800;822;823;3;350;799;1;0;0;0;0;350;4;346
152400068;900;938;937;6;414;899;1;0;0;0;0;414;5;409
152400069;700;766;766;8;316;699;1;0;0;0;0;316;5;311
152400070;800;806;808;9;389;799;1;0;0;0;0;389;8;381
152400071;700;728;731;7;273;699;1;0;0;0;0;273;4;269
152400072;600;610;610;8;277;599;1;0;0;0;0;277;4;273
152400073;800;780;781;8;373;799;1;0;0;0;0;373;7;366
152400074;800;841;842;12;377;799;1;0;0;0;0;377;6;371
152400075;1000;1018;1019;7;426;999;1;0;0;0;0;426;6;420
152400076;800;786;787;8;342;799;1;0;0;0;0;342;2;340
152400077;600;599;596;6;283;599;1;0;0;0;0;282;1;281
152400078;800;828;830;8;282;799;1;0;0;0;0;282;0;282
152400079;700;658;649;9;259;700;0;0;0;0;0;259;8;251
152400080;600;591;592;5;239;599;1;0;0;0;0;239;5;234
152400081;500;524;525;8;262;499;1;0;0;0;0;262;3;259
152400082;500;484;484;6;239;499;1;0;0;0;0;239;4;235
152400083;700;685;686;7;152;699;1;0;0;0;0;152;1;151
152400084;600;639;639;5;266;599;1;0;0;0;0;266;4;262
152400085;800;812;796;7;301;799;1;0;0;0;0;301;8;293
152400086;800;760;762;8;336;799;1;0;0;0;0;336;3;333
152400087;500;561;560;11;261;499;1;0;0;0;0;261;5;256
152400088;600;645;632;7;272;599;1;0;0;0;0;272;2;270
152400089;700;703;704;10;326;699;1;0;0;0;0;326;5;321
152400090;500;537;538;10;240;499;1;0;0;0;0;240;5;235
152400091;900;926;931;10;396;899;1;0;0;0;0;396;2;394
152400092;700;739;742;12;353;700;0;0;0;0;0;353;7;346
152400093;800;789;784;5;303;799;1;0;0;0;0;303;6;297
152400094;900;874;875;7;349;899;1;0;0;0;0;349;2;347
152400095;800;802;800;18;310;799;1;0;0;0;0;310;3;307
152400096;1000;977;977;5;455;999;1;0;0;0;0;455;7;448
152400097;700;748;750;3;334;699;1;0;0;0;0;334;4;330
152400098;900;939;939;7;431;899;1;0;0;0;0;431;11;420
152400099;900;867;868;8;410;899;1;0;0;0;0;410;7;403
152400100;600;666;664;8;290;599;1;0;0;0;0;290;3;287
152400101;936;402;936;11;413;935;1;0;0;0;0;413;10;403
152400102;700;698;699;9;374;699;1;0;0;0;0;374;5;369
152400103;700;729;729;11;343;699;1;0;0;0;0;343;2;341
152400104;800;794;797;6;348;799;1;0;0;0;0;348;2;346
152400105;600;610;611;10;278;600;0;0;0;0;0;278;5;273
152400106;800;745;745;9;326;800;0;0;0;0;0;326;7;319
152400107;600;648;650;10;282;599;1;0;0;0;0;282;4;278
152400108;800;775;773;8;376;799;1;0;0;0;0;376;3;373
152400109;500;524;525;6;247;499;1;0;0;0;0;247;2;245
152400110;600;638;636;9;265;599;1;0;0;0;0;265;2;263
152400111;600;618;618;7;260;599;1;0;0;0;0;260;4;256
152400112;700;701;702;7;320;699;1;0;0;0;0;320;3;317
152400113;800;804;811;8;371;799;1;0;0;0;0;371;4;367
152400114;900;866;866;8;379;899;1;0;0;0;0;379;1;378
152400115;900;868;871;8;391;899;1;0;0;0;0;391;5;386
152400116;900;869;866;5;388;899;1;0;0;0;0;388;2;386
152400117;700;665;666;8;310;699;1;0;0;0;0;310;8;302
152400118;700;701;703;7;306;699;1;0;0;0;0;306;6;300
152400119;700;668;670;9;310;699;1;0;0;0;0;310;4;306
152400120;600;637;635;7;251;599;1;0;0;0;0;251;5;246
152400121;600;576;559;8;239;599;1;0;0;0;0;239;5;234
152400122;600;656;658;5;267;599;1;0;0;0;0;267;3;264
152400123;800;774;777;7;321;799;1;0;0;0;0;321;7;314
152400124;900;839;836;8;406;899;1;0;0;0;0;406;10;396
152400125;700;733;733;5;314;699;1;0;0;0;0;314;7;307
152400126;800;832;832;8;348;799;1;0;0;0;0;348;5;343
152400127;900;883;884;5;397;899;1;0;0;0;0;397;6;391
152400128;100;28;28;6;34;65;1;34;0;2;32;0;0;0
152400129;100;40;40;0;40;59;1;40;0;0;40;0;0;0
152400130;100;45;45;5;49;50;1;49;1;0;48;0;0;0
152400131;100;25;25;7;20;79;1;20;5;0;15;0;0;0
152400132;200;79;79;50;116;83;1;116;0;2;114;0;0;0
152400200;500;524;537;4;238;500;0;0;0;0;0;238;3;235
152400201;600;536;537;1;266;600;0;0;0;0;0;266;2;264
152400202;700;715;718;4;278;699;1;0;0;0;0;278;1;277
152400203;600;562;565;3;166;599;1;0;0;0;0;166;1;165
152400204;800;807;808;9;214;800;0;0;0;0;0;214;1;213
152400205;1000;994;994;4;112;1000;0;0;0;0;0;112;0;112
152400206;1000;994;994;4;179;1000;0;0;0;0;0;179;2;177
152400207;400;440;446;4;218;400;0;0;0;0;0;218;3;215
152400208;100;116;116;5;83;16;1;83;3;0;80;0;0;0
152400209;500;558;558;3;207;499;1;0;0;0;0;207;0;207
152400210;700;748;748;3;286;699;1;0;0;0;0;286;8;278
152400211;300;328;329;5;106;299;1;0;0;0;0;106;2;104
152400212;400;382;382;4;112;399;1;0;0;0;0;112;1;111
152400213;100;102;106;4;74;24;2;74;1;2;71;0;0;0
152400214;300;240;240;6;126;173;1;126;4;3;119;0;0;0
152400215;100;64;64;5;56;43;1;56;1;0;55;0;0;0
152400216;500;513;518;2;264;499;1;0;0;0;0;264;2;262
152400217;500;473;472;2;124;499;1;0;0;0;0;124;1;123
152400218;700;752;752;1;255;699;1;0;0;0;0;255;6;249
152400219;600;666;667;0;226;599;1;0;0;0;0;226;0;226
152400220;400;434;434;4;197;400;0;0;0;0;0;197;1;196
152400221;400;380;380;4;140;400;0;0;0;0;0;140;0;140
152400222;300;235;236;2;148;150;2;148;7;0;141;0;0;0
152400223;500;519;523;1;120;499;1;0;0;0;0;120;0;120
152400224;900;903;905;1;203;899;1;0;0;0;0;203;3;200
152400225;500;483;484;2;195;499;1;0;0;0;0;195;0;195
152400226;900;848;849;1;235;899;1;0;0;0;0;235;3;232
152400227;800;790;794;0;279;799;1;0;0;0;0;279;4;275
152400228;300;273;273;1;200;98;2;200;10;2;188;0;0;0
152400229;300;241;242;6;145;154;1;145;1;0;144;0;0;0
152400230;800;758;759;1;163;800;0;0;0;0;0;163;3;160
152400231;700;768;768;2;307;699;1;0;0;0;0;307;2;305
152400232;800;792;795;3;321;799;1;0;0;0;0;321;3;318
152400233;500;524;525;1;179;499;1;0;0;0;0;179;1;178
152400234;600;622;625;7;173;599;1;0;0;0;0;173;0;173
152700001;600;607;608;3;195;600;0;0;0;0;0;195;1;194
152700002;600;548;548;0;199;600;0;0;0;0;0;199;1;198
152700003;500;470;470;1;214;500;0;0;0;0;0;214;7;207
152700004;150;141;141;3;85;64;1;85;1;0;84;0;0;0
152700005;700;704;704;3;307;700;0;0;0;0;0;307;1;306
152700006;450;439;441;3;217;450;0;0;0;0;0;217;1;216
152700007;700;643;644;6;230;700;0;0;0;0;0;230;5;225
152700008;100;59;59;5;48;51;1;48;1;0;47;0;0;0
152700009;800;754;754;2;212;800;0;0;0;0;0;212;0;212
152700010;400;373;375;1;149;400;0;0;0;0;0;149;0;149
153700001;400;318;322;1;135;399;1;0;0;0;0;135;1;134
153700002;400;432;432;1;136;399;1;0;0;0;0;136;1;135
153700003;600;633;634;0;203;599;1;0;0;0;0;203;1;202
153700004;400;410;410;2;172;399;1;0;0;0;0;172;0;172
153700005;600;659;665;0;173;599;1;0;0;0;0;173;2;171
153700006;600;572;573;4;182;599;1;0;0;0;0;182;0;182
153700007;700;725;725;1;195;699;1;0;0;0;0;195;2;193
153700008;600;607;609;0;182;599;1;0;0;0;0;182;0;182
153700009;700;764;764;1;250;699;1;0;0;0;0;250;0;250
153700010;1000;982;982;1;200;999;1;0;0;0;0;200;3;197
153700011;700;736;736;3;231;699;1;0;0;0;0;231;1;230
153700012;300;331;331;3;147;299;1;0;0;0;0;147;1;146
153700013;700;636;639;1;208;699;1;0;0;0;0;208;1;207
153700014;600;540;547;1;173;599;1;0;0;0;0;173;1;172
153700015;700;653;653;2;245;699;1;0;0;0;0;245;1;244
153700016;800;769;778;1;334;800;0;0;0;0;0;334;3;331
153700017;1000;941;943;0;295;999;1;0;0;0;0;295;1;294
153700018;550;550;556;3;195;550;0;0;0;0;0;195;0;195
153700019;400;353;357;2;179;399;1;0;0;0;0;179;0;179
153700020;400;355;356;1;194;399;1;0;0;0;0;194;1;193
153700021;600;610;611;2;285;599;1;0;0;0;0;285;0;285
153700022;700;632;633;1;208;700;0;0;0;0;0;208;1;207
153700023;800;740;742;5;296;799;1;0;0;0;0;296;3;293
153700024;600;599;599;4;283;599;1;0;0;0;0;283;5;278
153700025;700;612;612;5;249;700;0;0;0;0;0;249;1;248
153700026;700;702;703;0;279;699;1;0;0;0;0;279;4;275
153700027;600;576;577;1;222;599;1;0;0;0;0;222;2;220
153700028;800;774;774;1;288;799;1;0;0;0;0;288;3;285
153700029;700;672;673;4;259;699;1;0;0;0;0;259;3;256
153700030;700;663;667;4;272;699;1;0;0;0;0;272;1;271
153700031;800;737;740;1;283;799;1;0;0;0;0;283;2;281
153700032;600;631;633;0;294;599;1;0;0;0;0;294;1;293
153700033;800;858;858;0;286;799;1;0;0;0;0;286;7;279
153700034;800;876;877;4;300;799;1;0;0;0;0;300;6;294
153700035;800;896;897;0;302;799;1;0;0;0;0;302;4;298
153700036;700;735;735;4;150;699;1;0;0;0;0;150;0;150
153700037;500;593;593;6;94;499;1;0;0;0;0;94;0;94
153700038;400;424;424;0;133;399;1;0;0;0;0;133;1;132
153700039;400;441;443;2;186;399;1;0;0;0;0;186;2;184
153700040;100;39;39;0;39;61;0;39;1;0;38;0;0;0
153900001;800;803;811;7;352;799;1;0;0;0;0;352;3;349
153900002;600;632;641;4;236;599;1;0;0;0;0;236;3;233
153900003;700;754;756;9;276;699;1;0;0;0;0;276;3;273
153900004;700;671;679;7;347;699;1;0;0;0;0;347;6;341
153900005;716;716;720;3;348;715;1;0;0;0;0;348;2;346
153900006;600;582;587;9;144;600;0;0;0;0;0;144;0;144
153900007;900;840;845;7;154;900;0;0;0;0;0;154;1;153
153900008;700;729;734;4;286;699;1;0;0;0;0;286;4;282
153900009;500;536;539;4;201;499;1;0;0;0;0;201;3;198
153900010;600;621;626;6;251;599;1;0;0;0;0;251;3;248
153900011;500;520;523;11;251;499;1;0;0;0;0;251;6;245
153900012;800;737;746;8;284;799;1;0;0;0;0;284;2;282
153900013;700;683;689;9;269;699;1;0;0;0;0;269;4;265
153900014;800;740;752;3;296;799;1;0;0;0;0;296;2;294
153900015;600;644;666;4;241;599;1;0;0;0;0;241;3;238
153900016;700;771;795;4;265;700;0;0;0;0;0;265;2;263
153900017;400;277;288;2;189;208;3;189;11;2;176;0;0;0
153900018;100;37;37;7;43;57;0;43;2;0;41;0;0;0
153900019;50;30;30;0;30;20;0;30;2;0;28;0;0;0
153900020;50;32;32;4;35;15;0;35;1;0;34;0;0;0
153900021;100;41;41;16;35;64;1;35;4;2;29;0;0;0
162201001;500;452;452;6;211;500;0;0;0;0;0;211;3;208
162201002;500;485;485;7;227;499;1;0;0;0;0;227;1;226
162201003;500;494;492;8;210;499;1;0;0;0;0;210;1;209
162201004;700;683;683;3;254;517;1;182;1;1;180;72;2;70
162201005;300;337;338;8;149;299;1;0;0;0;0;149;3;146
162201006;400;386;386;7;178;399;1;0;0;0;0;178;1;177
162201007;500;500;505;5;240;500;0;0;0;0;0;240;6;234
162201008;700;736;736;7;340;700;0;0;0;0;0;340;6;334
162201009;700;746;747;8;357;699;1;0;0;0;0;357;4;353
162201010;500;233;502;7;233;500;0;0;0;0;0;233;3;230
162201011;300;341;338;7;168;300;0;0;0;0;0;168;0;168
162201012;600;655;654;4;279;599;1;0;0;0;0;279;2;277
162201013;800;759;760;5;334;799;1;0;0;0;0;334;5;329
162201014;700;680;680;10;329;699;1;0;0;0;0;329;11;318
162201015;500;481;481;6;207;499;1;0;0;0;0;207;4;203
162201016;700;687;687;12;311;699;1;0;0;0;0;311;5;306
162201017;600;547;548;8;219;599;1;0;0;0;0;219;8;211
162201018;400;422;424;6;192;399;1;0;0;0;0;192;2;190
162201019;600;601;602;9;276;599;1;0;0;0;0;276;3;273
162201020;500;508;508;17;256;499;1;0;0;0;0;256;3;253
162201021;700;664;665;10;301;699;1;0;0;0;0;301;6;295
162201022;600;674;676;9;309;599;1;0;0;0;0;309;3;306
162201023;600;607;610;11;285;599;1;0;0;0;0;285;4;281
162201024;700;728;729;8;296;700;0;0;0;0;0;296;5;291
162201025;400;414;414;5;169;399;1;0;0;0;0;169;1;168
162201026;700;753;753;12;344;699;1;0;0;0;0;344;6;338
162201027;900;966;965;8;446;900;0;0;0;0;0;446;4;442
162201028;900;1030;1031;3;491;900;0;0;0;0;0;491;7;484
162201029;700;648;648;3;300;700;0;0;0;0;0;300;9;291
162201030;900;914;916;9;415;899;1;0;0;0;0;415;4;411
162201031;500;515;515;13;259;499;1;0;0;0;0;259;6;253
162201032;600;537;537;3;241;599;1;0;0;0;0;241;3;238
162201033;700;678;679;7;320;700;0;0;0;0;0;320;7;313
162201034;800;770;770;8;292;800;0;0;0;0;0;292;9;283
162201035;600;563;563;7;204;600;0;0;0;0;0;204;1;203
162201036;900;834;840;9;364;900;0;0;0;0;0;364;5;359
162201037;900;862;862;6;413;899;1;0;0;0;0;413;8;405
162201038;700;666;667;9;290;700;0;0;0;0;0;290;6;284
162201039;500;473;473;5;237;499;1;0;0;0;0;237;10;227
162201040;800;773;777;6;317;800;0;0;0;0;0;317;6;311
162201041;500;459;460;8;188;500;0;0;0;0;0;188;2;186
162201042;700;659;659;8;302;699;1;0;0;0;0;302;5;297
162201043;900;872;860;6;435;899;1;0;0;0;0;435;5;430
162201044;900;969;973;6;435;899;1;0;0;0;0;435;9;426
162201045;500;231;451;18;229;499;1;0;0;0;0;229;4;225
162201046;700;674;676;5;298;699;1;0;0;0;0;298;6;292
162201047;700;620;620;4;275;699;1;0;0;0;0;275;5;270
162201048;800;782;784;7;362;800;0;0;0;0;0;362;6;356
162201049;500;513;513;6;195;500;0;0;0;0;0;195;4;191
162201050;600;621;622;10;246;600;0;0;0;0;0;246;2;244
162201051;600;545;545;3;243;600;0;0;0;0;0;243;4;239
162201052;500;461;461;5;187;500;0;0;0;0;0;187;3;184
162201053;700;705;707;16;353;699;1;0;0;0;0;353;11;342
162201054;900;864;863;8;393;899;1;0;0;0;0;393;4;389
162201055;900;943;948;6;458;899;1;0;0;0;0;458;7;451
162201056;700;723;723;6;330;699;1;0;0;0;0;330;4;326
162201057;800;780;781;9;314;799;1;0;0;0;0;314;4;310
162201058;900;877;878;10;430;899;1;0;0;0;0;430;6;424
162201059;700;712;712;12;341;699;1;0;0;0;0;341;2;339
162201060;900;931;933;8;428;899;1;0;0;0;0;428;7;421
162201061;900;869;870;9;417;899;1;0;0;0;0;417;4;413
162201062;700;688;690;6;321;699;1;0;0;0;0;321;4;317
162201063;700;679;681;8;349;699;1;0;0;0;0;349;4;345
162201064;800;772;772;10;330;799;1;0;0;0;0;330;5;325
162201065;700;725;725;3;299;699;1;0;0;0;0;299;10;289
162201066;700;644;643;6;325;699;1;0;0;0;0;325;3;322
162201067;500;490;490;8;245;499;1;0;0;0;0;245;4;241
162201068;400;398;399;10;171;400;0;0;0;0;0;171;5;166
162201069;700;665;665;10;299;700;0;0;0;0;0;299;2;297
162201070;800;741;741;7;359;799;1;0;0;0;0;359;6;353
162201071;400;429;429;3;188;400;0;0;0;0;0;188;2;186
162201072;800;804;805;5;360;799;1;0;0;0;0;360;4;356
162201073;800;804;808;10;385;799;1;0;0;0;0;385;4;381
162201074;900;844;844;11;442;899;1;0;0;0;0;442;5;437
162201075;600;628;629;9;303;600;0;0;0;0;0;303;10;293
162201076;600;614;615;7;295;600;0;0;0;0;0;295;8;287
162201077;700;646;646;7;270;700;0;0;0;0;0;270;2;268
162201078;600;611;612;9;268;599;1;0;0;0;0;268;5;263
162201079;800;749;743;8;347;800;0;0;0;0;0;347;7;340
162201080;900;871;872;6;195;899;1;0;0;0;0;195;0;195
162201081;500;524;524;13;151;500;0;0;0;0;0;151;3;148
162201082;700;693;693;7;316;700;0;0;0;0;0;316;9;307
162201083;900;864;864;10;259;899;1;0;0;0;0;259;2;257
162201084;500;495;495;10;77;499;1;0;0;0;0;77;0;77
162201085;400;445;445;5;204;399;1;0;0;0;0;204;2;202
162201086;700;728;729;6;287;699;1;0;0;0;0;287;4;283
162201087;600;592;592;6;235;599;1;0;0;0;0;235;5;230
162201088;800;738;738;6;276;799;1;0;0;0;0;276;0;276
162201089;700;669;669;3;222;699;1;0;0;0;0;222;6;216
162201090;700;670;673;7;248;699;1;0;0;0;0;248;6;242
162201091;700;661;661;10;224;699;1;0;0;0;0;224;5;219
162201092;798;798;798;10;388;797;1;0;0;0;0;388;0;388
162201093;600;581;582;7;249;599;1;0;0;0;0;249;2;247
162201094;500;443;443;6;209;499;1;0;0;0;0;209;3;206
162201095;900;859;860;6;339;900;0;0;0;0;0;339;8;331
162201096;600;582;583;6;274;600;0;0;0;0;0;274;6;268
162201097;400;396;396;12;166;399;1;0;0;0;0;166;2;164
162201098;500;473;473;5;201;500;0;0;0;0;0;201;5;196
162201099;700;694;695;5;271;699;1;0;0;0;0;271;6;265
162201100;500;513;513;4;205;500;0;0;0;0;0;205;3;202
162201101;200;41;41;8;47;152;1;47;1;0;46;0;0;0
162201102;200;47;47;44;76;123;1;76;0;1;75;0;0;0
162201103;200;16;16;35;50;149;1;50;3;1;46;0;0;0
162201104;200;13;13;23;30;168;2;30;1;0;29;0;0;0
162202001;500;541;541;9;124;499;1;0;0;0;0;124;1;123
162202002;800;793;793;5;137;800;0;0;0;0;0;137;0;137
162202003;600;614;614;11;161;600;0;0;0;0;0;161;5;156
162202004;700;678;679;8;175;699;1;0;0;0;0;175;2;173
162202005;600;576;567;0;106;600;0;0;0;0;0;106;1;105
162202006;600;559;559;6;191;599;1;0;0;0;0;191;3;188
162202007;500;513;513;6;127;500;0;0;0;0;0;127;3;124
162202008;600;608;608;6;172;600;0;0;0;0;0;172;4;168
162202009;600;591;592;11;200;600;0;0;0;0;0;200;2;198
162202010;500;156;518;10;156;499;1;0;0;0;0;156;0;156
162202011;700;702;702;8;224;700;0;0;0;0;0;224;8;216
162202012;500;485;485;5;199;499;1;0;0;0;0;199;2;197
162202013;600;590;590;7;237;600;0;0;0;0;0;237;5;232
162202014;500;534;534;5;200;500;0;0;0;0;0;200;1;199
162202015;700;701;702;9;270;700;0;0;0;0;0;270;3;267
162202016;500;438;438;4;165;500;0;0;0;0;0;165;2;163
162202017;600;557;557;6;205;600;0;0;0;0;0;205;3;202
162202018;500;529;530;7;190;500;0;0;0;0;0;190;4;186
162202019;700;567;567;8;163;700;0;0;0;0;0;163;3;160
162202020;600;584;585;5;228;600;0;0;0;0;0;228;3;225
162202021;600;607;609;6;38;600;0;0;0;0;0;38;1;37
162202022;600;615;615;12;140;600;0;0;0;0;0;140;4;136
162202023;600;593;593;7;71;599;1;0;0;0;0;71;0;71
162202024;800;815;815;4;40;800;0;0;0;0;0;40;0;40
162202025;600;599;600;4;49;600;0;0;0;0;0;49;0;49
162202026;700;685;685;8;69;700;0;0;0;0;0;69;0;69
162202027;700;707;700;7;69;700;0;0;0;0;0;69;1;68
162202028;500;502;502;8;177;500;0;0;0;0;0;177;2;175
162202029;500;507;508;6;123;500;0;0;0;0;0;123;2;121
162202030;500;486;486;6;102;500;0;0;0;0;0;102;0;102
162202031;700;649;649;10;48;699;1;0;0;0;0;48;0;48
162202032;600;613;615;8;68;600;0;0;0;0;0;68;0;68
162202033;700;695;695;6;53;700;0;0;0;0;0;53;0;53
162202034;700;708;708;5;30;699;1;0;0;0;0;30;0;30
162202035;600;553;554;7;53;599;1;0;0;0;0;53;0;53
162202036;600;603;603;6;57;599;1;0;0;0;0;57;0;57
162202037;600;603;603;4;31;599;1;0;0;0;0;31;0;31
162202038;700;692;692;7;50;700;0;0;0;0;0;50;0;50
162202039;900;845;845;6;53;900;0;0;0;0;0;53;0;53
162202040;800;751;751;6;66;800;0;0;0;0;0;66;0;66
162202041;1000;80;860;2;82;1000;0;0;0;0;0;82;0;82
162202042;800;780;780;4;64;800;0;0;0;0;0;64;0;64
162202043;700;672;672;4;78;700;0;0;0;0;0;78;0;78
162202044;800;746;746;9;69;800;0;0;0;0;0;69;0;69
162202045;600;632;632;6;53;600;0;0;0;0;0;53;0;53
162202046;700;738;738;8;72;700;0;0;0;0;0;72;2;70
162202047;600;589;589;6;49;600;0;0;0;0;0;49;0;49
162202048;700;655;658;7;47;699;1;0;0;0;0;47;1;46
162202049;700;742;742;9;45;700;0;0;0;0;0;45;2;43
162202050;900;858;860;5;53;900;0;0;0;0;0;53;0;53
162202051;800;801;807;5;57;799;1;0;0;0;0;57;2;55
162202052;800;828;828;5;50;799;1;0;0;0;0;50;0;50
162202053;900;863;863;4;34;899;1;0;0;0;0;34;0;34
162202054;800;784;784;6;224;800;0;0;0;0;0;224;5;219
162202055;700;627;629;5;267;700;0;0;0;0;0;267;2;265
162202056;700;674;674;7;285;699;1;0;0;0;0;285;5;280
162202057;700;714;714;6;353;700;0;0;0;0;0;353;8;345
162202058;500;538;539;5;240;500;0;0;0;0;0;240;3;237
162202059;500;464;464;6;205;500;0;0;0;0;0;205;1;204
162202060;800;761;761;8;360;800;0;0;0;0;0;360;2;358
162202061;600;605;606;8;271;600;0;0;0;0;0;271;2;269
162202062;600;587;587;7;268;600;0;0;0;0;0;268;3;265
162202063;700;657;657;8;325;700;0;0;0;0;0;325;6;319
162202064;500;472;474;7;217;500;0;0;0;0;0;217;4;213
162202065;700;680;680;12;299;700;0;0;0;0;0;299;3;296
162202066;700;675;676;8;273;700;0;0;0;0;0;273;2;271
162202067;700;696;696;9;341;700;0;0;0;0;0;341;5;336
162202068;800;751;751;10;366;800;0;0;0;0;0;366;8;358
162202069;600;633;633;12;311;599;1;0;0;0;0;311;6;305
162202070;700;652;652;7;253;700;0;0;0;0;0;253;6;247
162203001;600;636;636;11;262;599;1;0;0;0;0;262;4;258
162203002;700;706;706;9;312;699;1;0;0;0;0;312;1;311
162203003;600;610;612;6;302;599;1;0;0;0;0;302;3;299
162203004;700;651;651;8;274;699;1;0;0;0;0;274;2;272
162203005;700;680;682;7;262;699;1;0;0;0;0;262;10;252
162203006;600;635;635;7;300;599;1;0;0;0;0;300;1;299
162203007;600;627;627;18;262;599;1;0;0;0;0;262;3;259
162203008;600;621;626;9;275;599;1;0;0;0;0;275;4;271
162203009;700;695;695;10;283;700;0;0;0;0;0;283;4;279
162203010;800;824;824;10;355;799;1;0;0;0;0;355;6;349
162203011;500;724;725;6;299;500;0;0;0;0;0;299;7;292
162203012;800;794;797;8;342;799;1;0;0;0;0;342;4;338
162203013;900;940;942;11;414;899;1;0;0;0;0;414;4;410
162203014;300;47;47;139;166;133;1;166;0;0;166;0;0;0
162203015;600;587;587;8;232;600;0;0;0;0;0;232;4;228
162203016;600;582;582;6;234;600;0;0;0;0;0;234;3;231
162203017;600;605;606;7;270;599;1;0;0;0;0;270;5;265
162203018;800;826;826;6;366;799;1;0;0;0;0;366;4;362
162203019;800;860;860;5;362;799;1;0;0;0;0;362;7;355
162203020;700;738;738;8;256;699;1;0;0;0;0;256;2;254
162203021;700;704;706;5;254;700;0;0;0;0;0;254;6;248
162203022;700;696;698;4;279;700;0;0;0;0;0;279;3;276
162203023;700;691;691;5;300;698;2;0;0;0;0;300;3;297
162203024;600;649;649;4;267;600;0;0;0;0;0;267;1;266
162203025;800;808;808;7;326;800;0;0;0;0;0;326;1;325
162203026;700;680;682;8;298;699;1;0;0;0;0;298;7;291
162203027;700;677;677;8;240;699;1;0;0;0;0;240;6;234
162203028;600;647;648;5;238;599;1;0;0;0;0;238;3;235
162203029;700;713;713;4;244;699;1;0;0;0;0;244;4;240
162203030;1000;1018;1019;7;374;999;1;0;0;0;0;374;4;370
162203031;700;743;743;6;329;699;1;0;0;0;0;329;5;324
162203032;600;594;594;6;271;599;1;0;0;0;0;271;8;263
162203033;600;622;623;9;296;599;1;0;0;0;0;296;4;292
162203034;700;721;722;6;327;699;1;0;0;0;0;327;5;322
162203035;600;591;591;4;229;600;0;0;0;0;0;229;4;225
162203036;500;664;664;6;286;500;0;0;0;0;0;286;5;281
162203037;600;620;622;5;288;600;0;0;0;0;0;288;5;283
162203038;700;724;724;12;347;699;1;0;0;0;0;347;11;336
162203039;800;774;775;7;379;799;1;0;0;0;0;379;5;374
162203040;700;663;663;8;253;699;1;0;0;0;0;253;8;245
162203041;1000;759;759;8;312;999;1;0;0;0;0;312;3;309
162203042;800;819;819;4;349;799;1;0;0;0;0;349;6;343
162203043;900;851;851;5;346;899;1;0;0;0;0;346;8;338
162203044;1000;950;952;5;373;999;1;0;0;0;0;373;11;362
162203045;912;912;912;3;381;912;0;0;0;0;0;381;12;369
162203046;600;579;580;3;196;599;1;0;0;0;0;196;4;192
162203047;300;279;280;6;115;185;0;115;6;1;108;0;0;0
162203048;300;45;45;107;115;184;1;115;2;1;112;0;0;0
162203049;300;300;300;60;73;223;4;73;4;3;66;0;0;0
162203050;200;26;26;37;45;154;1;45;1;0;44;0;0;0
162203051;200;19;19;74;79;116;5;79;16;1;62;0;0;0
162204001;700;494;494;7;237;699;1;0;0;0;0;237;3;234
162204002;700;560;561;10;286;699;1;0;0;0;0;286;4;282
162204003;600;493;493;5;204;599;1;0;0;0;0;204;2;202
162204004;700;536;536;5;238;699;1;0;0;0;0;238;5;233
162204005;600;616;616;1;254;599;1;0;0;0;0;254;5;249
162204006;700;550;551;5;160;699;1;0;0;0;0;160;2;158
162204007;600;609;606;3;244;599;1;0;0;0;0;244;5;239
162204008;600;518;520;4;203;599;1;0;0;0;0;203;2;201
162204009;700;624;624;5;274;699;1;0;0;0;0;274;1;273
162204010;600;535;539;5;216;599;1;0;0;0;0;216;5;211
162204011;700;671;671;6;284;699;1;0;0;0;0;284;7;277
162204012;700;648;651;5;305;699;1;0;0;0;0;305;3;302
162204013;500;484;485;13;231;498;2;0;0;0;0;231;0;231
162204014;700;649;649;7;123;699;1;0;0;0;0;123;3;120
162204015;800;775;775;5;156;799;1;0;0;0;0;156;4;152
162204016;800;744;750;4;102;799;1;0;0;0;0;102;0;102
162204017;600;600;603;8;243;599;1;0;0;0;0;243;1;242
162204018;700;545;545;6;241;700;0;0;0;0;0;241;3;238
162204019;700;730;730;4;317;700;0;0;0;0;0;317;4;313
162204020;700;698;698;6;310;699;1;0;0;0;0;310;3;307
162204021;700;644;644;5;287;700;0;0;0;0;0;287;6;281
162204022;700;602;602;9;251;699;1;0;0;0;0;251;5;246
162204023;800;803;804;1;395;799;1;0;0;0;0;395;5;390
162204024;700;653;654;4;295;699;1;0;0;0;0;295;4;291
162204025;700;689;689;6;268;699;1;0;0;0;0;268;6;262
162204026;700;697;697;5;328;699;1;0;0;0;0;328;6;322
162204027;600;484;485;6;188;599;1;0;0;0;0;188;2;186
162204028;600;502;503;11;217;599;1;0;0;0;0;217;2;215
162204029;800;592;593;8;261;799;1;0;0;0;0;261;2;259
162204030;800;641;642;5;277;799;1;0;0;0;0;277;7;270
162204031;800;531;533;6;215;799;1;0;0;0;0;215;3;212
162204032;700;597;597;6;235;699;1;0;0;0;0;235;5;230
162204033;900;772;775;5;130;900;0;0;0;0;0;130;0;130
162204034;700;535;537;6;236;699;1;0;0;0;0;236;4;232
162204035;900;798;800;5;355;899;1;0;0;0;0;355;6;349
162204036;600;464;464;4;167;599;1;0;0;0;0;167;5;162
162204037;800;753;753;3;347;799;1;0;0;0;0;347;5;342
162204038;700;715;717;9;304;699;1;0;0;0;0;304;3;301
162204039;700;666;666;4;339;699;1;0;0;0;0;339;2;337
162204040;700;672;672;4;284;699;1;0;0;0;0;284;5;279
162204041;600;585;585;10;275;599;1;0;0;0;0;275;2;273
162204042;500;537;537;3;244;499;1;0;0;0;0;244;3;241
162204043;600;492;494;6;219;599;1;0;0;0;0;219;1;218
162204044;600;698;698;10;308;599;1;0;0;0;0;308;6;302
162204045;600;691;692;4;21;599;1;0;0;0;0;21;0;21
162204046;600;704;704;6;258;599;1;0;0;0;0;258;5;253
162204047;500;574;574;20;205;500;0;0;0;0;0;205;2;203
162204048;500;556;558;4;222;499;1;0;0;0;0;222;0;222
162204049;500;555;555;4;200;500;0;0;0;0;0;200;1;199
162204050;561;561;561;7;217;561;0;0;0;0;0;217;5;212
162204051;600;623;623;7;238;600;0;0;0;0;0;238;3;235
162204052;600;671;671;6;294;600;0;0;0;0;0;294;5;289
162204053;600;625;625;11;277;600;0;0;0;0;0;277;6;271
162204054;400;370;371;16;181;399;1;0;0;0;0;181;4;177
162204055;400;396;396;7;159;400;0;0;0;0;0;159;4;155
162204056;400;382;382;3;152;399;1;0;0;0;0;152;2;150
162204057;500;460;460;4;219;499;1;0;0;0;0;219;2;217
162204058;700;747;747;7;312;699;1;0;0;0;0;312;7;305
162204059;400;414;414;4;171;399;1;0;0;0;0;171;2;169
162204060;500;653;655;9;259;500;0;0;0;0;0;259;3;256
162204061;400;528;528;5;234;399;1;0;0;0;0;234;3;231
162204062;500;639;640;7;261;499;1;0;0;0;0;261;4;257
162204063;500;690;690;7;316;499;1;0;0;0;0;316;4;312
162204064;500;276;688;3;276;500;0;0;0;0;0;276;2;274
162204065;400;581;581;3;217;400;0;0;0;0;0;217;3;214
162204066;400;473;473;22;209;399;1;0;0;0;0;209;3;206
162204067;400;580;580;7;260;399;1;0;0;0;0;260;2;258
162204068;400;573;575;5;304;399;1;0;0;0;0;304;11;293
162204069;400;493;494;10;76;399;1;0;0;0;0;76;1;75
162204070;400;424;424;7;189;400;0;0;0;0;0;189;3;186
162204071;400;611;612;7;306;399;1;0;0;0;0;306;7;299
162204072;400;521;521;6;27;399;1;0;0;0;0;27;1;26
162204073;500;793;793;7;386;499;1;0;0;0;0;386;7;379
162204074;100;40;40;6;40;60;0;40;0;4;36;0;0;0
162204075;300;17;17;31;41;258;1;41;0;0;41;0;0;0
162205001;600;571;571;9;231;599;1;0;0;0;0;231;6;225
162205002;700;686;686;8;268;699;1;0;0;0;0;268;7;261
162205003;600;600;605;6;247;600;0;0;0;0;0;247;3;244
162205004;600;628;629;7;274;599;1;0;0;0;0;274;5;269
162205005;700;726;726;10;333;700;0;0;0;0;0;333;7;326
162205006;700;668;670;12;282;699;1;0;0;0;0;282;3;279
162205007;600;595;595;9;288;600;0;0;0;0;0;288;5;283
162205008;700;675;676;5;319;699;1;0;0;0;0;319;2;317
162205009;600;650;651;7;276;599;1;0;0;0;0;276;5;271
162205010;600;658;659;7;289;600;0;0;0;0;0;289;5;284
162205011;600;640;640;3;231;599;1;0;0;0;0;231;6;225
162205012;661;661;661;8;261;661;0;0;0;0;0;261;5;256
162205013;600;561;561;6;236;600;0;0;0;0;0;236;3;233
162205014;600;626;630;6;273;600;0;0;0;0;0;273;6;267
162205015;600;611;612;5;245;599;1;0;0;0;0;245;1;244
162205016;700;609;610;8;284;699;1;0;0;0;0;284;7;277
162205017;700;700;699;6;323;699;1;0;0;0;0;323;5;318
162205018;600;640;640;6;274;599;1;0;0;0;0;274;5;269
162205019;600;632;633;7;276;599;1;0;0;0;0;276;6;270
162205020;700;650;651;5;298;699;1;0;0;0;0;298;4;294
162205021;800;774;773;6;330;799;1;0;0;0;0;330;11;319
162205022;600;628;628;13;259;599;1;0;0;0;0;259;11;248
162205023;600;616;616;10;304;599;1;0;0;0;0;304;11;293
162205024;600;616;616;1;293;599;1;0;0;0;0;293;7;286
162205025;500;671;670;7;290;499;1;0;0;0;0;290;6;284
162205026;700;676;676;5;261;699;1;0;0;0;0;261;2;259
162205027;600;591;592;5;244;599;1;0;0;0;0;244;1;243
162205028;800;759;760;6;343;799;1;0;0;0;0;343;6;337
162205029;700;673;675;7;285;699;1;0;0;0;0;285;6;279
162205030;600;640;640;8;246;600;0;0;0;0;0;246;4;242
162205031;600;600;655;7;291;600;0;0;0;0;0;291;6;285
162205032;700;680;680;9;262;699;1;0;0;0;0;262;3;259
162205033;700;681;681;4;293;699;1;0;0;0;0;293;3;290
162205034;700;696;697;7;269;699;1;0;0;0;0;269;5;264
162205035;700;680;681;9;287;699;1;0;0;0;0;287;2;285
162205036;700;695;695;8;271;699;1;0;0;0;0;271;10;261
162205037;700;727;727;6;328;699;1;0;0;0;0;328;6;322
162205038;900;828;828;10;324;900;0;0;0;0;0;324;5;319
162205039;800;777;777;7;353;800;0;0;0;0;0;353;10;343
162205040;900;419;879;4;419;900;0;0;0;0;0;419;9;410
162205041;900;922;922;8;399;900;0;0;0;0;0;399;3;396
162205042;700;666;667;19;304;699;1;0;0;0;0;304;4;300
162205043;700;678;677;4;262;700;0;0;0;0;0;262;2;260
162205044;700;664;667;5;290;699;1;0;0;0;0;290;7;283
162205045;700;673;674;5;291;699;1;0;0;0;0;291;6;285
162205046;700;729;729;7;326;699;1;0;0;0;0;326;6;320
162205047;700;689;689;6;300;699;1;0;0;0;0;300;12;288
162205048;600;217;647;6;223;599;1;0;0;0;0;223;2;221
162205049;600;645;645;7;216;599;1;0;0;0;0;216;7;209
162205050;600;634;635;8;244;600;0;0;0;0;0;244;3;241
162205051;700;723;724;6;310;699;1;0;0;0;0;310;5;305
162205052;700;677;677;8;247;700;0;0;0;0;0;247;9;238
162205053;700;710;710;31;351;699;1;0;0;0;0;351;2;349
162205054;800;781;781;18;353;799;1;0;0;0;0;353;4;349
162205055;700;732;733;9;291;699;1;0;0;0;0;291;4;287
162205056;700;720;721;4;274;699;1;0;0;0;0;274;4;270
162205057;1100;1163;1163;14;536;1099;1;0;0;0;0;536;12;524
162205058;700;700;701;10;264;699;1;0;0;0;0;264;7;257
162205059;700;749;749;4;330;700;0;0;0;0;0;330;3;327
162205060;800;776;777;7;325;799;1;0;0;0;0;325;6;319
162205061;700;756;757;9;342;699;1;0;0;0;0;342;4;338
162205062;700;736;739;9;302;699;1;0;0;0;0;302;6;296
162205063;800;774;775;5;350;799;1;0;0;0;0;350;7;343
162205064;800;817;817;8;332;799;1;0;0;0;0;332;6;326
162205065;800;778;779;6;250;799;1;0;0;0;0;250;6;244
162205066;800;814;814;8;291;800;0;0;0;0;0;291;5;286
162205067;800;766;766;10;292;799;1;0;0;0;0;292;7;285
162205068;900;926;926;8;416;899;1;0;0;0;0;416;4;412
162205069;800;825;825;7;319;799;1;0;0;0;0;319;4;315
162205070;800;832;832;9;307;800;0;0;0;0;0;307;4;303
162205071;700;677;678;13;291;700;0;0;0;0;0;291;5;286
162205072;700;730;730;5;307;699;1;0;0;0;0;307;5;302
162205073;700;747;748;6;332;699;1;0;0;0;0;332;4;328
162205074;700;697;698;7;260;699;1;0;0;0;0;260;3;257
162205075;700;717;711;9;314;700;0;0;0;0;0;314;5;309
162205076;700;741;740;5;336;699;1;0;0;0;0;336;7;329
162205077;700;702;702;9;290;409;1;290;0;5;285;0;0;0
162205078;700;710;709;5;255;699;1;0;0;0;0;255;4;251
162205079;700;704;704;9;273;700;0;0;0;0;0;273;7;266
162205080;800;733;734;5;285;799;1;0;0;0;0;285;8;277
162205081;700;719;719;6;268;699;1;0;0;0;0;268;2;266
162205082;800;747;747;6;243;800;0;0;0;0;0;243;4;239
162205083;700;743;745;6;284;699;1;0;0;0;0;284;6;278
162205084;900;900;902;5;383;900;0;0;0;0;0;383;9;374
162205085;800;787;788;8;334;799;1;0;0;0;0;334;11;323
162205086;800;559;559;35;284;799;1;0;0;0;0;284;2;282
162205087;800;578;579;25;280;799;1;0;0;0;0;280;6;274
162205088;600;637;637;3;274;599;1;0;0;0;0;274;4;270
162205089;700;652;652;4;255;699;1;0;0;0;0;255;2;253
162205090;660;661;661;3;251;659;1;0;0;0;0;251;1;250
162205091;700;664;665;3;274;699;1;0;0;0;0;274;2;272
162205092;700;681;681;5;287;699;1;0;0;0;0;287;5;282
162205093;600;643;643;5;280;600;0;0;0;0;0;280;8;272
162205094;600;596;596;2;231;599;1;0;0;0;0;231;6;225
162205095;600;635;635;7;238;600;0;0;0;0;0;238;2;236
162205096;200;31;31;5;31;169;0;31;0;0;31;0;0;0
162205097;300;11;11;46;57;242;1;57;1;4;52;0;0;0
162205098;500;64;64;30;89;410;1;89;9;2;78;0;0;0
162205099;500;79;79;23;94;405;1;94;11;2;81;0;0;0
162206001;700;638;639;6;251;699;1;0;0;0;0;251;8;243
162206002;700;633;633;7;271;699;1;0;0;0;0;271;10;261
162206003;500;479;483;16;226;499;1;0;0;0;0;226;1;225
162206004;700;647;648;5;252;699;1;0;0;0;0;252;2;250
162206005;600;591;591;5;258;599;1;0;0;0;0;258;4;254
162206006;600;596;598;6;224;599;1;0;0;0;0;224;4;220
162206007;700;738;736;5;273;699;1;0;0;0;0;273;10;263
162206008;700;660;659;0;240;699;1;0;0;0;0;240;7;233
162206009;700;652;653;4;293;699;1;0;0;0;0;293;3;290
162206010;600;582;583;7;212;599;1;0;0;0;0;212;5;207
162206011;700;642;645;4;298;699;1;0;0;0;0;298;7;291
162206012;700;666;666;7;228;699;1;0;0;0;0;228;3;225
162206013;700;674;676;3;278;699;1;0;0;0;0;278;7;271
162206014;700;692;693;8;297;699;1;0;0;0;0;297;9;288
162206015;700;701;703;5;290;699;1;0;0;0;0;290;3;287
162206016;800;770;770;2;280;799;1;0;0;0;0;280;4;276
162206017;600;624;625;5;233;599;1;0;0;0;0;233;6;227
162206018;700;663;663;3;221;699;1;0;0;0;0;221;5;216
162206019;600;601;601;4;228;599;1;0;0;0;0;228;4;224
162206020;700;249;626;8;257;699;1;0;0;0;0;257;4;253
162206021;700;682;681;3;308;699;1;0;0;0;0;308;4;304
162206022;600;621;621;8;229;599;1;0;0;0;0;229;3;226
162206023;800;743;744;7;313;799;1;0;0;0;0;313;9;304
162206024;700;718;719;6;290;699;1;0;0;0;0;290;4;286
162206025;600;610;611;5;222;600;0;0;0;0;0;222;7;215
162206026;700;685;685;7;338;699;1;0;0;0;0;338;3;335
162206027;600;586;586;15;283;599;1;0;0;0;0;283;3;280
162206028;700;695;695;4;311;699;1;0;0;0;0;311;4;307
162206029;700;692;691;10;282;699;1;0;0;0;0;282;9;273
162206030;600;202;615;9;211;599;1;0;0;0;0;211;1;210
162206031;600;601;601;4;211;599;1;0;0;0;0;211;2;209
162206032;600;605;605;4;229;599;1;0;0;0;0;229;7;222
162206033;700;288;669;4;288;699;1;0;0;0;0;288;10;278
162206034;700;703;704;6;303;699;1;0;0;0;0;303;5;298
162206035;700;647;646;7;251;699;1;0;0;0;0;251;11;240
162206036;700;714;714;6;290;699;1;0;0;0;0;290;7;283
162206037;600;579;580;7;234;599;1;0;0;0;0;234;3;231
162206038;700;706;706;6;256;700;0;0;0;0;0;256;7;249
162206039;600;608;610;3;253;599;1;0;0;0;0;253;3;250
162206040;500;448;448;34;204;499;1;0;0;0;0;204;3;201
162206041;600;609;609;7;222;599;1;0;0;0;0;222;3;219
162206042;500;448;448;4;180;499;1;0;0;0;0;180;4;176
162206043;508;508;509;4;224;507;1;0;0;0;0;224;4;220
162206044;600;625;625;7;281;599;1;0;0;0;0;281;6;275
162206045;700;700;700;4;303;700;0;0;0;0;0;303;6;297
162206046;600;622;622;5;328;600;0;0;0;0;0;328;6;322
162206047;700;722;723;3;327;699;1;0;0;0;0;327;8;319
162206048;700;725;725;5;379;699;1;0;0;0;0;379;2;377
162206049;700;655;656;4;278;700;0;0;0;0;0;278;4;274
162206050;600;583;585;7;260;599;1;0;0;0;0;260;7;253
162206051;600;628;628;3;260;599;1;0;0;0;0;260;5;255
162206052;600;631;631;0;223;600;0;0;0;0;0;223;5;218
162206053;800;799;799;5;303;800;0;0;0;0;0;303;5;298
162206054;700;730;730;5;326;699;1;0;0;0;0;326;4;322
162206055;600;615;615;9;332;599;1;0;0;0;0;332;9;323
162206056;700;663;663;0;270;699;1;0;0;0;0;270;5;265
162206057;700;738;741;4;320;699;1;0;0;0;0;320;9;311
162206058;700;695;700;6;265;700;0;0;0;0;0;265;6;259
162206059;700;719;719;8;314;699;1;0;0;0;0;314;3;311
162206060;700;657;659;6;251;699;1;0;0;0;0;251;3;248
162206061;800;728;732;8;331;799;1;0;0;0;0;331;4;327
162206062;700;704;705;8;370;699;1;0;0;0;0;370;3;367
162206063;800;767;767;8;356;800;0;0;0;0;0;356;9;347
162206064;800;785;785;6;386;799;1;0;0;0;0;386;6;380
162206065;800;774;774;7;324;800;0;0;0;0;0;324;8;316
162206066;800;764;764;9;302;800;0;0;0;0;0;302;6;296
162206067;800;793;793;6;311;800;0;0;0;0;0;311;6;305
162206068;600;578;579;24;278;600;0;0;0;0;0;278;3;275
162206069;800;769;769;4;350;800;0;0;0;0;0;350;5;345
162206070;900;858;858;3;374;899;1;0;0;0;0;374;5;369
162206071;800;797;800;6;328;799;1;0;0;0;0;328;10;318
162206072;700;666;666;13;284;699;1;0;0;0;0;284;7;277
162206073;103;70;70;11;28;72;3;28;3;0;25;0;0;0
162206074;100;10;10;13;18;81;1;18;3;0;15;0;0;0
170100001;500;801;802;4;308;499;1;0;0;0;0;308;3;305
170100002;400;699;700;4;285;399;1;0;0;0;0;285;1;284
170100003;500;817;817;5;303;499;1;0;0;0;0;303;2;301
170100004;500;810;810;4;318;499;1;0;0;0;0;318;4;314
170100005;500;787;787;4;299;499;1;0;0;0;0;299;4;295
170100006;400;606;606;9;302;399;1;0;0;0;0;302;4;298
170100007;500;864;867;8;397;499;1;0;0;0;0;397;10;387
170100008;500;826;826;5;379;499;1;0;0;0;0;379;8;371
170100009;400;683;685;9;343;399;1;0;0;0;0;343;3;340
170100010;400;597;597;7;294;399;1;0;0;0;0;294;4;290
170100011;500;794;795;4;399;499;1;0;0;0;0;399;5;394
170100012;400;714;716;5;331;399;1;0;0;0;0;331;5;326
170100013;300;457;457;5;196;299;1;0;0;0;0;196;0;196
170100014;300;494;494;3;221;299;1;0;0;0;0;221;5;216
170100015;400;638;638;7;305;399;1;0;0;0;0;305;4;301
170100016;500;748;751;7;348;499;1;0;0;0;0;348;6;342
170100017;300;447;448;4;253;299;1;0;0;0;0;253;2;251
170100018;300;487;487;7;251;299;1;0;0;0;0;251;7;244
170100019;300;546;546;9;232;299;1;0;0;0;0;232;2;230
170100020;400;702;702;2;332;399;1;0;0;0;0;332;2;330
170100021;500;830;830;5;393;499;1;0;0;0;0;393;9;384
170100022;500;865;865;8;414;499;1;0;0;0;0;414;2;412
170100023;300;518;519;6;253;299;1;0;0;0;0;253;5;248
170100024;500;741;741;7;337;499;1;0;0;0;0;337;1;336
170100025;200;363;364;6;165;199;1;0;0;0;0;165;2;163
170100026;400;643;644;6;304;399;1;0;0;0;0;304;4;300
170100027;300;545;545;7;254;299;1;0;0;0;0;254;1;253
170100028;200;392;390;2;198;199;1;0;0;0;0;198;1;197
170100029;400;693;694;6;258;399;1;0;0;0;0;258;2;256
170100030;200;399;401;4;179;199;1;0;0;0;0;179;2;177
170100031;400;722;722;6;244;399;1;0;0;0;0;244;1;243
170100032;400;613;613;4;259;399;1;0;0;0;0;259;2;257
170100033;400;679;680;8;274;399;1;0;0;0;0;274;5;269
170100034;500;779;779;5;283;499;1;0;0;0;0;283;6;277
170100035;300;543;545;1;271;299;1;0;0;0;0;271;3;268
170100036;300;499;502;3;169;299;1;0;0;0;0;169;1;168
170100037;400;606;606;7;256;399;1;0;0;0;0;256;0;256
170100038;500;853;853;0;295;499;1;0;0;0;0;295;4;291
170100039;500;756;759;7;295;499;1;0;0;0;0;295;0;295
170100040;500;620;610;10;202;499;1;0;0;0;0;202;3;199
170100041;300;212;487;11;223;299;1;0;0;0;0;223;2;221
170100042;400;679;680;3;273;399;1;0;0;0;0;273;1;272
170100043;400;699;702;7;329;399;1;0;0;0;0;329;2;327
170100044;400;699;699;3;269;399;1;0;0;0;0;269;2;267
170100045;300;498;498;4;192;299;1;0;0;0;0;192;2;190
170100046;500;812;815;6;299;499;1;0;0;0;0;299;1;298
170100047;500;822;825;5;294;499;1;0;0;0;0;294;2;292
170100048;400;648;648;5;203;399;1;0;0;0;0;203;3;200
170100049;400;692;692;7;269;399;1;0;0;0;0;269;3;266
170100050;400;679;679;3;220;399;1;0;0;0;0;220;2;218
170100051;200;347;347;1;130;199;1;0;0;0;0;130;1;129
170100052;400;724;724;6;219;399;1;0;0;0;0;219;2;217
170100053;400;655;656;5;223;399;1;0;0;0;0;223;2;221
170100054;500;752;752;4;179;499;1;0;0;0;0;179;1;178
170100055;300;460;460;13;136;299;1;0;0;0;0;136;2;134
170100056;400;700;701;5;126;399;1;0;0;0;0;126;2;124
170100057;500;792;793;0;175;499;1;0;0;0;0;175;6;169
170100058;500;839;839;3;150;499;1;0;0;0;0;150;0;150
170100059;500;891;891;6;183;499;1;0;0;0;0;183;0;183
170100060;300;473;479;5;187;299;1;0;0;0;0;187;1;186
170100061;400;592;592;4;164;399;1;0;0;0;0;164;0;164
170100062;300;539;540;3;174;299;1;0;0;0;0;174;3;171
170100063;400;692;692;7;220;399;1;0;0;0;0;220;2;218
170100064;300;547;548;2;187;299;1;0;0;0;0;187;0;187
170100065;500;814;814;5;234;281;3;216;7;6;203;18;0;18
170100066;500;843;848;11;320;499;1;0;0;0;0;320;6;314
170100067;300;265;265;7;169;130;1;169;3;0;166;0;0;0
170100068;400;437;437;3;125;399;1;0;0;0;0;125;1;124
170100069;100;12;12;5;11;88;1;11;0;1;10;0;0;0
170100070;100;20;20;6;9;90;1;9;0;0;9;0;0;0
170100071;100;64;66;5;52;47;1;52;2;0;50;0;0;0
170100072;200;231;231;4;138;61;1;138;5;2;131;0;0;0
170100073;100;18;18;8;22;77;1;22;1;0;21;0;0;0
170100074;300;371;376;3;145;299;1;0;0;0;0;145;1;144
170100075;600;668;668;2;260;599;1;0;0;0;0;260;4;256
170100076;500;163;496;3;166;500;0;0;0;0;0;166;0;166
170100077;500;521;521;3;184;499;1;0;0;0;0;184;1;183
170100078;100;25;25;6;30;67;3;30;2;1;27;0;0;0
170100079;700;741;741;5;305;699;1;0;0;0;0;305;3;302
170100080;100;37;37;6;26;73;1;26;2;0;24;0;0;0
170100081;300;305;305;4;181;118;1;181;3;2;176;0;0;0
170100082;300;296;296;3;144;299;1;0;0;0;0;144;0;144
170100083;200;215;215;7;115;83;2;115;2;0;113;0;0;0
170100084;300;138;286;8;146;149;5;146;3;4;139;0;0;0
170100085;200;152;152;5;92;106;2;92;3;0;89;0;0;0
170100086;200;110;110;3;61;137;2;61;1;0;60;0;0;0
170100087;100;26;26;5;25;72;3;25;2;0;23;0;0;0
170100088;200;282;283;3;178;21;1;178;4;3;171;0;0;0
170100089;600;617;610;7;255;599;1;0;0;0;0;255;0;255
170100090;800;757;757;4;60;799;1;0;0;0;0;60;0;60
170100091;800;622;623;2;261;800;0;0;0;0;0;261;2;259
170100092;600;591;592;2;210;600;0;0;0;0;0;210;2;208
170100093;600;712;712;3;239;599;1;0;0;0;0;239;1;238
170100094;100;24;24;5;19;80;1;19;0;0;19;0;0;0
170100095;100;22;22;5;26;74;0;26;1;0;25;0;0;0
170100096;500;563;565;4;296;499;1;0;0;0;0;296;5;291
170100097;100;24;24;4;22;77;1;22;0;0;22;0;0;0
170100098;500;830;833;7;241;499;1;0;0;0;0;241;6;235
170100099;300;316;317;5;189;110;1;189;3;2;184;0;0;0
170100100;600;596;596;4;193;599;1;0;0;0;0;193;3;190
170100101;400;699;699;4;101;399;1;0;0;0;0;101;0;101
170100102;500;781;782;4;251;499;1;0;0;0;0;251;1;250
170100103;300;326;326;1;116;299;1;0;0;0;0;116;0;116
170100104;400;695;695;6;106;399;1;0;0;0;0;106;0;106
170100105;500;881;881;2;310;499;1;0;0;0;0;310;2;308
170100106;100;20;20;0;20;78;2;20;1;0;19;0;0;0
170100107;100;15;15;37;40;59;1;40;3;0;37;0;0;0
170100108;100;14;14;11;25;74;1;25;0;1;24;0;0;0
170700001;400;440;441;4;221;399;1;0;0;0;0;221;2;219
170700002;300;345;345;5;182;299;1;0;0;0;0;182;1;181
170700003;600;616;618;0;170;599;1;0;0;0;0;170;1;169
170700004;300;321;321;3;117;299;1;0;0;0;0;117;2;115
170700005;300;341;344;6;108;299;1;0;0;0;0;108;1;107
170700006;200;215;215;2;109;90;1;109;1;1;107;0;0;0
170700007;300;286;286;5;144;155;1;144;5;1;138;0;0;0
170700008;100;69;69;4;53;46;1;53;2;0;51;0;0;0
170700009;200;183;183;3;115;84;1;115;6;1;108;0;0;0
170700010;100;50;51;4;40;58;2;40;1;0;39;0;0;0
170700011;150;150;150;2;115;34;1;115;6;1;108;0;0;0
170700012;150;111;111;5;83;66;1;83;8;0;75;0;0;0
170700013;300;265;265;3;99;200;1;99;11;5;83;0;0;0
170700014;200;204;204;1;97;102;1;97;5;1;91;0;0;0
170700015;500;564;564;4;143;499;1;0;0;0;0;143;1;142
170700016;100;118;118;4;65;34;1;65;5;0;60;0;0;0
170700017;300;361;363;1;158;299;1;0;0;0;0;158;2;156
170700018;500;475;476;5;143;499;1;0;0;0;0;143;1;142
170700019;100;81;81;3;57;42;1;57;3;2;52;0;0;0
171200001;800;857;858;2;307;799;1;0;0;0;0;307;4;303
171200002;600;672;674;2;320;599;1;0;0;0;0;320;6;314
171200003;600;589;590;2;258;599;1;0;0;0;0;258;1;257
171200004;400;446;446;1;219;399;1;0;0;0;0;219;2;217
171200005;600;681;682;2;260;599;1;0;0;0;0;260;3;257
171200006;600;604;605;2;251;599;1;0;0;0;0;251;7;244
171200007;1000;942;942;5;230;999;1;0;0;0;0;230;0;230
171200008;700;656;657;0;218;699;1;0;0;0;0;218;7;211
171200009;600;618;618;3;163;599;1;0;0;0;0;163;5;158
171200010;500;527;527;0;191;499;1;0;0;0;0;191;3;188
171200011;200;170;170;1;100;99;1;100;3;1;96;0;0;0
171200012;200;184;184;3;103;96;1;103;7;0;96;0;0;0
171200013;400;344;344;2;188;211;1;188;8;1;179;0;0;0
171200014;600;600;600;0;135;599;1;0;0;0;0;135;0;135
171200015;100;111;111;3;65;33;2;65;5;1;59;0;0;0
171200016;100;120;121;0;64;34;2;64;1;1;62;0;0;0
171200017;300;335;337;3;96;299;1;0;0;0;0;96;0;96
171200018;200;153;154;2;92;107;1;92;9;0;83;0;0;0
171200019;300;263;263;0;131;168;1;131;2;1;128;0;0;0
171200020;400;399;400;2;161;399;1;0;0;0;0;161;2;159
171300001;600;631;631;7;282;599;1;0;0;0;0;282;4;278
171300002;600;631;631;6;315;599;1;0;0;0;0;315;5;310
171300003;600;648;650;0;226;599;1;0;0;0;0;226;4;222
171300004;600;578;578;3;273;600;0;0;0;0;0;273;4;269
171300005;600;673;673;6;213;598;2;0;0;0;0;213;1;212
171300006;600;645;655;8;135;599;1;0;0;0;0;135;1;134
171300007;600;589;589;7;216;599;1;0;0;0;0;216;4;212
171300008;700;746;749;8;319;699;1;0;0;0;0;319;1;318
171300009;700;765;767;7;316;699;1;0;0;0;0;316;3;313
171300010;700;726;726;7;264;699;1;0;0;0;0;264;8;256
171300011;600;597;597;6;240;599;1;0;0;0;0;240;5;235
171300012;700;748;751;3;308;699;1;0;0;0;0;308;6;302
171300013;700;683;685;11;305;699;1;0;0;0;0;305;3;302
171300014;700;685;685;5;271;699;1;0;0;0;0;271;8;263
171300015;600;651;652;3;127;599;1;0;0;0;0;127;2;125
171300016;600;567;567;5;136;599;1;0;0;0;0;136;4;132
171300017;700;683;685;9;253;699;1;0;0;0;0;253;2;251
171300018;700;691;691;4;254;699;1;0;0;0;0;254;3;251
171300019;600;662;665;2;232;599;1;0;0;0;0;232;6;226
171300020;700;696;696;7;263;699;1;0;0;0;0;263;5;258
171300021;700;766;769;9;351;699;1;0;0;0;0;351;10;341
171300022;600;603;606;7;262;599;1;0;0;0;0;262;4;258
171300023;700;698;700;1;306;699;1;0;0;0;0;306;7;299
171300024;600;630;630;8;261;599;1;0;0;0;0;261;1;260
171300025;700;663;666;4;305;699;1;0;0;0;0;305;2;303
171300026;700;691;691;11;303;699;1;0;0;0;0;303;7;296
171300027;700;703;704;7;249;699;1;0;0;0;0;249;3;246
171300028;700;752;752;5;250;699;1;0;0;0;0;250;3;247
171300029;600;591;591;6;257;599;1;0;0;0;0;257;1;256
171300030;700;676;676;4;266;699;1;0;0;0;0;266;7;259
171300031;700;742;742;3;351;699;1;0;0;0;0;351;7;344
171300032;500;496;496;1;172;499;1;0;0;0;0;172;3;169
171300033;100;21;21;8;14;85;1;14;1;0;13;0;0;0
171300034;400;392;392;3;222;399;1;0;0;0;0;222;3;219
171300035;500;450;541;0;251;499;1;0;0;0;0;251;1;250
171300036;600;599;599;4;256;599;1;0;0;0;0;256;5;251
171300037;700;682;683;3;294;699;1;0;0;0;0;294;5;289
171300038;700;729;734;2;240;700;0;0;0;0;0;240;2;238
171300039;800;841;841;0;224;800;0;0;0;0;0;224;3;221
171300040;400;427;427;5;200;399;1;0;0;0;0;200;0;200
171300041;200;169;169;3;117;82;1;117;2;2;113;0;0;0
171300042;300;326;331;3;179;119;2;179;7;1;171;0;0;0
171300043;400;411;412;2;161;399;1;0;0;0;0;161;2;159
171300044;300;311;312;4;195;104;1;195;9;7;179;0;0;0
171300045;100;89;89;6;64;35;1;64;1;0;63;0;0;0
171300046;500;550;550;2;261;500;0;0;0;0;0;261;7;254
171300047;600;638;643;3;334;599;1;0;0;0;0;334;1;333
171300048;600;599;599;7;211;599;1;0;0;0;0;211;2;209
171300049;600;636;636;5;269;599;1;0;0;0;0;269;7;262
171300050;600;643;644;2;252;599;1;0;0;0;0;252;2;250
171300051;600;604;611;1;216;599;1;0;0;0;0;216;7;209
171300052;200;191;191;2;111;88;1;111;2;1;108;0;0;0
171300053;700;782;782;4;310;699;1;0;0;0;0;310;3;307
171300054;600;625;625;5;261;599;1;0;0;0;0;261;6;255
171300055;500;481;483;3;192;499;1;0;0;0;0;192;2;190
171300056;500;487;487;2;226;499;1;0;0;0;0;226;2;224
171300057;500;481;482;1;238;499;1;0;0;0;0;238;2;236
171300058;400;459;460;5;192;400;0;0;0;0;0;192;1;191
171300059;400;445;445;5;202;399;1;0;0;0;0;202;4;198
171300060;600;606;606;2;215;599;1;0;0;0;0;215;9;206
171300061;600;681;681;3;244;600;0;0;0;0;0;244;1;243
171300062;400;412;412;5;190;400;0;0;0;0;0;190;1;189
171300063;300;326;326;6;102;300;0;0;0;0;0;102;0;102
171300064;700;714;714;5;265;699;1;0;0;0;0;265;3;262
171300065;600;620;620;6;212;454;1;145;2;0;143;67;2;65
171300066;700;740;740;1;287;699;1;0;0;0;0;287;1;286
171300067;600;166;609;3;166;599;1;0;0;0;0;166;2;164
171300068;600;597;597;6;160;599;1;0;0;0;0;160;2;158
171300069;700;699;699;1;230;700;0;0;0;0;0;230;1;229
171300070;600;662;662;4;205;599;1;0;0;0;0;205;1;204
171300071;600;688;688;1;207;600;0;0;0;0;0;207;1;206
171300072;800;812;812;2;267;800;0;0;0;0;0;267;1;266
171300073;600;690;690;3;199;599;1;0;0;0;0;199;1;198
171300074;500;481;483;1;197;499;1;0;0;0;0;197;1;196
171300075;500;486;486;4;178;499;1;0;0;0;0;178;0;178
171300076;100;11;11;17;20;79;1;20;1;0;19;0;0;0
171300077;200;112;112;20;96;103;1;96;2;0;94;0;0;0
171300078;100;37;37;1;36;63;1;36;0;0;36;0;0;0
171500001;700;673;673;6;246;700;0;0;0;0;0;246;4;242
171500002;400;440;440;2;146;399;1;0;0;0;0;146;5;141
171500003;600;627;627;7;228;599;1;0;0;0;0;228;2;226
171500004;40;39;39;8;32;6;2;32;3;0;29;0;0;0
171500005;60;56;56;8;46;12;2;46;1;0;45;0;0;0
171500006;200;181;182;3;79;120;1;79;3;0;76;0;0;0
171500007;20;16;16;6;10;9;1;10;0;0;10;0;0;0
171500008;80;76;76;6;60;19;1;60;1;1;58;0;0;0
171500009;200;149;150;4;82;117;1;82;3;1;78;0;0;0
171500010;50;36;36;7;21;26;3;21;1;0;20;0;0;0
171500011;50;27;27;7;14;35;1;14;1;0;13;0;0;0
171700001;700;647;648;5;274;699;1;0;0;0;0;274;5;269
171700002;500;492;492;4;213;499;1;0;0;0;0;213;6;207
171700003;700;743;744;3;355;699;1;0;0;0;0;355;7;348
171700004;500;495;495;4;187;499;1;0;0;0;0;187;4;183
171700005;600;592;593;3;239;599;1;0;0;0;0;239;3;236
171700006;800;818;820;4;388;799;1;0;0;0;0;388;4;384
171700007;600;618;618;5;366;599;1;0;0;0;0;366;5;361
171700008;700;700;700;8;305;699;1;0;0;0;0;305;10;295
171700009;700;692;692;2;188;699;1;0;0;0;0;188;3;185
171700010;700;741;741;3;284;699;1;0;0;0;0;284;8;276
171700011;900;926;927;3;433;899;1;0;0;0;0;433;10;423
171700012;800;756;756;1;346;799;1;0;0;0;0;346;10;336
171700013;800;841;842;2;240;799;1;0;0;0;0;240;1;239
171700014;600;580;580;3;209;599;1;0;0;0;0;209;4;205
171700015;800;800;778;5;305;798;2;0;0;0;0;305;4;301
171700016;600;634;634;2;290;599;1;0;0;0;0;290;1;289
171700017;800;787;787;2;287;799;1;0;0;0;0;287;7;280
171700018;900;945;945;1;390;899;1;0;0;0;0;390;4;386
171700019;800;752;752;8;303;799;1;0;0;0;0;303;5;298
171700020;600;618;618;1;156;599;1;0;0;0;0;156;2;154
171700021;600;633;634;8;296;599;1;0;0;0;0;296;3;293
171700022;400;420;420;4;146;399;1;0;0;0;0;146;1;145
171700023;500;439;440;0;60;499;1;0;0;0;0;60;0;60
171700024;300;326;326;1;172;299;1;0;0;0;0;172;1;171
171700025;500;503;503;2;199;500;0;0;0;0;0;199;3;196
171700026;600;648;648;3;88;599;1;0;0;0;0;88;0;88
171700027;700;735;735;2;270;699;1;0;0;0;0;270;3;267
171700028;600;549;550;7;112;599;1;0;0;0;0;112;2;110
171700029;700;694;694;3;273;699;1;0;0;0;0;273;1;272
171700030;600;595;595;0;221;599;1;0;0;0;0;221;2;219
171700031;500;511;511;3;197;499;1;0;0;0;0;197;4;193
171700032;700;690;690;5;234;699;1;0;0;0;0;234;1;233
171700033;700;680;680;3;39;699;1;0;0;0;0;39;0;39
171700034;700;680;680;1;247;699;1;0;0;0;0;247;5;242
171700035;600;575;575;4;68;599;1;0;0;0;0;68;3;65
171700036;600;585;585;5;184;599;1;0;0;0;0;184;3;181
171700037;500;529;529;3;192;499;1;0;0;0;0;192;1;191
171700038;600;654;654;6;208;599;1;0;0;0;0;208;2;206
171700039;500;566;566;2;259;499;1;0;0;0;0;259;2;257
171700040;500;536;536;1;210;499;1;0;0;0;0;210;1;209
172300001;600;679;680;3;191;599;1;0;0;0;0;191;1;190
172300002;600;603;603;8;165;599;1;0;0;0;0;165;1;164
172300003;600;614;614;1;233;599;1;0;0;0;0;233;3;230
172300004;700;696;697;2;293;700;0;0;0;0;0;293;4;289
172300005;800;798;799;2;328;799;1;0;0;0;0;328;3;325
172300006;1000;968;968;8;213;999;1;0;0;0;0;213;3;210
172300007;600;679;682;0;296;599;1;0;0;0;0;296;4;292
172300008;700;708;711;2;319;699;1;0;0;0;0;319;9;310
172300009;500;563;565;3;243;499;1;0;0;0;0;243;5;238
172300010;500;474;476;2;266;499;1;0;0;0;0;266;3;263
172300011;600;616;619;0;259;599;1;0;0;0;0;259;7;252
172300012;600;634;634;3;277;599;1;0;0;0;0;277;1;276
172300013;500;537;538;9;281;499;1;0;0;0;0;281;5;276
172300014;1000;923;924;8;102;999;1;0;0;0;0;102;1;101
172300015;600;586;586;2;112;599;1;0;0;0;0;112;1;111
172300016;700;700;700;3;241;699;1;0;0;0;0;241;3;238
172300017;800;805;805;0;196;799;1;0;0;0;0;196;0;196
172300018;800;844;844;6;261;799;1;0;0;0;0;261;0;261
172300019;700;701;701;0;137;699;1;0;0;0;0;137;4;133
172300020;500;562;562;3;208;499;1;0;0;0;0;208;4;204
172300021;500;548;548;0;229;499;1;0;0;0;0;229;4;225
172300022;600;675;675;5;240;599;1;0;0;0;0;240;3;237
172300023;100;51;51;7;37;62;1;37;0;0;37;0;0;0
172300024;400;407;409;1;82;399;1;0;0;0;0;82;0;82
172300025;400;493;494;3;137;399;1;0;0;0;0;137;0;137
172300026;500;609;610;4;249;499;1;0;0;0;0;249;1;248
172300027;400;445;445;2;166;399;1;0;0;0;0;166;1;165
172300028;500;570;571;6;234;499;1;0;0;0;0;234;2;232
172300029;600;617;617;1;289;599;1;0;0;0;0;289;0;289
172300030;200;269;269;3;161;38;1;161;4;0;157;0;0;0
172300031;400;388;388;2;166;400;0;0;0;0;0;166;0;166
172300032;300;379;378;3;155;300;0;0;0;0;0;155;1;154
172300033;400;454;454;3;176;399;1;0;0;0;0;176;1;175
172300034;600;628;628;6;177;599;1;0;0;0;0;177;0;177
172300035;500;504;504;4;133;499;1;0;0;0;0;133;1;132
172300036;500;499;499;3;206;499;1;0;0;0;0;206;1;205
172300037;100;120;120;5;67;29;4;67;3;0;64;0;0;0
172300038;400;413;415;2;170;399;1;0;0;0;0;170;2;168
172300039;1000;972;972;5;151;999;1;0;0;0;0;151;2;149
172300040;100;18;18;0;18;82;0;18;1;0;17;0;0;0
172500001;800;791;792;1;266;799;1;0;0;0;0;266;4;262
172500002;800;785;786;4;247;799;1;0;0;0;0;247;1;246
172500003;600;555;555;0;164;599;1;0;0;0;0;164;2;162
172500004;500;465;465;0;145;499;1;0;0;0;0;145;2;143
172500005;1000;988;988;2;313;999;1;0;0;0;0;313;3;310
172500006;750;750;750;2;232;749;1;0;0;0;0;232;1;231
172500007;800;792;792;1;251;799;1;0;0;0;0;251;3;248
172500008;500;475;477;0;175;499;1;0;0;0;0;175;2;173
172500009;600;589;589;5;208;599;1;0;0;0;0;208;4;204
172500010;800;748;748;5;260;799;1;0;0;0;0;260;3;257
172500011;700;648;652;3;215;699;1;0;0;0;0;215;2;213
172500012;800;761;764;3;203;799;1;0;0;0;0;203;1;202
172500013;800;782;782;3;247;799;1;0;0;0;0;247;8;239
172500014;500;551;551;4;157;499;1;0;0;0;0;157;1;156
172500015;600;594;595;2;33;599;1;0;0;0;0;33;0;33
172500016;1000;933;937;3;230;999;1;0;0;0;0;230;0;230
172500017;700;669;670;0;227;699;1;0;0;0;0;227;5;222
172500018;600;634;634;0;18;598;2;0;0;0;0;18;1;17
172500019;600;634;635;4;208;599;1;0;0;0;0;208;3;205
172500020;500;576;578;1;214;499;1;0;0;0;0;214;4;210
172500021;700;707;709;5;267;699;1;0;0;0;0;267;1;266
172500022;300;349;349;1;119;299;1;0;0;0;0;119;2;117
172500023;600;629;630;2;163;599;1;0;0;0;0;163;0;163
172500024;600;652;652;2;212;599;1;0;0;0;0;212;0;212
172500025;600;656;656;4;214;599;1;0;0;0;0;214;3;211
172500026;800;817;817;4;172;799;1;0;0;0;0;172;1;171
172500027;900;921;921;4;206;899;1;0;0;0;0;206;2;204
172500028;700;690;690;3;116;699;1;0;0;0;0;116;1;115
172500029;200;267;267;3;128;70;2;128;5;1;122;0;0;0
172500030;400;447;447;0;170;399;1;0;0;0;0;170;4;166
172500031;1000;998;998;6;154;999;1;0;0;0;0;154;0;154
172500032;700;725;725;0;229;698;2;0;0;0;0;229;5;224
172500033;800;789;790;9;295;799;1;0;0;0;0;295;6;289
172500034;100;23;23;4;8;91;1;8;2;0;6;0;0;0
172600001;500;536;536;7;283;499;1;0;0;0;0;283;7;276
172600002;600;576;576;9;292;599;1;0;0;0;0;292;6;286
172600003;600;577;577;5;314;599;1;0;0;0;0;314;5;309
172600004;200;114;114;7;91;108;1;91;1;3;87;0;0;0
172600005;800;803;803;0;263;799;1;0;0;0;0;263;6;257
172600006;400;466;466;1;170;399;1;0;0;0;0;170;5;165
172600007;600;662;662;1;211;599;1;0;0;0;0;211;3;208
172600008;800;741;741;1;272;799;1;0;0;0;0;272;6;266
172600009;500;516;516;3;212;499;1;0;0;0;0;212;2;210
172600010;500;553;553;3;211;499;1;0;0;0;0;211;6;205
172600011;600;606;606;1;221;599;1;0;0;0;0;221;3;218
172600012;500;485;485;0;198;499;1;0;0;0;0;198;6;192
172600013;700;661;661;2;245;699;1;0;0;0;0;245;3;242
172600014;600;561;561;1;225;599;1;0;0;0;0;225;8;217
172600015;600;652;652;4;307;599;1;0;0;0;0;307;1;306
172600016;400;379;379;1;164;398;2;0;0;0;0;164;1;163
172600017;100;56;56;4;38;61;1;38;0;0;38;0;0;0
172600018;500;520;520;3;222;499;1;0;0;0;0;222;5;217
172600019;600;571;571;3;240;599;1;0;0;0;0;240;5;235
172600020;100;67;67;3;44;55;1;44;1;1;42;0;0;0
172600021;500;459;459;1;169;500;0;0;0;0;0;169;3;166
172600022;400;448;448;2;162;400;0;0;0;0;0;162;3;159
172600023;600;636;636;6;231;599;1;0;0;0;0;231;5;226
172600024;700;663;664;0;308;699;1;0;0;0;0;308;3;305
172600025;700;713;713;1;302;699;1;0;0;0;0;302;6;296
172600026;500;515;515;5;214;499;1;0;0;0;0;214;4;210
172600027;100;23;23;5;21;78;1;21;0;0;21;0;0;0
172600028;500;535;535;3;235;498;2;0;0;0;0;235;4;231
172600029;600;582;582;5;255;599;1;0;0;0;0;255;5;250
172600030;500;493;493;1;210;499;1;0;0;0;0;210;2;208
172600031;700;710;710;2;368;699;1;0;0;0;0;368;8;360
172600032;400;311;312;1;140;258;2;140;2;1;137;0;0;0
172600033;700;747;747;0;310;699;1;0;0;0;0;310;2;308
172600034;500;522;522;0;253;499;1;0;0;0;0;253;3;250
172600035;600;632;632;4;256;599;1;0;0;0;0;256;4;252
172600036;700;663;663;1;122;699;1;0;0;0;0;122;0;122
172600037;500;498;498;6;211;499;1;0;0;0;0;211;4;207
172600038;100;24;24;4;15;84;1;15;0;0;15;0;0;0
172600039;100;57;57;5;44;55;1;44;7;0;37;0;0;0
172600040;600;625;625;3;192;599;1;0;0;0;0;192;4;188
172600041;400;381;381;0;75;399;1;0;0;0;0;75;2;73
172600042;700;732;732;0;239;699;1;0;0;0;0;239;2;237
172600043;600;573;573;5;269;599;1;0;0;0;0;269;4;265
172600044;400;376;376;0;105;399;1;0;0;0;0;105;0;105
172600045;400;419;419;0;137;399;1;0;0;0;0;137;1;136
172600046;400;377;377;12;128;399;1;0;0;0;0;128;0;128
172600047;600;153;600;0;153;600;0;0;0;0;0;153;1;152
172600048;400;439;439;1;149;399;1;0;0;0;0;149;1;148
172600049;500;575;575;0;182;499;1;0;0;0;0;182;1;181
172600050;400;450;451;0;163;399;1;0;0;0;0;163;2;161
172600051;500;567;567;3;208;499;1;0;0;0;0;208;2;206
172600052;500;537;537;3;226;499;1;0;0;0;0;226;3;223
172600053;500;562;562;7;82;499;1;0;0;0;0;82;0;82
172600054;600;579;579;2;147;599;1;0;0;0;0;147;0;147
172600055;500;520;520;4;201;499;1;0;0;0;0;201;3;198
172600056;500;517;517;4;86;499;1;0;0;0;0;86;0;86
172800001;700;702;704;4;258;699;1;0;0;0;0;258;0;258
172800002;700;681;683;2;248;699;1;0;0;0;0;248;4;244
172800003;700;692;692;3;193;699;1;0;0;0;0;193;3;190
172800004;800;756;756;3;231;799;1;0;0;0;0;231;5;226
172800005;700;705;705;9;162;699;1;0;0;0;0;162;2;160
172800006;600;627;630;5;185;599;1;0;0;0;0;185;1;184
172800007;600;594;594;3;226;599;1;0;0;0;0;226;5;221
172800008;500;500;546;5;172;499;1;0;0;0;0;172;2;170
172800009;200;192;192;3;108;91;1;108;13;0;95;0;0;0
172800010;300;362;362;4;144;299;1;0;0;0;0;144;1;143
172800011;400;468;468;4;107;399;1;0;0;0;0;107;0;107
172800012;600;607;617;4;224;599;1;0;0;0;0;224;3;221
172800013;800;813;815;4;231;799;1;0;0;0;0;231;1;230
172800014;800;791;791;5;179;799;1;0;0;0;0;179;0;179
172800015;400;413;415;0;132;400;0;0;0;0;0;132;2;130
172800016;400;429;431;4;167;399;1;0;0;0;0;167;3;164
172800017;800;810;810;4;193;799;1;0;0;0;0;193;3;190
172800018;600;600;600;3;186;599;1;0;0;0;0;186;1;185
172800019;700;710;713;0;289;699;1;0;0;0;0;289;5;284
172800020;600;616;616;1;253;599;1;0;0;0;0;253;8;245
172800021;100;28;28;0;26;72;2;26;2;0;24;0;0;0
173300001;730;728;728;0;268;729;1;0;0;0;0;268;2;266
173300002;590;590;593;2;230;589;1;0;0;0;0;230;2;228
173300003;530;536;536;0;229;529;1;0;0;0;0;229;2;227
173300004;420;421;421;0;180;419;1;0;0;0;0;180;2;178
173300005;430;437;437;3;209;429;1;0;0;0;0;209;4;205
173300006;580;580;581;0;290;579;1;0;0;0;0;290;3;287
173300007;900;898;898;0;169;899;1;0;0;0;0;169;0;169
173300008;450;452;452;0;226;449;1;0;0;0;0;226;1;225
173300009;70;75;75;1;36;33;1;36;2;1;33;0;0;0
173300010;300;308;308;7;131;168;1;131;7;0;124;0;0;0
173300011;530;546;546;4;173;529;1;0;0;0;0;173;1;172
173300012;300;317;317;3;124;300;0;0;0;0;0;124;0;124
173300013;340;340;342;3;119;340;0;0;0;0;0;119;0;119
173300014;250;256;256;0;140;108;2;140;5;2;133;0;0;0
173300015;370;377;379;2;133;369;1;0;0;0;0;133;0;133
173300016;270;273;274;3;94;175;1;94;1;1;92;0;0;0
173300017;428;428;428;1;103;427;1;0;0;0;0;103;0;103
173300018;220;222;222;4;138;81;1;138;3;0;135;0;0;0
173300019;300;199;199;3;97;202;1;97;6;1;90;0;0;0
173700001;700;778;778;4;338;699;1;0;0;0;0;338;4;334
173700002;900;867;868;9;371;899;1;0;0;0;0;371;7;364
173700003;800;841;842;7;377;799;1;0;0;0;0;377;6;371
173700004;650;693;693;5;322;649;1;0;0;0;0;322;2;320
173700005;700;690;690;0;291;699;1;0;0;0;0;291;4;287
173700006;500;503;504;9;183;499;1;0;0;0;0;183;2;181
173700007;800;750;742;8;286;799;1;0;0;0;0;286;5;281
173700008;800;854;855;4;339;799;1;0;0;0;0;339;2;337
173700009;400;478;478;6;174;400;0;0;0;0;0;174;1;173
173700010;100;131;131;5;63;35;2;63;0;1;62;0;0;0
173700011;250;293;293;3;110;139;1;110;4;0;106;0;0;0
173700012;300;377;377;3;180;300;0;0;0;0;0;180;1;179
173700013;150;88;172;4;92;56;2;92;2;0;90;0;0;0
173700014;650;739;740;7;281;650;0;0;0;0;0;281;2;279
173700015;100;76;78;4;50;49;1;50;2;1;47;0;0;0
173700016;800;840;850;2;285;799;1;0;0;0;0;285;2;283
173700017;50;21;21;3;23;26;1;23;5;0;18;0;0;0
173700018;500;573;574;5;170;500;0;0;0;0;0;170;0;170
173700019;300;279;279;2;139;160;1;139;9;4;126;0;0;0
173700020;200;226;226;2;108;91;1;108;7;2;99;0;0;0
173700021;100;103;103;3;42;57;1;42;4;0;38;0;0;0
173700022;250;111;111;101;198;51;1;198;0;1;197;0;0;0
173700023;200;68;68;29;93;105;2;93;4;1;88;0;0;0
173700024;200;20;20;26;45;154;1;45;2;0;43;0;0;0
173900001;800;582;584;2;249;799;1;0;0;0;0;249;7;242
173900002;1000;680;683;1;206;999;1;0;0;0;0;206;2;204
173900003;1000;790;790;0;304;999;1;0;0;0;0;304;5;299
173900004;800;932;932;0;79;799;1;0;0;0;0;79;0;79
173900005;600;789;789;0;257;599;1;0;0;0;0;257;4;253
173900006;500;585;585;0;226;499;1;0;0;0;0;226;5;221
173900007;500;531;531;0;175;499;1;0;0;0;0;175;2;173
173900008;600;599;599;0;188;599;1;0;0;0;0;188;1;187
173900009;800;896;897;7;291;799;1;0;0;0;0;291;1;290
173900010;600;708;708;0;81;599;1;0;0;0;0;81;0;81
174000001;500;435;435;3;220;499;1;0;0;0;0;220;1;219
174000002;600;626;626;0;295;599;1;0;0;0;0;295;1;294
174000003;600;603;603;1;212;599;1;0;0;0;0;212;3;209
174000004;700;713;713;3;256;699;1;0;0;0;0;256;5;251
174000005;800;759;759;0;296;799;1;0;0;0;0;296;10;286
174000006;1000;978;978;0;115;999;1;0;0;0;0;115;0;115
174100001;800;764;765;0;345;799;1;0;0;0;0;345;5;340
174100002;1000;978;978;2;288;999;1;0;0;0;0;288;5;283
174100003;1000;961;962;0;304;999;1;0;0;0;0;304;4;300
174100004;800;674;675;1;300;558;1;241;5;2;234;59;2;57
174100005;700;708;710;0;290;699;1;0;0;0;0;290;2;288
174100006;700;700;700;4;265;699;1;0;0;0;0;265;3;262
174100007;700;649;649;1;285;699;1;0;0;0;0;285;1;284
174100008;800;765;765;5;356;799;1;0;0;0;0;356;1;355
174100009;700;664;664;3;295;699;1;0;0;0;0;295;5;290
174100010;500;506;507;3;162;499;1;0;0;0;0;162;3;159
174100011;600;621;621;2;264;599;1;0;0;0;0;264;5;259
174100012;600;598;598;5;262;598;2;0;0;0;0;262;5;257
174100013;600;621;621;0;290;599;1;0;0;0;0;290;3;287
174100014;700;697;698;2;250;699;1;0;0;0;0;250;4;246
174100015;700;678;678;1;186;699;1;0;0;0;0;186;0;186
174100016;600;577;577;0;198;599;1;0;0;0;0;198;3;195
174100017;800;794;796;0;284;800;0;0;0;0;0;284;5;279
174100018;500;530;530;0;154;499;1;0;0;0;0;154;1;153
174100019;800;795;795;1;160;798;2;0;0;0;0;160;0;160
174100020;600;608;608;1;214;599;1;0;0;0;0;214;0;214
174100021;700;704;704;3;213;699;1;0;0;0;0;213;2;211
174100022;600;562;562;2;268;599;1;0;0;0;0;268;5;263
174100023;500;520;521;6;233;499;1;0;0;0;0;233;0;233
174100024;900;968;968;0;147;899;1;0;0;0;0;147;0;147
174100025;500;536;536;5;171;499;1;0;0;0;0;171;2;169
174100026;500;536;536;3;67;499;1;0;0;0;0;67;1;66
174200001;705;705;707;3;257;704;1;0;0;0;0;257;3;254
174200002;555;558;559;2;193;554;1;0;0;0;0;193;10;183
174200003;825;836;837;0;334;824;1;0;0;0;0;334;8;326
174200004;850;850;855;8;294;849;1;0;0;0;0;294;2;292
174200005;753;759;762;3;261;752;1;0;0;0;0;261;3;258
174200006;530;541;544;1;193;529;1;0;0;0;0;193;0;193
174200007;680;686;687;3;274;679;1;0;0;0;0;274;1;273
174200008;800;807;807;2;259;799;1;0;0;0;0;259;1;258
174200009;200;199;199;4;140;59;1;140;2;1;137;0;0;0
174200010;60;60;60;5;36;23;1;36;1;2;33;0;0;0
174200011;120;117;117;4;87;32;1;87;1;0;86;0;0;0
174200012;74;74;74;0;48;25;1;48;0;1;47;0;0;0
174200013;35;34;34;5;27;7;1;27;3;0;24;0;0;0
174200014;18;13;13;0;12;5;1;12;0;0;12;0;0;0
174300001;700;697;697;0;284;699;1;0;0;0;0;284;14;270
174300002;800;760;760;2;352;799;1;0;0;0;0;352;5;347
174300003;900;861;861;4;360;899;1;0;0;0;0;360;3;357
174300004;900;861;861;0;374;899;1;0;0;0;0;374;4;370
174300005;800;830;830;1;335;799;1;0;0;0;0;335;2;333
174300006;600;594;594;1;274;599;1;0;0;0;0;274;3;271
174300007;800;779;779;1;325;799;1;0;0;0;0;325;4;321
174300008;900;873;866;3;315;899;1;0;0;0;0;315;7;308
174300009;800;801;802;6;322;799;1;0;0;0;0;322;3;319
174300010;900;840;840;1;360;899;1;0;0;0;0;360;2;358
174300011;500;457;457;1;170;499;1;0;0;0;0;170;1;169
174300012;500;500;500;0;191;499;1;0;0;0;0;191;2;189
181100001;900;888;918;4;280;840;1;59;2;1;56;221;2;219
181100002;900;896;896;5;309;899;1;0;0;0;0;309;0;309
181100003;900;860;914;5;266;899;1;0;0;0;0;266;0;266
181100004;1000;1142;1142;7;467;999;1;0;0;0;0;467;3;464
181100005;700;722;722;0;226;700;0;0;0;0;0;226;5;221
181100006;800;822;834;5;252;799;1;0;0;0;0;252;1;251
181100007;800;720;757;5;244;799;1;0;0;0;0;244;5;239
181100008;800;745;745;4;249;800;0;0;0;0;0;249;1;248
181100009;400;421;421;6;173;399;1;0;0;0;0;173;0;173
181100010;800;825;846;8;226;799;1;0;0;0;0;226;0;226
181100011;700;680;715;9;205;699;1;0;0;0;0;205;4;201
181100012;800;744;768;8;221;799;1;0;0;0;0;221;1;220
181100013;900;906;925;8;359;900;0;0;0;0;0;359;3;356
181100014;500;552;552;7;267;499;1;0;0;0;0;267;8;259
181100015;100;57;57;1;58;41;1;58;0;1;57;0;0;0
181100016;200;116;116;0;115;83;2;115;0;1;114;0;0;0
181100017;200;80;80;4;81;118;1;81;2;0;79;0;0;0
181100018;100;57;57;2;57;43;0;57;0;1;56;0;0;0
181400001;700;677;677;6;252;699;1;0;0;0;0;252;4;248
181400002;400;362;363;7;184;399;1;0;0;0;0;184;1;183
181400003;1000;1092;1097;6;269;1000;0;0;0;0;0;269;4;265
181400004;700;717;717;8;261;699;1;0;0;0;0;261;0;261
181400005;1000;958;958;8;283;1000;0;0;0;0;0;283;2;281
181400006;500;548;550;9;202;499;1;0;0;0;0;202;1;201
181400007;1000;1081;1081;5;392;999;1;0;0;0;0;392;7;385
181400008;1000;1063;1063;6;329;999;1;0;0;0;0;329;7;322
181400009;800;835;835;6;312;799;1;0;0;0;0;312;8;304
181400010;900;965;967;7;351;899;1;0;0;0;0;351;5;346
181400011;900;924;935;9;323;898;2;0;0;0;0;323;4;319
181400012;1000;1037;1040;11;307;999;1;0;0;0;0;307;3;304
181400013;1000;1037;1037;11;390;1000;0;0;0;0;0;390;6;384
181400014;600;645;647;5;249;599;1;0;0;0;0;249;4;245
181400015;750;720;724;8;231;749;1;0;0;0;0;232;1;231
181400016;700;743;760;11;292;699;1;0;0;0;0;292;3;289
181400017;1000;980;1012;6;374;999;1;0;0;0;0;374;3;371
181400018;600;595;626;9;208;599;1;0;0;0;0;208;5;203
181400019;800;777;812;6;262;799;1;0;0;0;0;262;3;259
181400020;900;881;917;10;340;899;1;0;0;0;0;340;0;340
181400021;150;49;50;6;41;108;1;41;0;1;40;0;0;0
181400022;350;321;328;6;145;349;1;0;0;0;0;145;0;145
181400023;1000;1051;1081;6;382;999;1;0;0;0;0;382;5;377
181400024;650;614;636;4;245;650;0;0;0;0;0;245;4;241
181400025;700;721;772;14;301;699;1;0;0;0;0;301;2;299
181400026;350;334;335;7;163;349;1;0;0;0;0;163;3;160
181400027;350;294;293;6;138;209;3;138;5;1;132;0;0;0
181400028;1000;910;959;5;337;999;1;0;0;0;0;337;2;335
181400029;900;943;943;9;360;899;1;0;0;0;0;360;2;358
181400030;350;354;365;7;143;349;1;0;0;0;0;143;0;143
181400031;350;376;376;7;132;349;1;0;0;0;0;132;1;131
181400032;900;876;876;4;232;899;1;0;0;0;0;232;6;226
181400033;500;487;518;12;194;499;1;0;0;0;0;194;0;194
181400034;450;429;429;7;183;449;1;0;0;0;0;183;0;183
181400035;1000;1055;1114;9;397;1000;0;0;0;0;0;397;0;397
181400036;350;322;322;6;147;350;0;0;0;0;0;147;1;146
181400037;200;43;43;7;50;150;0;50;1;0;49;0;0;0
181400038;200;83;83;6;88;110;2;88;3;0;85;0;0;0
181400039;100;72;72;6;75;25;0;75;2;0;73;0;0;0
181400040;100;78;78;6;84;15;1;84;7;0;77;0;0;0
181400041;100;33;33;7;40;58;2;40;0;0;40;0;0;0
181400042;100;31;31;1;32;64;4;32;4;0;28;0;0;0
181400043;100;70;70;5;68;31;1;68;1;0;67;0;0;0
181400044;100;31;31;6;37;62;1;37;1;0;36;0;0;0
181400045;100;17;17;3;20;79;1;20;2;0;18;0;0;0
181400046;100;30;30;4;34;66;0;34;2;0;32;0;0;0
181400047;200;17;17;20;25;172;3;25;0;0;25;0;0;0
181600001;800;817;854;7;345;799;1;0;0;0;0;345;5;340
181600002;800;800;824;5;195;800;0;0;0;0;0;195;2;193
181600003;800;791;832;11;263;799;1;0;0;0;0;263;2;261
181600004;700;638;682;15;212;699;1;0;0;0;0;212;2;210
181600005;300;352;372;2;154;299;1;0;0;0;0;154;0;154
181600006;300;347;360;4;162;299;1;0;0;0;0;162;0;162
181600007;400;468;470;4;224;399;1;0;0;0;0;224;4;220
181600008;600;553;587;1;225;599;1;0;0;0;0;225;2;223
181600009;200;243;243;2;99;100;1;99;5;3;91;0;0;0
181600010;700;751;761;5;229;699;1;0;0;0;0;229;5;224
181600011;900;913;931;5;286;899;1;0;0;0;0;286;9;277
181600012;900;919;949;1;232;899;1;0;0;0;0;232;1;231
181600013;900;939;953;5;274;899;1;0;0;0;0;274;8;266
181600014;800;848;861;2;266;799;1;0;0;0;0;266;1;265
181600015;700;728;738;8;231;699;1;0;0;0;0;231;2;229
181600016;800;793;799;4;289;799;1;0;0;0;0;289;6;283
181600017;700;747;755;2;265;699;1;0;0;0;0;265;2;263
181600018;900;942;975;6;250;899;1;0;0;0;0;250;3;247
181600019;300;357;357;4;157;299;1;0;0;0;0;157;0;157
181600020;900;814;906;8;386;899;1;0;0;0;0;386;0;386
181600021;600;607;608;8;184;599;1;0;0;0;0;184;2;182
181600022;500;519;521;8;134;499;1;0;0;0;0;134;0;134
181600023;1000;1060;1087;7;276;1000;0;0;0;0;0;276;0;276
181600024;800;737;784;9;252;799;1;0;0;0;0;252;5;247
181600025;700;700;719;2;293;699;1;0;0;0;0;293;0;293
181600026;200;138;158;4;99;100;1;99;6;1;92;0;0;0
181600027;300;342;342;9;178;299;1;0;0;0;0;178;2;176
181600028;300;341;344;4;146;299;1;0;0;0;0;146;1;145
181600029;100;23;23;3;20;79;1;20;0;0;20;0;0;0
181600030;100;33;33;8;37;62;1;37;1;0;36;0;0;0
181600031;100;60;60;2;61;37;2;61;2;1;58;0;0;0
181600032;100;83;83;3;85;14;1;85;8;1;76;0;0;0
181600033;100;19;19;2;21;77;2;21;1;0;20;0;0;0
181600034;100;13;13;2;15;84;1;15;0;0;15;0;0;0
181600035;100;32;32;0;29;71;0;29;0;0;29;0;0;0
181600036;100;94;94;5;95;4;1;95;4;0;91;0;0;0
181600037;100;92;92;0;85;14;1;85;2;0;83;0;0;0
181600038;100;64;64;6;70;29;1;70;23;0;47;0;0;0
181600039;100;19;19;0;19;80;1;19;2;0;17;0;0;0
181600040;100;17;17;1;17;82;1;17;0;1;16;0;0;0
181700001;1000;929;995;6;358;999;1;0;0;0;0;358;1;357
181700002;1000;1406;1447;8;485;999;1;0;0;0;0;485;4;481
181700003;400;357;357;4;149;399;1;0;0;0;0;149;1;148
181700004;400;424;429;8;215;399;1;0;0;0;0;215;1;214
181700005;500;488;488;6;223;499;1;0;0;0;0;223;3;220
181700006;200;211;211;6;81;117;2;81;4;1;76;0;0;0
181700007;800;859;875;7;322;799;1;0;0;0;0;322;3;319
181700008;600;584;584;7;266;599;1;0;0;0;0;266;1;265
181700009;700;676;684;3;292;699;1;0;0;0;0;292;2;290
181700010;700;691;716;5;305;699;1;0;0;0;0;305;0;305
181700011;200;224;224;4;122;77;1;122;0;0;122;0;0;0
181700012;300;256;256;6;112;187;1;112;3;0;109;0;0;0
181700013;500;458;461;5;253;499;1;0;0;0;0;253;3;250
181700014;900;948;975;8;395;899;1;0;0;0;0;395;4;391
181700015;400;356;362;4;169;399;1;0;0;0;0;169;1;168
181700016;700;657;657;3;225;699;1;0;0;0;0;225;0;225
181700017;200;154;155;6;103;96;1;103;13;0;90;0;0;0
181700018;400;409;413;5;174;399;1;0;0;0;0;174;1;173
181700019;50;16;16;5;21;28;1;21;0;0;21;0;0;0
181700020;50;12;12;6;18;31;1;18;0;0;18;0;0;0
181700021;50;28;28;6;33;16;1;33;2;0;31;0;0;0
181700022;150;65;65;6;70;80;0;70;7;0;63;0;0;0
181700023;100;41;41;0;41;58;1;41;5;0;36;0;0;0
181700024;100;28;28;0;27;73;0;27;0;0;27;0;0;0
181700025;100;23;23;6;29;70;1;29;0;0;29;0;0;0
182600001;200;145;146;7;85;114;1;85;0;2;83;0;0;0
182600002;500;451;453;4;205;499;1;0;0;0;0;205;0;205
182600003;500;766;769;8;276;499;1;0;0;0;0;276;6;270
182600004;500;737;740;3;267;499;1;0;0;0;0;267;1;266
182600005;500;612;612;10;233;499;1;0;0;0;0;233;2;231
182600006;500;1064;1065;9;150;499;1;0;0;0;0;150;0;150
182600007;500;976;976;6;238;499;1;0;0;0;0;238;0;238
182600008;500;1034;1034;5;203;499;1;0;0;0;0;203;2;201
182600009;500;829;829;4;259;500;0;0;0;0;0;259;1;258
182600010;500;562;565;8;126;499;1;0;0;0;0;126;1;125
182600011;500;1397;1397;7;308;499;1;0;0;0;0;308;2;306
182600012;300;260;260;9;106;192;2;106;2;0;104;0;0;0
182600013;500;692;692;5;228;499;1;0;0;0;0;228;4;224
182600014;100;95;95;7;74;25;1;74;1;0;73;0;0;0
182600015;200;108;179;6;108;91;1;108;4;1;103;0;0;0
182600016;300;266;268;6;116;183;1;116;6;1;109;0;0;0
182600017;200;115;115;3;53;146;1;53;2;0;51;0;0;0
182600018;500;416;416;7;118;499;1;0;0;0;0;118;0;118
182600019;500;994;1004;9;216;499;1;0;0;0;0;216;3;213
182600020;500;882;884;9;197;499;1;0;0;0;0;197;1;196
182600021;500;949;952;9;206;499;1;0;0;0;0;206;3;203
182600022;500;965;965;7;209;499;1;0;0;0;0;209;3;206
182600023;500;1096;1101;5;146;499;1;0;0;0;0;146;0;146
182600024;500;407;401;6;203;499;1;0;0;0;0;203;2;201
182600025;300;209;209;4;129;170;1;129;1;5;123;0;0;0
182600026;100;50;51;5;34;65;1;34;0;0;34;0;0;0
182600027;500;779;779;3;285;499;1;0;0;0;0;285;4;281
182600028;500;837;839;4;207;499;1;0;0;0;0;207;0;207
182600029;500;883;883;3;337;499;1;0;0;0;0;337;1;336
182600030;500;924;926;11;360;499;1;0;0;0;0;360;3;357
182600031;500;921;927;10;323;499;1;0;0;0;0;323;5;318
182600032;500;1060;1066;6;327;499;1;0;0;0;0;327;2;325
182600033;500;896;901;8;380;499;1;0;0;0;0;380;7;373
182600034;500;811;817;7;333;499;1;0;0;0;0;333;5;328
182600035;500;908;918;5;397;499;1;0;0;0;0;397;7;390
182600036;500;879;883;7;412;499;1;0;0;0;0;412;6;406
182600037;500;879;884;5;401;499;1;0;0;0;0;401;2;399
182600038;500;860;861;9;400;499;1;0;0;0;0;400;7;393
182600039;500;911;913;6;310;499;1;0;0;0;0;310;3;307
182600040;500;973;976;7;385;499;1;0;0;0;0;385;6;379
182600041;500;869;870;9;304;499;1;0;0;0;0;304;8;296
182600042;500;832;832;8;291;499;1;0;0;0;0;291;2;289
182600043;500;816;821;7;313;499;1;0;0;0;0;313;2;311
182600044;500;819;821;7;338;499;1;0;0;0;0;338;6;332
182600045;500;778;784;8;302;499;1;0;0;0;0;302;5;297
182600046;500;819;821;8;312;499;1;0;0;0;0;312;6;306
182600047;500;910;912;9;322;499;1;0;0;0;0;322;1;321
182600048;500;924;924;7;302;499;1;0;0;0;0;302;8;294
182600049;500;970;975;10;366;499;1;0;0;0;0;366;8;358
182600050;500;996;1002;10;345;499;1;0;0;0;0;345;3;342
182600051;500;970;963;8;378;499;1;0;0;0;0;378;9;369
182600052;500;966;972;9;299;499;1;0;0;0;0;299;3;296
182600053;500;1042;1044;7;98;499;1;0;0;0;0;98;1;97
182600054;500;981;982;9;190;499;1;0;0;0;0;190;0;190
182600055;500;941;943;9;264;499;1;0;0;0;0;264;0;264
182600056;500;1025;1025;10;168;499;1;0;0;0;0;168;0;168
182600057;500;906;910;8;212;499;1;0;0;0;0;212;3;209
182600058;500;804;806;8;231;499;1;0;0;0;0;231;1;230
182600059;500;911;912;6;264;499;1;0;0;0;0;264;3;261
182600060;500;881;882;9;279;498;2;0;0;0;0;279;6;273
182600061;500;914;914;6;287;499;1;0;0;0;0;287;9;278
182600062;500;803;805;9;209;499;1;0;0;0;0;209;1;208
182600063;500;920;921;6;210;499;1;0;0;0;0;210;4;206
182600064;500;869;873;7;254;499;1;0;0;0;0;254;3;251
182600065;500;888;888;8;290;499;1;0;0;0;0;290;5;285
182600066;100;93;93;7;34;65;1;34;0;0;34;0;0;0
182600067;100;62;36;10;46;53;1;46;2;0;44;0;0;0
182600068;100;39;30;12;40;59;1;40;0;0;40;0;0;0
182600069;100;54;54;7;59;41;0;59;4;0;55;0;0;0
182600070;100;58;58;37;40;59;1;40;0;3;37;0;0;0
182900001;580;577;577;9;281;579;1;0;0;0;0;281;1;280
182900002;450;420;437;7;181;449;1;0;0;0;0;181;0;181
182900003;970;923;968;8;331;969;1;0;0;0;0;331;1;330
182900004;540;531;531;0;136;539;1;0;0;0;0;136;2;134
182900005;360;337;353;1;133;360;0;0;0;0;0;133;1;132
182900006;280;271;271;0;188;91;1;188;10;1;177;0;0;0
182900007;950;944;944;14;328;950;0;0;0;0;0;328;0;328
182900008;460;438;458;6;200;460;0;0;0;0;0;200;0;200
182900009;420;415;416;4;127;419;1;0;0;0;0;127;0;127
182900010;700;694;696;3;256;700;0;0;0;0;0;256;2;254
182900011;380;336;379;10;129;379;1;0;0;0;0;129;0;129
182900012;60;56;56;3;44;15;1;44;1;0;43;0;0;0
182900013;400;375;396;2;155;400;0;0;0;0;0;155;0;155
182900014;430;401;427;4;201;429;1;0;0;0;0;201;1;200
182900015;1200;1127;1192;10;391;1200;0;0;0;0;0;391;2;389
182900016;880;846;876;4;331;880;0;0;0;0;0;331;2;329
182900017;60;51;51;0;47;13;0;47;5;0;42;0;0;0
182900018;20;17;17;0;17;2;1;17;1;0;16;0;0;0
182900019;85;76;76;0;74;10;1;74;1;0;73;0;0;0
182900020;40;40;40;0;34;5;1;34;0;0;34;0;0;0
182900021;25;20;20;0;19;5;1;19;2;0;17;0;0;0
182900022;50;42;42;0;40;10;0;40;1;0;39;0;0;0
182900023;30;21;21;0;21;9;0;21;0;0;21;0;0;0
182900024;30;26;26;0;26;3;1;26;0;0;26;0;0;0
182900025;100;92;92;0;92;7;1;92;0;0;92;0;0;0
183600001;400;876;935;8;227;399;1;0;0;0;0;227;0;227
183600002;300;646;660;6;206;300;0;0;0;0;0;206;1;205
183600003;300;711;740;9;182;300;0;0;0;0;0;182;1;181
183600004;200;203;203;6;76;122;2;76;2;0;74;0;0;0
183600005;200;488;498;0;174;200;0;0;0;0;0;174;1;173
183600006;300;671;671;2;245;299;1;0;0;0;0;245;7;238
183600007;300;640;703;5;229;299;1;0;0;0;0;229;2;227
183600008;400;836;905;1;266;399;1;0;0;0;0;266;4;262
183600009;300;788;830;3;323;299;1;0;0;0;0;323;7;316
183600010;300;223;223;2;223;76;1;223;1;0;222;0;0;0
183600011;200;100;100;0;100;100;0;100;2;0;98;0;0;0
190300001;600;586;586;6;240;599;1;0;0;0;0;240;4;236
190300002;600;554;557;3;250;599;1;0;0;0;0;250;3;247
190300003;700;730;733;3;247;699;1;0;0;0;0;247;0;247
190300004;100;112;112;4;47;51;2;47;3;0;44;0;0;0
190300005;200;173;173;2;115;84;1;115;2;0;113;0;0;0
190300006;700;706;707;3;183;699;1;0;0;0;0;183;1;182
190300007;400;463;464;4;111;399;1;0;0;0;0;111;0;111
190300008;400;376;376;3;175;399;1;0;0;0;0;175;2;173
190300009;800;767;770;4;234;799;1;0;0;0;0;234;1;233
190300010;500;505;509;4;198;499;1;0;0;0;0;198;0;198
190400001;300;389;390;4;183;299;1;0;0;0;0;183;5;178
190400002;600;666;666;1;277;599;1;0;0;0;0;277;2;275
190400003;600;592;597;0;164;599;1;0;0;0;0;164;2;162
190400004;800;795;799;5;329;799;1;0;0;0;0;329;4;325
190400005;800;844;850;9;376;799;1;0;0;0;0;376;2;374
190400006;900;987;990;9;147;899;1;0;0;0;0;147;0;147
190400007;900;920;920;5;359;899;1;0;0;0;0;359;5;354
190400008;600;647;651;5;270;599;1;0;0;0;0;270;4;266
190400009;500;507;511;0;201;499;1;0;0;0;0;201;1;200
190400010;600;624;626;6;273;599;1;0;0;0;0;273;1;272
190400011;600;586;586;5;246;599;1;0;0;0;0;246;0;246
190400012;200;15;15;75;90;109;1;90;4;2;84;0;0;0
190400013;200;124;9;15;100;99;1;100;23;2;75;0;0;0
190400014;200;232;232;1;104;95;1;104;4;1;99;0;0;0
190400015;200;192;192;4;114;85;1;114;2;1;111;0;0;0
190400016;100;34;34;6;30;69;1;30;0;0;30;0;0;0
190400017;700;698;698;3;236;699;1;0;0;0;0;236;1;235
190400018;500;566;576;1;180;500;0;0;0;0;0;180;0;180
190400019;300;290;290;5;124;175;1;124;4;1;119;0;0;0
190400020;400;443;445;1;207;398;2;0;0;0;0;207;1;206
190400021;200;197;200;6;84;115;1;84;1;0;83;0;0;0
190400022;300;332;336;5;147;299;1;0;0;0;0;147;3;144
190400023;300;313;313;4;128;299;1;0;0;0;0;128;5;123
190400024;400;470;474;1;187;399;1;0;0;0;0;187;0;187
190400025;200;189;189;6;72;127;1;72;5;1;66;0;0;0
190400026;100;37;37;0;35;64;1;35;4;0;31;0;0;0
190500001;600;585;587;2;196;599;1;0;0;0;0;196;4;192
190500002;700;673;673;2;178;699;1;0;0;0;0;178;0;178
190500003;800;790;786;5;193;799;1;0;0;0;0;193;2;191
190500004;700;632;632;3;234;699;1;0;0;0;0;234;1;233
190500005;900;828;828;4;248;900;0;0;0;0;0;248;1;247
190500006;940;939;940;7;272;939;1;0;0;0;0;272;3;269
190500007;600;544;544;4;221;599;1;0;0;0;0;221;0;221
190500008;500;485;493;2;138;499;1;0;0;0;0;138;0;138
190500009;600;536;542;2;172;599;1;0;0;0;0;172;0;172
190500010;700;693;709;2;277;699;1;0;0;0;0;277;2;275
190500011;500;503;518;2;175;499;1;0;0;0;0;175;2;173
190500012;600;573;582;3;142;599;1;0;0;0;0;142;1;141
190500013;400;438;438;3;208;398;2;0;0;0;0;208;3;205
190500014;300;279;279;3;141;157;2;141;2;2;137;0;0;0
190500015;200;203;203;1;92;107;1;92;1;0;91;0;0;0
190500016;600;600;600;4;166;599;1;0;0;0;0;166;1;165
190500017;400;350;352;1;147;399;1;0;0;0;0;147;0;147
190500018;700;652;662;4;272;699;1;0;0;0;0;272;1;271
190500019;600;613;624;7;213;599;1;0;0;0;0;213;0;213
190500020;700;651;673;8;274;699;1;0;0;0;0;274;3;271
190500021;700;635;650;8;251;699;1;0;0;0;0;251;2;249
190500022;200;123;123;0;119;80;1;119;0;1;118;0;0;0
190800001;600;602;603;2;272;599;1;0;0;0;0;272;2;270
190800002;500;511;512;7;237;499;1;0;0;0;0;237;2;235
190800003;800;773;777;3;354;799;1;0;0;0;0;354;3;351
190800004;800;823;823;4;247;799;1;0;0;0;0;247;3;244
190800005;900;849;851;2;111;900;0;0;0;0;0;111;0;111
190800006;900;966;967;8;232;900;0;0;0;0;0;232;1;231
190800007;600;530;531;5;234;600;0;0;0;0;0;234;1;233
190800008;700;720;722;4;223;699;1;0;0;0;0;223;1;222
190800009;300;298;298;4;120;179;1;120;7;0;113;0;0;0
190800010;600;571;571;2;178;599;1;0;0;0;0;178;0;178
190800011;200;141;141;6;63;136;1;63;2;0;61;0;0;0
190800012;200;184;185;5;81;118;1;81;6;0;75;0;0;0
190800013;400;362;363;8;129;399;1;0;0;0;0;129;1;128
190800014;400;374;374;3;133;399;1;0;0;0;0;133;2;131
190800015;100;66;66;8;52;47;1;52;0;1;51;0;0;0
191300001;150;112;112;4;81;67;2;81;0;4;77;0;0;0
191300002;600;650;653;5;257;599;1;0;0;0;0;257;2;255
191300003;200;246;246;4;153;46;1;153;6;2;145;0;0;0
191300004;150;164;164;5;107;42;1;107;2;3;102;0;0;0
191300005;100;100;100;3;80;19;1;80;3;2;75;0;0;0
191300006;600;638;639;3;308;599;1;0;0;0;0;308;2;306
191300007;450;481;485;4;222;449;1;0;0;0;0;222;3;219
191300008;450;499;501;5;250;449;1;0;0;0;0;250;2;248
191300009;650;732;734;6;223;649;1;0;0;0;0;223;6;217
191300010;500;485;487;3;176;499;1;0;0;0;0;176;0;176
191300011;600;496;497;2;219;600;0;0;0;0;0;219;0;219
191300012;500;373;373;2;185;499;1;0;0;0;0;185;3;182
191300013;900;849;849;5;266;899;1;0;0;0;0;266;4;262
191300014;350;350;351;5;193;350;0;0;0;0;0;193;0;193
191300015;500;542;544;3;289;499;1;0;0;0;0;289;8;281
191300016;100;114;115;4;85;14;1;85;0;0;85;0;0;0
191300017;650;683;683;3;268;649;1;0;0;0;0;268;2;266
191300018;100;72;72;5;57;40;3;57;1;0;56;0;0;0
192700001;500;847;845;8;425;499;1;0;0;0;0;425;10;415
192700002;500;879;871;9;414;499;1;0;0;0;0;414;5;409
192700003;500;794;796;9;399;499;1;0;0;0;0;399;4;395
192700004;500;825;820;8;385;499;1;0;0;0;0;385;5;380
192700005;500;868;859;9;423;500;0;0;0;0;0;423;3;420
192700006;500;900;887;11;418;500;0;0;0;0;0;418;2;416
192700007;500;699;694;8;301;499;1;0;0;0;0;301;5;296
192700008;500;775;779;11;286;500;0;0;0;0;0;286;8;278
192700009;500;627;628;7;269;499;1;0;0;0;0;269;4;265
192700010;500;747;746;4;310;499;1;0;0;0;0;310;5;305
192700011;500;757;753;8;325;499;1;0;0;0;0;325;5;320
192700012;500;807;805;7;366;500;0;0;0;0;0;366;5;361
192700013;500;877;880;5;419;499;1;0;0;0;0;419;4;415
192700014;500;806;803;7;396;499;1;0;0;0;0;396;6;390
192700015;500;837;843;7;406;499;1;0;0;0;0;406;5;401
192700016;500;741;742;4;313;499;1;0;0;0;0;313;4;309
192700017;500;786;786;8;341;499;1;0;0;0;0;341;3;338
192700018;500;705;703;7;293;499;1;0;0;0;0;293;3;290
192700019;500;863;857;8;408;499;1;0;0;0;0;408;8;400
192700020;500;827;823;11;376;499;1;0;0;0;0;376;7;369
192700021;500;621;623;6;296;499;1;0;0;0;0;296;4;292
192700022;500;735;733;11;321;499;1;0;0;0;0;321;2;319
192700023;500;620;620;9;266;499;1;0;0;0;0;266;4;262
192700024;500;802;807;12;403;499;1;0;0;0;0;403;4;399
192700025;500;765;768;10;332;500;0;0;0;0;0;332;6;326
192700026;500;781;779;8;358;499;1;0;0;0;0;358;5;353
192700027;500;764;767;8;303;500;0;0;0;0;0;303;3;300
192700028;500;720;708;8;276;499;1;0;0;0;0;276;4;272
192700029;500;775;780;9;304;500;0;0;0;0;0;304;2;302
192700030;500;168;162;4;47;452;1;47;0;0;47;0;0;0
192700031;500;747;749;8;301;499;1;0;0;0;0;301;6;295
192700032;500;836;838;12;364;499;1;0;0;0;0;364;3;361
192700033;500;719;721;8;324;499;1;0;0;0;0;324;4;320
192700034;500;574;569;10;226;500;0;0;0;0;0;226;1;225
192700035;500;757;759;9;306;499;1;0;0;0;0;306;7;299
192700036;500;858;847;7;367;500;0;0;0;0;0;367;3;364
192700037;500;796;799;10;313;499;1;0;0;0;0;313;3;310
192700038;500;661;660;10;216;499;1;0;0;0;0;216;0;216
192700039;500;630;630;9;252;499;1;0;0;0;0;252;3;249
192700040;500;661;662;8;264;499;1;0;0;0;0;264;5;259
192700041;500;772;769;6;340;500;0;0;0;0;0;340;6;334
192700042;500;697;698;9;314;499;1;0;0;0;0;314;9;305
192700043;500;769;769;9;325;499;1;0;0;0;0;325;5;320
192700044;500;824;824;6;350;499;1;0;0;0;0;350;5;345
192700045;500;724;725;9;285;500;0;0;0;0;0;285;5;280
192700046;500;798;799;8;249;500;0;0;0;0;0;249;1;248
192700047;500;824;827;7;341;499;1;0;0;0;0;341;5;336
192700048;500;804;805;8;321;500;0;0;0;0;0;321;3;318
192700049;500;795;794;8;276;499;1;0;0;0;0;276;6;270
192700050;500;793;794;7;211;499;1;0;0;0;0;211;6;205
192700051;500;845;842;10;283;499;1;0;0;0;0;283;5;278
192700052;500;875;877;8;217;500;0;0;0;0;0;217;1;216
192700053;500;893;895;7;149;499;1;0;0;0;0;149;2;147
192700054;500;848;849;6;246;500;0;0;0;0;0;246;2;244
192700055;500;745;747;4;198;500;0;0;0;0;0;198;1;197
192700056;500;714;706;8;270;499;1;0;0;0;0;270;3;267
192700057;500;768;768;2;246;499;1;0;0;0;0;246;5;241
192700058;500;792;797;4;279;499;1;0;0;0;0;279;0;279
192700059;500;680;682;6;194;499;1;0;0;0;0;194;4;190
192700060;500;768;770;10;330;500;0;0;0;0;0;330;3;327
192700061;500;825;818;10;268;500;0;0;0;0;0;268;4;264
192700062;500;853;855;7;297;499;1;0;0;0;0;297;8;289
192700063;500;802;804;9;301;499;1;0;0;0;0;301;3;298
192700064;500;812;814;8;280;499;1;0;0;0;0;280;4;276
192700065;500;745;749;6;245;500;0;0;0;0;0;245;4;241
192700066;500;776;777;3;284;499;1;0;0;0;0;284;4;280
192700067;500;739;740;9;255;499;1;0;0;0;0;255;3;252
192700068;500;759;759;8;278;500;0;0;0;0;0;278;3;275
192700069;500;705;708;3;229;500;0;0;0;0;0;229;2;227
192700070;500;827;828;5;295;499;1;0;0;0;0;295;3;292
192700071;500;735;732;5;327;500;0;0;0;0;0;327;6;321
192700072;500;752;755;7;205;500;0;0;0;0;0;205;3;202
192700073;500;555;555;7;227;499;1;0;0;0;0;227;10;217
192700074;500;788;790;6;283;499;1;0;0;0;0;283;4;279
192700075;500;786;788;5;234;499;1;0;0;0;0;234;8;226
192700076;500;825;827;8;196;500;0;0;0;0;0;196;1;195
192700077;500;747;747;9;238;500;0;0;0;0;0;238;5;233
192700078;500;808;813;2;281;500;0;0;0;0;0;281;5;276
192700079;500;662;664;5;224;500;0;0;0;0;0;224;6;218
192700080;500;801;801;9;277;499;1;0;0;0;0;277;6;271
192700081;500;741;741;9;269;500;0;0;0;0;0;269;5;264
192700082;500;797;797;9;288;500;0;0;0;0;0;288;4;284
192700083;500;837;838;4;272;499;1;0;0;0;0;272;2;270
192700084;500;802;805;4;237;499;1;0;0;0;0;237;4;233
192700085;500;804;805;7;285;499;1;0;0;0;0;285;6;279
192700086;500;810;814;3;283;500;0;0;0;0;0;283;1;282
192700087;500;748;748;8;224;499;1;0;0;0;0;224;1;223
192700088;500;640;643;7;206;499;1;0;0;0;0;206;0;206
192700089;500;633;636;3;210;499;1;0;0;0;0;210;5;205
192700090;500;780;781;4;218;499;1;0;0;0;0;218;3;215
192700091;500;802;803;0;221;499;1;0;0;0;0;221;3;218
192700092;500;723;724;6;214;499;1;0;0;0;0;214;2;212
192700093;500;736;737;8;152;500;0;0;0;0;0;152;1;151
192700094;500;665;669;4;131;499;1;0;0;0;0;131;4;127
192700095;500;636;636;8;160;499;1;0;0;0;0;160;3;157
192700096;500;750;753;8;156;499;1;0;0;0;0;156;3;153
192700097;500;766;769;6;228;499;1;0;0;0;0;228;4;224
192700098;500;824;827;6;250;499;1;0;0;0;0;250;8;242
192700099;500;775;774;8;236;499;1;0;0;0;0;236;3;233
192700100;500;807;802;10;254;500;0;0;0;0;0;254;2;252
192700101;500;610;603;12;200;499;1;0;0;0;0;200;3;197
192700102;500;739;739;6;264;499;1;0;0;0;0;264;2;262
192700103;500;781;781;5;299;499;1;0;0;0;0;299;3;296
192700104;500;793;793;5;242;499;1;0;0;0;0;242;3;239
192700105;500;679;679;7;281;500;0;0;0;0;0;281;6;275
192700106;500;674;676;8;244;499;1;0;0;0;0;244;3;241
192700107;500;761;765;6;280;499;1;0;0;0;0;280;5;275
192700108;500;858;860;9;356;500;0;0;0;0;0;356;9;347
192700109;500;676;676;11;266;499;1;0;0;0;0;266;6;260
192700110;500;713;713;9;284;500;0;0;0;0;0;284;5;279
192700111;500;737;741;10;266;499;1;0;0;0;0;266;5;261
192700112;500;773;781;9;284;499;1;0;0;0;0;284;9;275
192700113;500;776;776;8;267;500;0;0;0;0;0;267;0;267
192700114;500;780;779;7;322;499;1;0;0;0;0;322;5;317
192700115;500;645;645;9;245;499;1;0;0;0;0;245;1;244
192700116;500;666;666;7;299;499;1;0;0;0;0;299;7;292
192700117;500;674;677;7;265;499;1;0;0;0;0;265;2;263
192700118;500;626;627;4;289;499;1;0;0;0;0;289;5;284
192700119;500;582;584;9;253;499;1;0;0;0;0;253;3;250
192700120;500;681;685;8;269;499;1;0;0;0;0;269;2;267
192700121;500;735;735;9;320;500;0;0;0;0;0;320;8;312
192700122;500;534;539;8;229;499;1;0;0;0;0;229;8;221
192700123;500;602;605;5;233;499;1;0;0;0;0;233;1;232
192700124;500;701;705;7;257;499;1;0;0;0;0;257;2;255
192700125;500;780;780;6;282;499;1;0;0;0;0;282;4;278
192700126;500;598;598;6;222;499;1;0;0;0;0;222;0;222
192700127;500;777;778;7;320;499;1;0;0;0;0;320;5;315
192700128;500;524;524;4;210;499;1;0;0;0;0;210;0;210
192700129;500;677;683;5;287;499;1;0;0;0;0;287;5;282
192700130;500;564;566;9;237;499;1;0;0;0;0;237;3;234
192700131;500;660;660;7;257;500;0;0;0;0;0;257;3;254
192700132;500;566;569;4;177;500;0;0;0;0;0;177;3;174
192700133;500;577;580;5;208;499;1;0;0;0;0;208;3;205
192700134;500;519;519;8;231;500;0;0;0;0;0;231;1;230
192700135;500;729;731;6;283;499;1;0;0;0;0;283;6;277
192700136;500;711;712;6;257;499;1;0;0;0;0;257;13;244
192700137;500;732;737;6;259;499;1;0;0;0;0;259;7;252
192700138;500;682;685;3;218;500;0;0;0;0;0;218;6;212
192700139;500;689;691;4;222;499;1;0;0;0;0;222;0;222
192700140;500;755;757;8;220;500;0;0;0;0;0;220;3;217
192700141;500;685;677;8;330;499;1;0;0;0;0;330;7;323
192700142;500;765;765;6;305;500;0;0;0;0;0;305;3;302
192700143;500;732;737;5;327;499;1;0;0;0;0;327;5;322
192700144;500;734;734;8;310;500;0;0;0;0;0;310;3;307
192700145;500;606;608;8;238;500;0;0;0;0;0;238;10;228
192700146;500;732;737;6;351;499;1;0;0;0;0;351;4;347
192700147;500;684;686;7;328;500;0;0;0;0;0;328;5;323
192700148;500;810;815;4;383;499;1;0;0;0;0;383;5;378
192700149;500;624;619;10;287;499;1;0;0;0;0;287;8;279
192700150;500;659;662;9;307;500;0;0;0;0;0;307;2;305
192700151;500;626;619;7;290;500;0;0;0;0;0;290;6;284
192700152;500;658;658;8;268;499;1;0;0;0;0;268;4;264
192700153;500;768;769;6;358;499;1;0;0;0;0;358;4;354
192700154;500;540;542;9;237;500;0;0;0;0;0;237;5;232
192700155;500;725;725;7;357;500;0;0;0;0;0;357;6;351
192700156;500;733;731;8;334;499;1;0;0;0;0;334;3;331
192700157;500;786;785;12;355;500;0;0;0;0;0;355;6;349
192700158;500;588;592;10;279;500;0;0;0;0;0;280;6;274
192700159;500;374;375;12;170;499;1;0;0;0;0;170;3;167
192700160;500;683;682;9;290;499;1;0;0;0;0;290;6;284
192700161;500;654;654;6;273;499;1;0;0;0;0;273;6;267
192700162;500;686;688;3;270;499;1;0;0;0;0;270;2;268
192700163;500;710;713;7;297;500;0;0;0;0;0;297;5;292
192700164;500;724;730;5;292;500;0;0;0;0;0;292;4;288
192700165;500;519;521;9;196;499;1;0;0;0;0;196;4;192
192700166;500;696;698;9;322;500;0;0;0;0;0;322;3;319
192700167;500;699;701;7;314;500;0;0;0;0;0;314;4;310
192700168;500;733;738;11;295;499;1;0;0;0;0;295;6;289
192700169;500;562;565;7;237;499;1;0;0;0;0;237;2;235
192700170;500;653;655;7;261;500;0;0;0;0;0;261;6;255
192700171;500;623;639;7;148;499;1;0;0;0;0;148;2;146
192700172;500;546;543;5;112;499;1;0;0;0;0;112;1;111
192700173;500;360;358;5;53;499;1;0;0;0;0;53;0;53
192700174;500;768;674;6;168;500;0;0;0;0;0;168;0;168
192700175;500;593;594;5;210;500;0;0;0;0;0;210;2;208
192700176;500;660;661;4;244;499;1;0;0;0;0;244;6;238
192700177;500;545;545;7;146;500;0;0;0;0;0;146;2;144
192700178;500;612;613;2;249;499;1;0;0;0;0;249;3;246
192700179;500;622;622;4;235;499;1;0;0;0;0;235;3;232
192700180;500;132;124;7;62;437;1;62;1;0;61;0;0;0
192700181;500;281;263;8;97;401;2;97;6;1;90;0;0;0
192700182;500;621;623;1;269;499;1;0;0;0;0;269;3;266
192700183;500;519;519;4;229;499;1;0;0;0;0;229;3;226
192700184;500;446;447;3;156;499;1;0;0;0;0;156;1;155
192700185;500;650;651;4;131;499;1;0;0;0;0;131;2;129
192700186;500;185;185;5;142;357;1;142;5;2;135;0;0;0
192700187;500;882;882;6;318;499;1;0;0;0;0;318;3;315
192700188;500;763;766;6;318;499;1;0;0;0;0;318;5;313
192700189;500;593;595;1;214;499;1;0;0;0;0;214;0;214
192700190;500;832;832;4;295;500;0;0;0;0;0;295;3;292
192700191;500;663;665;2;296;499;1;0;0;0;0;296;3;293
192700192;500;509;509;4;197;499;1;0;0;0;0;197;4;193
192700193;500;537;537;6;197;500;0;0;0;0;0;197;3;194
192700194;500;580;581;3;215;499;1;0;0;0;0;215;0;215
192700195;500;539;540;1;186;499;1;0;0;0;0;186;6;180
192700196;500;455;455;5;161;499;1;0;0;0;0;161;1;160
192700197;500;482;482;1;159;500;0;0;0;0;0;159;1;158
192700198;500;517;517;1;207;499;1;0;0;0;0;207;4;203
192700199;500;525;526;5;212;499;1;0;0;0;0;212;1;211
192700200;500;466;466;3;115;500;0;0;0;0;0;115;1;114
192700201;500;625;627;7;189;499;1;0;0;0;0;189;2;187
192700202;500;819;823;1;216;499;1;0;0;0;0;216;1;215
192700203;500;871;873;3;131;499;1;0;0;0;0;131;1;130
192700204;500;601;603;3;125;499;1;0;0;0;0;125;0;125
192700205;500;608;611;2;236;499;1;0;0;0;0;236;3;233
192700206;500;528;528;3;189;500;0;0;0;0;0;189;3;186
192700207;500;342;342;6;132;500;0;0;0;0;0;132;2;130
192700208;100;69;69;5;19;80;1;19;4;0;15;0;0;0
192700209;200;64;37;10;49;150;1;49;22;0;27;0;0;0
192700210;200;162;97;13;92;107;1;92;16;1;75;0;0;0
192700211;100;36;36;6;40;60;0;40;0;1;39;0;0;0
192700212;100;39;39;7;40;60;0;40;0;2;38;0;0;0
192700213;100;16;16;8;24;75;1;24;3;0;21;0;0;0
192700214;100;59;59;24;71;27;2;71;8;0;63;0;0;0
192700215;200;118;118;74;141;54;5;141;2;3;136;0;0;0
192700216;100;19;19;10;25;73;2;25;1;0;24;0;0;0
192700217;200;36;36;99;118;80;2;118;1;2;115;0;0;0
192700218;100;16;16;6;11;88;1;11;0;0;11;0;0;0
193300001;1000;728;728;4;287;999;1;0;0;0;0;287;3;284
193300002;1000;993;993;4;312;999;1;0;0;0;0;312;5;307
193300003;700;709;709;7;142;699;1;0;0;0;0;142;0;142
193300004;700;671;672;3;94;699;1;0;0;0;0;94;0;94
193300005;700;693;693;3;257;699;1;0;0;0;0;257;2;255
193300006;800;810;812;3;270;800;0;0;0;0;0;270;1;269
193300007;500;521;522;3;113;499;1;0;0;0;0;113;0;113
193300008;700;712;714;5;135;699;1;0;0;0;0;135;3;132
193300009;700;723;723;5;211;699;1;0;0;0;0;211;2;209
193300010;900;905;906;1;216;899;1;0;0;0;0;216;1;215
193300011;800;818;818;2;243;799;1;0;0;0;0;243;4;239
193300012;400;383;384;3;190;399;1;0;0;0;0;190;2;188
193300013;300;280;280;6;164;135;1;164;0;2;162;0;0;0
193300014;400;421;421;7;167;399;1;0;0;0;0;167;4;163
193300015;450;453;454;8;199;450;0;0;0;0;0;202;8;194
193300016;350;363;363;5;131;349;1;0;0;0;0;131;2;129
193300017;100;66;66;5;58;41;1;58;2;2;54;0;0;0
193700001;600;622;627;1;318;599;1;0;0;0;0;318;2;316
193700002;800;739;741;0;256;799;1;0;0;0;0;256;2;254
193700003;500;346;347;4;146;499;1;0;0;0;0;146;1;145
193700004;600;658;663;0;325;599;1;0;0;0;0;325;4;321
193700005;800;758;761;2;437;799;1;0;0;0;0;437;3;434
193700006;400;336;339;2;188;399;1;0;0;0;0;188;1;187
193700007;200;174;175;2;122;76;2;122;5;2;115;0;0;0
193700008;100;81;75;6;40;59;1;40;1;2;37;0;0;0
193700009;600;627;636;2;308;599;1;0;0;0;0;308;0;308
193700010;300;245;246;3;124;172;4;124;3;1;120;0;0;0
193700011;100;17;17;0;16;84;0;16;2;0;14;0;0;0
200100201;600;549;549;1;266;599;1;0;0;0;0;266;2;264
200100202;550;469;509;1;227;549;1;0;0;0;0;227;5;222
200100203;300;264;269;1;112;187;1;112;1;2;109;0;0;0
200100204;400;343;343;4;139;260;1;139;3;0;136;0;0;0
200100205;430;397;397;4;82;429;1;0;0;0;0;82;0;82
200100206;100;53;53;4;38;61;1;38;0;0;38;0;0;0
200100207;50;39;39;5;33;15;2;33;2;0;31;0;0;0
200100208;70;47;47;3;31;38;1;31;2;1;28;0;0;0
200100209;400;348;348;6;120;400;0;0;0;0;0;120;1;119
200100210;50;38;38;2;39;10;1;39;2;0;37;0;0;0
200100211;50;32;32;4;33;16;1;33;0;0;33;0;0;0
200700301;800;761;764;1;310;799;1;0;0;0;0;310;1;309
200700302;800;838;840;5;374;799;1;0;0;0;0;374;15;359
200700303;200;166;166;7;99;99;2;99;2;0;97;0;0;0
200700304;500;562;570;6;283;499;1;0;0;0;0;283;1;282
200700305;400;369;369;4;219;399;1;0;0;0;0;219;0;219
200700306;600;560;560;9;260;600;0;0;0;0;0;260;2;258
200700307;300;305;305;3;145;299;1;0;0;0;0;145;0;145
200700308;400;380;382;4;200;399;1;0;0;0;0;200;1;199
200700309;300;350;350;4;157;299;1;0;0;0;0;157;0;157
200700310;400;419;421;2;189;399;1;0;0;0;0;189;1;188
200700311;700;686;687;5;294;699;1;0;0;0;0;294;4;290
200700312;400;424;428;3;200;399;1;0;0;0;0;200;0;200
200700313;600;577;577;6;292;600;0;0;0;0;0;292;2;290
200700314;400;374;374;6;163;400;0;0;0;0;0;163;0;163
200700315;300;210;210;7;103;196;1;103;1;2;100;0;0;0
200700316;600;575;575;8;293;599;1;0;0;0;0;293;1;292
200700317;200;173;173;3;90;109;1;90;2;0;88;0;0;0
200700318;600;552;554;6;287;599;1;0;0;0;0;287;2;285
200700319;100;74;74;7;45;53;2;45;1;0;44;0;0;0
200700320;372;372;376;5;228;371;1;0;0;0;0;228;0;228
200700321;200;136;137;3;67;131;2;67;0;0;67;0;0;0
200700322;350;297;302;3;178;169;3;178;5;2;171;0;0;0
200700323;800;833;834;4;255;799;1;0;0;0;0;255;2;253
200700324;800;793;794;6;376;799;1;0;0;0;0;376;1;375
200700325;300;364;364;3;156;299;1;0;0;0;0;156;0;156
200700326;50;44;44;0;43;6;1;43;7;0;36;0;0;0
201000401;700;710;710;6;284;699;1;0;0;0;0;284;7;277
201000402;400;376;380;7;181;399;1;0;0;0;0;181;0;181
201000403;1000;1022;1023;5;336;999;1;0;0;0;0;336;7;329
201000404;800;752;755;11;321;799;1;0;0;0;0;321;4;317
201000405;700;637;638;4;287;699;1;0;0;0;0;287;1;286
201000406;1200;1177;1181;3;435;1199;1;0;0;0;0;435;4;431
201000407;800;776;779;8;304;799;1;0;0;0;0;304;4;300
201000408;1000;1018;1018;7;355;999;1;0;0;0;0;355;4;351
201000409;1200;1107;1107;2;374;1199;1;0;0;0;0;374;1;373
201000410;900;919;921;1;306;899;1;0;0;0;0;306;4;302
201000411;500;520;521;6;178;499;1;0;0;0;0;178;1;177
201000412;100;44;44;24;31;68;1;31;0;0;31;0;0;0
201000413;900;909;910;4;425;899;1;0;0;0;0;425;0;425
201000414;700;669;669;6;308;700;0;0;0;0;0;308;0;308
201000415;404;404;404;3;193;403;1;0;0;0;0;193;2;191
201000416;300;267;267;5;163;136;1;163;2;0;161;0;0;0
201000417;700;648;649;4;268;700;0;0;0;0;0;268;2;266
201000418;800;740;742;9;305;799;1;0;0;0;0;305;0;305
201000419;700;721;721;5;240;699;1;0;0;0;0;240;0;240
201000420;100;43;43;6;37;62;1;37;5;0;32;0;0;0
201000421;500;502;504;4;221;499;1;0;0;0;0;221;1;220
201000422;300;295;295;1;134;299;1;0;0;0;0;134;0;134
201000423;1200;1165;1169;6;419;1199;1;0;0;0;0;419;2;417
201000424;800;738;738;3;246;799;1;0;0;0;0;246;2;244
201000425;800;799;800;7;319;799;1;0;0;0;0;319;3;316
201000426;200;206;206;4;69;130;1;69;3;0;66;0;0;0
201000427;800;728;728;6;375;799;1;0;0;0;0;375;1;374
201000428;600;637;637;6;300;599;1;0;0;0;0;300;1;299
201000429;900;962;962;2;380;899;1;0;0;0;0;380;2;378
201000430;700;755;755;3;300;699;1;0;0;0;0;300;2;298
201000431;600;663;663;0;262;599;1;0;0;0;0;262;1;261
201000432;600;631;633;4;292;599;1;0;0;0;0;292;0;292
201000433;900;914;914;4;337;899;1;0;0;0;0;337;1;336
201000434;500;470;471;4;170;499;1;0;0;0;0;170;0;170
201000435;900;944;946;4;315;899;1;0;0;0;0;315;0;315
201000436;400;373;374;2;183;399;1;0;0;0;0;183;1;182
201000437;1000;1019;1033;4;406;999;1;0;0;0;0;406;5;401
201000438;800;817;817;0;331;799;1;0;0;0;0;331;6;325
201000439;600;682;681;2;248;599;1;0;0;0;0;248;5;243
201000440;800;806;808;3;284;799;1;0;0;0;0;284;0;284
201000441;600;627;627;4;222;599;1;0;0;0;0;222;1;221
201000442;1000;1027;1029;7;491;1000;0;0;0;0;0;491;2;489
201000443;50;21;21;0;21;28;1;21;0;0;21;0;0;0
201000444;50;22;22;0;20;29;1;20;0;0;20;0;0;0
201500501;100;89;89;4;52;47;1;52;1;1;50;0;0;0
201500502;550;543;543;3;147;549;1;0;0;0;0;147;1;146
201500503;600;552;552;6;192;599;1;0;0;0;0;192;0;192
201500504;160;139;139;5;76;83;1;76;5;0;71;0;0;0
201500505;150;103;103;6;52;97;1;52;1;1;50;0;0;0
201500506;420;413;413;3;214;419;1;0;0;0;0;214;0;214
201500507;600;587;587;6;249;599;1;0;0;0;0;249;2;247
201500508;100;69;69;3;46;53;1;46;2;0;44;0;0;0
201500509;200;183;183;7;127;72;1;127;2;0;125;0;0;0
201500510;300;300;300;6;76;299;1;0;0;0;0;76;0;76
201500511;100;74;74;6;48;51;1;48;3;0;45;0;0;0
201500512;610;607;608;7;147;609;1;0;0;0;0;147;0;147
201500513;610;602;603;3;138;609;1;0;0;0;0;138;1;137
203100101;500;488;497;7;209;499;1;0;0;0;0;209;3;206
203100102;500;460;460;8;220;499;1;0;0;0;0;220;2;218
203100103;500;512;513;6;238;499;1;0;0;0;0;238;1;237
203100104;500;556;555;8;273;500;0;0;0;0;0;273;6;267
203100105;500;478;478;9;189;499;1;0;0;0;0;189;0;189
203100106;500;456;457;5;227;499;1;0;0;0;0;227;4;223
203100107;500;444;445;8;210;499;1;0;0;0;0;210;2;208
203100108;700;645;645;5;280;699;1;0;0;0;0;280;6;274
203100109;500;489;490;8;223;499;1;0;0;0;0;223;3;220
203100110;700;643;647;9;311;699;1;0;0;0;0;311;3;308
203100111;600;627;632;9;293;599;1;0;0;0;0;293;4;289
203100112;700;727;731;6;300;699;1;0;0;0;0;300;2;298
203100113;500;508;511;9;210;499;1;0;0;0;0;210;1;209
203100114;500;584;586;9;242;499;1;0;0;0;0;242;3;239
203100115;900;869;874;8;324;899;1;0;0;0;0;324;3;321
203100116;500;507;509;6;212;499;1;0;0;0;0;212;1;211
203100117;700;649;653;7;271;699;1;0;0;0;0;271;3;268
203100118;900;883;885;8;332;899;1;0;0;0;0;332;4;328
203100119;700;658;660;4;304;700;0;0;0;0;0;304;7;297
203100120;600;516;516;8;225;599;1;0;0;0;0;225;3;222
203100121;600;502;505;9;196;599;1;0;0;0;0;196;3;193
203100122;500;538;545;4;170;499;1;0;0;0;0;170;3;167
203100123;900;956;960;2;278;620;2;278;16;1;261;0;0;0
203100124;600;576;580;9;259;599;1;0;0;0;0;259;3;256
203100125;500;480;482;8;190;499;1;0;0;0;0;190;1;189
203100126;600;566;568;4;238;599;1;0;0;0;0;238;3;235
203100127;600;663;664;6;289;599;1;0;0;0;0;289;4;285
203100128;500;498;499;7;214;499;1;0;0;0;0;214;0;214
203100129;700;657;657;9;324;699;1;0;0;0;0;324;3;321
203100130;700;675;680;7;300;699;1;0;0;0;0;300;3;297
203100131;700;694;696;5;291;699;1;0;0;0;0;291;3;288
203100132;800;804;807;10;362;799;1;0;0;0;0;362;6;356
203100133;800;840;841;3;351;799;1;0;0;0;0;351;7;344
203100134;500;448;449;6;198;499;1;0;0;0;0;198;3;195
203100135;500;512;513;5;175;499;1;0;0;0;0;175;2;173
203100136;500;545;545;7;188;499;1;0;0;0;0;188;3;185
203100137;700;677;677;3;142;699;1;0;0;0;0;142;2;140
203100138;800;748;754;8;282;799;1;0;0;0;0;282;2;280
203100139;700;711;711;8;195;699;1;0;0;0;0;195;0;195
203100140;600;614;614;8;139;599;1;0;0;0;0;139;3;136
203100141;600;601;601;7;213;599;1;0;0;0;0;213;4;209
203100142;500;473;474;6;134;499;1;0;0;0;0;134;0;134
203100143;700;721;725;10;326;699;1;0;0;0;0;326;2;324
203100144;800;830;835;4;394;800;0;0;0;0;0;394;7;387
203100145;800;837;838;8;362;799;1;0;0;0;0;362;4;358
203100146;800;829;834;2;317;799;1;0;0;0;0;317;4;313
203100147;700;705;705;8;323;699;1;0;0;0;0;323;6;317
203100148;500;448;450;6;208;499;1;0;0;0;0;208;3;205
203100149;600;544;547;0;233;599;1;0;0;0;0;233;4;229
203100150;500;518;521;7;254;499;1;0;0;0;0;254;5;249
203100151;700;674;677;0;297;699;1;0;0;0;0;297;3;294
203100152;500;443;444;5;212;499;1;0;0;0;0;212;6;206
203100153;600;547;547;8;247;597;1;2;0;0;2;245;4;241
203100154;600;588;589;10;165;599;1;0;0;0;0;165;1;164
203100155;700;720;723;7;327;699;1;0;0;0;0;327;4;323
203100156;100;25;25;56;73;26;1;73;2;2;69;0;0;0
203100157;200;97;56;9;69;129;2;69;4;0;65;0;0;0
203100158;500;466;468;6;192;499;1;0;0;0;0;192;3;189
203100159;500;501;502;0;193;309;1;190;8;2;180;3;0;3
203100160;600;629;631;0;236;599;1;0;0;0;0;236;2;234
203100161;500;517;517;7;154;499;1;0;0;0;0;154;0;154
203100162;600;529;529;0;164;599;1;0;0;0;0;164;1;163
203100163;700;667;667;5;247;699;1;0;0;0;0;247;5;242
203100164;700;717;721;5;318;699;1;0;0;0;0;318;8;310
203100165;500;505;512;7;224;499;1;0;0;0;0;224;4;220
203100166;400;440;441;1;173;399;1;0;0;0;0;173;2;171
203100167;500;457;457;7;201;499;1;0;0;0;0;201;3;198
203100168;200;103;96;0;66;133;1;66;8;0;58;0;0;0
203100169;300;375;379;4;212;299;1;0;0;0;0;212;0;212
203100170;100;59;57;2;49;49;2;49;0;1;48;0;0;0
203100171;500;499;499;9;191;499;1;0;0;0;0;191;0;191
203100172;500;511;511;2;186;499;1;0;0;0;0;186;0;186
203100173;100;82;56;5;57;42;1;57;1;0;56;0;0;0
203100174;200;179;183;7;123;76;1;123;1;1;121;0;0;0
203100175;100;45;45;5;37;62;1;37;1;1;35;0;0;0
203100176;500;533;533;4;209;500;0;0;0;0;0;209;0;209
203100177;700;626;631;0;280;699;1;0;0;0;0;280;1;279
203100178;700;681;684;3;315;699;1;0;0;0;0;315;2;313
203100179;500;479;480;3;207;499;1;0;0;0;0;207;1;206
203100180;600;537;540;6;255;599;1;0;0;0;0;255;2;253
203100181;700;662;663;7;93;699;1;0;0;0;0;93;1;92
203100182;500;529;529;4;207;499;1;0;0;0;0;207;5;202
203100183;200;92;92;3;67;132;1;67;1;0;66;0;0;0
203100184;100;37;37;6;33;66;1;33;0;0;33;0;0;0
203100185;100;82;81;5;62;37;1;62;0;0;62;0;0;0
203100186;500;547;550;1;223;499;1;0;0;0;0;223;1;222
203100187;500;509;514;3;251;499;1;0;0;0;0;251;2;249
203100188;100;49;49;5;40;59;1;40;2;1;37;0;0;0
203100189;300;292;292;4;153;144;3;153;3;2;148;0;0;0
203100190;200;163;160;7;106;93;1;106;4;1;101;0;0;0
203100191;400;497;497;3;236;399;1;0;0;0;0;236;1;235
203100192;100;24;24;7;21;78;1;21;0;0;21;0;0;0
203100193;50;40;40;0;40;10;0;40;1;0;39;0;0;0
203100194;50;36;36;0;34;16;0;34;0;0;34;0;0;0
203200601;700;632;634;5;300;699;1;0;0;0;0;300;10;290
203200602;500;457;457;5;171;499;1;0;0;0;0;171;2;169
203200603;300;243;244;3;111;188;1;111;3;0;108;0;0;0
203200604;300;338;344;5;181;299;1;0;0;0;0;181;0;181
203200605;100;49;49;5;45;54;1;45;0;1;44;0;0;0
203200606;600;578;578;6;218;599;1;0;0;0;0;218;1;217
203200607;800;715;717;6;248;799;1;0;0;0;0;248;2;246
203200608;800;805;806;8;269;799;1;0;0;0;0;269;0;269
203200609;600;577;587;6;305;599;1;0;0;0;0;305;0;305
203200610;100;72;72;9;42;57;1;42;0;1;41;0;0;0
203200611;100;100;100;4;64;34;2;64;2;0;62;0;0;0
203200612;400;441;445;3;170;399;1;0;0;0;0;170;0;170
203200613;100;75;75;6;42;53;5;42;4;0;38;0;0;0
203200614;100;26;26;0;25;74;1;25;0;0;25;0;0;0
203400701;566;566;567;8;244;565;1;0;0;0;0;244;4;240
203400702;800;742;747;9;334;799;1;0;0;0;0;334;3;331
203400703;900;912;925;6;344;899;1;0;0;0;0;344;1;343
203400704;900;873;878;1;355;899;1;0;0;0;0;355;7;348
203400705;800;807;808;6;345;799;1;0;0;0;0;345;3;342
203400706;900;876;877;4;395;899;1;0;0;0;0;395;5;390
203400707;700;760;760;8;329;699;1;0;0;0;0;329;2;327
203400708;800;823;824;4;331;799;1;0;0;0;0;331;2;329
203400709;800;828;828;6;321;799;1;0;0;0;0;321;4;317
203400710;1000;1041;1041;9;395;999;1;0;0;0;0;395;0;395
203400711;500;465;467;2;213;499;1;0;0;0;0;213;1;212
203400712;500;547;547;4;203;499;1;0;0;0;0;203;1;202
203400713;900;934;939;6;270;899;1;0;0;0;0;270;0;270
203400714;100;39;39;7;32;67;1;32;2;0;30;0;0;0
203400715;500;590;591;2;227;499;1;0;0;0;0;227;1;226
203400716;300;254;254;4;140;154;6;140;4;2;134;0;0;0
203400717;300;302;303;1;124;299;1;0;0;0;0;124;3;121
203400718;400;408;408;1;181;399;1;0;0;0;0;181;2;179
203400719;400;440;442;4;187;399;1;0;0;0;0;187;2;185
203400720;300;238;238;0;111;186;3;111;1;0;110;0;0;0
203400721;100;63;63;9;42;56;2;42;1;0;41;0;0;0
203400722;500;495;495;3;243;499;1;0;0;0;0;243;2;241
203400723;700;772;772;4;464;699;1;0;0;0;0;464;1;463
203400724;400;387;389;5;213;399;1;0;0;0;0;213;0;213
203400725;100;27;27;6;10;89;1;10;0;0;10;0;0;0
203400726;100;43;43;5;36;63;1;36;1;2;33;0;0;0
203400727;100;29;29;31;37;62;1;37;2;0;35;0;0;0
203400728;100;43;43;6;47;49;4;47;3;0;44;0;0;0
211100001;200;108;108;5;75;124;1;75;2;1;72;0;0;0
211100003;900;189;863;8;197;900;0;0;0;0;0;197;1;196
211100004;907;907;907;6;162;907;0;0;0;0;0;162;0;162
211100005;900;880;880;7;128;900;0;0;0;0;0;128;1;127
211100006;800;806;806;7;106;800;0;0;0;0;0;106;0;106
211100007;100;20;20;6;16;83;1;16;1;1;14;0;0;0
211100008;500;333;333;4;151;499;1;0;0;0;0;151;4;147
211100010;500;415;415;5;225;499;1;0;0;0;0;225;0;225
211100011;800;743;744;8;282;799;1;0;0;0;0;282;4;278
211100012;800;765;766;4;271;799;1;0;0;0;0;271;3;268
211100013;800;803;804;7;272;799;1;0;0;0;0;272;3;269
211100014;900;910;914;1;220;899;1;0;0;0;0;220;2;218
211100015;800;758;758;1;243;799;1;0;0;0;0;243;1;242
211100016;1000;967;967;0;186;999;1;0;0;0;0;186;1;185
211100017;700;726;727;6;256;699;1;0;0;0;0;256;0;256
211100018;200;117;117;5;70;129;1;70;2;3;65;0;0;0
211100019;700;667;667;6;257;699;1;0;0;0;0;257;0;257
211100020;300;232;232;6;122;177;1;122;2;2;118;0;0;0
211100021;400;252;253;5;108;291;1;108;5;1;102;0;0;0
211100022;400;301;301;11;80;400;0;0;0;0;0;80;1;79
211100023;500;412;412;3;140;500;0;0;0;0;0;140;0;140
211100025;600;633;633;7;246;599;1;0;0;0;0;246;1;245
211100026;500;406;406;6;146;500;0;0;0;0;0;146;1;145
211100027;1000;985;985;6;404;999;1;0;0;0;0;404;0;404
211100028;300;219;219;5;52;245;3;52;2;2;48;0;0;0
211100029;900;911;911;9;296;899;1;0;0;0;0;296;2;294
211100030;900;946;946;11;238;899;1;0;0;0;0;238;1;237
211100031;900;937;937;6;177;899;1;0;0;0;0;177;1;176
211100032;900;956;957;3;218;899;1;0;0;0;0;218;1;217
211100033;900;907;908;6;263;899;1;0;0;0;0;263;0;263
211600001;400;422;422;9;178;400;0;0;0;0;0;178;0;178
211600002;700;796;796;6;339;699;1;0;0;0;0;339;7;332
211600003;700;780;780;5;319;699;1;0;0;0;0;319;4;315
211600004;700;835;835;4;349;699;1;0;0;0;0;349;5;344
211600005;600;653;653;0;284;599;1;0;0;0;0;284;4;280
211600006;700;677;679;6;248;700;0;0;0;0;0;248;6;242
211600007;500;513;513;6;166;499;1;0;0;0;0;166;2;164
211600008;700;731;731;11;153;699;1;0;0;0;0;153;0;153
211600009;700;753;754;8;41;699;1;0;0;0;0;41;0;41
211600010;800;949;949;1;27;799;1;0;0;0;0;27;0;27
211600011;800;1004;1004;5;54;800;0;0;0;0;0;54;0;54
211600012;600;681;681;1;33;599;1;0;0;0;0;33;0;33
211600013;500;573;574;0;26;499;1;0;0;0;0;26;0;26
211600014;700;852;853;0;59;699;1;0;0;0;0;59;0;59
211600015;800;899;899;0;40;799;1;0;0;0;0;40;0;40
211600016;800;908;908;0;48;799;1;0;0;0;0;48;0;48
211600017;600;596;596;1;204;599;1;0;0;0;0;204;3;201
211600018;700;706;707;7;284;699;1;0;0;0;0;284;5;279
211600019;400;406;406;5;171;399;1;0;0;0;0;171;2;169
211600020;400;391;391;6;154;399;1;0;0;0;0;154;0;154
211600021;600;636;637;5;298;599;1;0;0;0;0;298;6;292
211600022;500;529;529;2;245;499;1;0;0;0;0;245;3;242
211600023;600;650;650;6;275;599;1;0;0;0;0;275;2;273
211600024;500;536;537;10;238;499;1;0;0;0;0;238;3;235
211600025;700;812;813;5;315;700;0;0;0;0;0;315;4;311
211600026;600;602;602;3;249;599;1;0;0;0;0;249;1;248
211600027;700;749;750;1;330;699;1;0;0;0;0;330;7;323
211600028;700;744;744;0;366;699;1;0;0;0;0;366;6;360
211600029;600;602;603;5;233;600;0;0;0;0;0;233;3;230
211600030;700;705;706;3;221;699;1;0;0;0;0;221;2;219
211600031;700;771;772;6;272;699;1;0;0;0;0;272;0;272
211600032;500;497;497;3;219;499;1;0;0;0;0;219;1;218
211600033;300;270;270;6;111;187;2;111;1;2;108;0;0;0
211600034;600;646;647;9;206;600;0;0;0;0;0;206;1;205
211600035;100;41;41;7;46;53;1;46;1;0;45;0;0;0
211600036;700;574;574;0;212;699;1;0;0;0;0;212;0;212
211600037;600;514;554;7;136;599;1;0;0;0;0;136;2;134
211600038;700;675;676;3;348;699;1;0;0;0;0;348;2;346
211600039;200;156;156;6;108;91;1;108;4;1;103;0;0;0
211600040;300;334;336;3;239;60;1;239;10;3;226;0;0;0
211600041;200;103;103;5;58;141;1;58;3;0;55;0;0;0
211600042;400;413;413;6;129;399;1;0;0;0;0;129;2;127
211600043;700;643;646;4;265;699;1;0;0;0;0;265;2;263
211600044;300;340;340;6;158;300;0;0;0;0;0;158;3;155
211600045;300;300;301;3;101;198;1;101;8;1;92;0;0;0
211600046;300;247;247;4;100;199;1;100;1;2;97;0;0;0
211600047;200;225;225;5;119;79;2;119;3;1;115;0;0;0
211600048;100;93;94;3;55;44;1;55;1;0;54;0;0;0
211600049;400;359;360;4;163;399;1;0;0;0;0;163;1;162
211600050;200;130;130;7;63;136;1;63;1;1;61;0;0;0
211600051;200;135;135;2;89;110;1;89;0;3;86;0;0;0
211600052;500;491;493;4;246;499;1;0;0;0;0;246;0;246
211600053;200;114;114;6;67;133;0;67;0;0;67;0;0;0
211600054;300;250;251;5;105;194;1;105;1;2;102;0;0;0
211600055;300;272;273;4;116;183;1;116;3;1;112;0;0;0
211600056;300;309;310;6;166;132;2;166;5;5;156;0;0;0
211600057;500;484;485;4;192;500;0;0;0;0;0;192;0;192
211600058;300;349;349;4;85;300;0;0;0;0;0;85;1;84
211600059;300;254;254;1;103;196;1;103;2;2;99;0;0;0
211600060;500;610;610;4;232;499;1;0;0;0;0;232;1;231
211600061;300;308;308;5;110;189;1;110;9;6;95;0;0;0
211600062;200;235;235;3;151;48;1;151;6;0;145;0;0;0
211600063;300;298;298;2;142;157;1;142;3;1;138;0;0;0
212000001;600;579;581;4;198;599;1;0;0;0;0;198;2;196
212000002;700;743;743;6;243;699;1;0;0;0;0;243;3;240
212000003;600;575;577;6;216;599;1;0;0;0;0;216;8;208
212000004;700;647;649;4;270;699;1;0;0;0;0;270;2;268
212000005;600;628;628;2;216;599;1;0;0;0;0;216;1;215
212000006;800;829;830;3;264;799;1;0;0;0;0;264;3;261
212000007;700;676;677;5;248;699;1;0;0;0;0;248;6;242
212000008;600;649;649;0;205;599;1;0;0;0;0;205;1;204
212000009;700;688;689;4;231;699;1;0;0;0;0;231;6;225
212000010;500;443;447;7;144;499;1;0;0;0;0;144;1;143
212000011;500;524;526;0;190;499;1;0;0;0;0;190;1;189
212000012;700;691;692;2;205;699;1;0;0;0;0;205;1;204
212000013;400;418;418;8;156;399;1;0;0;0;0;156;0;156
212000014;500;537;537;5;197;499;1;0;0;0;0;197;5;192
212000015;400;397;397;4;146;398;2;0;0;0;0;146;1;145
212000016;600;567;567;5;170;599;1;0;0;0;0;170;2;168
212000017;700;737;740;11;309;699;1;0;0;0;0;309;3;306
212000018;500;546;546;7;228;499;1;0;0;0;0;228;0;228
212000019;400;441;443;4;128;400;0;0;0;0;0;128;1;127
212000020;700;679;679;6;99;699;1;0;0;0;0;99;0;99
212000021;900;894;894;7;101;899;1;0;0;0;0;101;0;101
212000022;700;660;662;6;146;699;1;0;0;0;0;146;3;143
212000023;700;699;701;4;203;699;1;0;0;0;0;203;1;202
212000024;600;611;611;5;273;599;1;0;0;0;0;273;1;272
212000025;500;526;526;8;216;499;1;0;0;0;0;216;3;213
212000026;700;719;720;9;326;699;1;0;0;0;0;326;5;321
212000027;500;526;526;6;214;499;1;0;0;0;0;214;5;209
212000028;500;482;482;1;198;499;1;0;0;0;0;198;5;193
212000029;900;846;847;4;392;899;1;0;0;0;0;392;1;391
212000030;600;623;625;6;282;599;1;0;0;0;0;282;6;276
212000031;700;668;671;6;279;699;1;0;0;0;0;279;1;278
212000032;600;644;646;5;279;599;1;0;0;0;0;279;3;276
212000033;900;907;907;2;382;899;1;0;0;0;0;382;3;379
212000034;500;529;534;7;266;499;1;0;0;0;0;266;3;263
212000035;500;460;463;4;221;499;1;0;0;0;0;221;2;219
212000036;700;695;697;7;318;699;1;0;0;0;0;318;5;313
212000037;500;520;520;7;227;499;1;0;0;0;0;227;3;224
212000038;500;491;492;9;244;499;1;0;0;0;0;244;2;242
212000039;600;572;573;6;261;599;1;0;0;0;0;261;5;256
212000040;600;561;561;3;239;599;1;0;0;0;0;239;4;235
212000041;600;569;570;7;241;599;1;0;0;0;0;241;2;239
212000042;500;531;532;6;105;499;1;0;0;0;0;105;0;105
212000043;600;622;625;8;249;599;1;0;0;0;0;249;5;244
212000044;400;440;440;6;156;399;1;0;0;0;0;156;1;155
212000045;500;553;557;3;188;499;1;0;0;0;0;188;2;186
212000046;500;457;457;7;168;499;1;0;0;0;0;168;0;168
212000047;700;709;712;7;277;699;1;0;0;0;0;277;2;275
212000048;600;565;566;4;201;599;1;0;0;0;0;201;1;200
212000049;600;643;647;1;203;599;1;0;0;0;0;203;2;201
212000050;800;754;754;6;240;799;1;0;0;0;0;240;4;236
212000051;600;627;627;6;236;600;0;0;0;0;0;236;1;235
212000052;500;468;465;3;171;499;1;0;0;0;0;171;0;171
212000053;700;725;727;7;316;700;0;0;0;0;0;316;1;315
212000054;500;514;514;8;210;499;1;0;0;0;0;210;2;208
212000055;600;605;610;3;185;599;1;0;0;0;0;185;2;183
212000056;700;694;694;2;214;699;1;0;0;0;0;214;1;213
212000057;1000;967;968;10;314;1000;0;0;0;0;0;314;7;307
212000058;700;668;668;5;219;699;1;0;0;0;0;219;2;217
212000059;800;798;799;2;273;799;1;0;0;0;0;273;4;269
212000060;700;691;692;4;231;699;1;0;0;0;0;231;2;229
212000061;600;638;638;5;233;599;1;0;0;0;0;233;7;226
212000062;700;673;675;6;252;699;1;0;0;0;0;252;2;250
212000063;800;802;805;5;267;799;1;0;0;0;0;267;2;265
212000064;800;736;737;11;253;799;1;0;0;0;0;253;2;251
212000065;600;551;553;8;171;599;1;0;0;0;0;171;3;168
212000066;800;715;753;5;224;799;1;0;0;0;0;224;3;221
212000067;700;652;655;3;218;699;1;0;0;0;0;218;5;213
212000068;800;804;805;3;305;799;1;0;0;0;0;305;4;301
212000069;700;694;696;3;218;699;1;0;0;0;0;218;5;213
212000070;700;702;705;2;224;699;1;0;0;0;0;224;5;219
212000071;700;683;684;5;262;699;1;0;0;0;0;262;4;258
212000072;600;604;605;5;240;599;1;0;0;0;0;240;2;238
212000073;600;609;610;4;234;599;1;0;0;0;0;234;4;230
212000074;500;502;502;4;216;499;1;0;0;0;0;216;0;216
212000075;600;586;588;8;210;599;1;0;0;0;0;210;2;208
212000076;800;751;751;7;259;799;1;0;0;0;0;259;2;257
212000077;800;812;814;2;323;799;1;0;0;0;0;323;3;320
212000078;700;689;689;8;238;699;1;0;0;0;0;238;5;233
212000079;800;755;756;5;289;799;1;0;0;0;0;289;6;283
212000080;600;588;590;3;156;599;1;0;0;0;0;156;10;146
212000081;600;570;572;2;230;599;1;0;0;0;0;230;9;221
212000082;600;553;555;6;194;599;1;0;0;0;0;194;2;192
212000083;500;458;458;13;188;499;1;0;0;0;0;188;3;185
212000084;500;522;523;4;167;499;1;0;0;0;0;167;3;164
212000085;900;912;914;7;309;622;2;276;4;6;266;33;0;33
212000086;600;595;595;6;173;599;1;0;0;0;0;173;3;170
212000087;700;715;716;4;217;699;1;0;0;0;0;217;4;213
212000088;800;756;757;5;236;799;1;0;0;0;0;236;6;230
212000089;800;754;754;6;207;799;1;0;0;0;0;207;0;207
212000090;800;797;798;6;258;799;1;0;0;0;0;258;3;255
212000091;600;619;621;6;236;599;1;0;0;0;0;236;2;234
212000092;700;714;714;2;280;699;1;0;0;0;0;280;1;279
212000093;500;538;541;8;180;499;1;0;0;0;0;180;1;179
212000094;400;403;403;4;148;399;1;0;0;0;0;148;2;146
212000095;500;499;500;1;199;499;1;0;0;0;0;199;3;196
212000096;500;473;474;3;172;499;1;0;0;0;0;172;4;168
212000097;600;619;620;5;277;599;1;0;0;0;0;277;5;272
212000098;400;423;425;5;181;400;0;0;0;0;0;181;4;177
212000099;600;586;586;4;226;599;1;0;0;0;0;226;3;223
212000100;600;636;636;6;244;599;1;0;0;0;0;244;3;241
212000101;700;689;691;7;288;699;1;0;0;0;0;288;1;287
212000102;700;698;698;0;265;699;1;0;0;0;0;265;5;260
212000103;700;662;664;4;241;699;1;0;0;0;0;241;4;237
212000104;400;432;432;2;132;399;1;0;0;0;0;132;4;128
212000105;500;490;491;7;153;499;1;0;0;0;0;153;0;153
212000106;400;391;390;10;165;399;1;0;0;0;0;165;3;162
212000107;500;461;461;2;169;499;1;0;0;0;0;169;1;168
212000108;800;798;799;7;285;799;1;0;0;0;0;285;0;285
212000109;600;603;604;4;262;599;1;0;0;0;0;262;5;257
212000110;600;641;644;1;248;599;1;0;0;0;0;248;3;245
212000111;500;505;509;6;190;499;1;0;0;0;0;190;1;189
212000112;500;538;542;6;164;499;1;0;0;0;0;164;1;163
212000113;1000;1025;1026;7;64;1000;0;0;0;0;0;64;0;64
212000114;900;950;953;7;80;899;1;0;0;0;0;80;0;80
212000115;900;950;950;5;31;900;0;0;0;0;0;31;0;31
212000116;1000;1044;1047;7;43;999;1;0;0;0;0;43;1;42
212000117;1000;1067;1069;12;46;999;1;0;0;0;0;46;0;46
212000118;1000;1034;1036;8;35;999;1;0;0;0;0;35;0;35
212000119;1200;1254;1256;6;97;1199;1;0;0;0;0;97;1;96
212000120;1200;1241;1244;7;79;1199;1;0;0;0;0;79;1;78
212000121;600;596;600;4;178;599;1;0;0;0;0;178;2;176
212000122;800;809;809;4;296;800;0;0;0;0;0;296;3;293
212000123;900;906;906;0;103;899;1;0;0;0;0;103;0;103
212000124;700;721;721;5;216;699;1;0;0;0;0;216;2;214
212000125;817;289;817;4;293;816;1;0;0;0;0;293;0;293
212000126;500;536;537;7;134;499;1;0;0;0;0;134;2;132
212000127;800;797;801;9;157;799;1;0;0;0;0;157;1;156
212000128;800;818;818;0;30;799;1;0;0;0;0;30;0;30
212000129;100;115;115;5;69;30;1;69;4;0;65;0;0;0
212000130;100;25;25;7;16;83;1;16;0;0;16;0;0;0
212000131;400;414;417;2;195;399;1;0;0;0;0;195;0;195
212000132;100;81;81;5;45;54;1;45;0;0;45;0;0;0
212000133;200;83;193;4;87;112;1;87;6;0;81;0;0;0
212000134;200;127;127;6;52;147;1;52;0;0;52;0;0;0
212000136;500;523;524;6;161;499;1;0;0;0;0;161;0;161
212000137;800;864;864;5;227;800;0;0;0;0;0;227;0;227
212000138;100;80;80;6;25;74;1;25;1;0;24;0;0;0
212000139;400;441;443;0;208;399;1;0;0;0;0;208;0;208
212000140;400;440;442;5;186;399;1;0;0;0;0;186;2;184
212000141;1000;963;965;5;397;999;1;0;0;0;0;397;0;397
212000142;300;267;267;6;160;139;1;160;3;0;157;0;0;0
212000143;200;130;130;5;79;120;1;79;4;0;75;0;0;0
212000144;400;381;382;4;189;399;1;0;0;0;0;189;3;186
212000145;500;490;492;4;174;499;1;0;0;0;0;174;6;168
212000146;700;692;692;4;241;699;1;0;0;0;0;241;1;240
212000147;400;454;454;3;174;399;1;0;0;0;0;174;1;173
212000148;200;115;116;6;82;117;1;82;1;1;80;0;0;0
212000149;300;216;216;7;130;169;1;130;13;1;116;0;0;0
212000150;200;164;166;4;88;111;1;88;1;0;87;0;0;0
212000151;900;917;917;6;226;899;1;0;0;0;0;226;1;225
212000152;600;626;627;4;297;599;1;0;0;0;0;297;2;295
212000153;400;485;489;4;212;400;0;0;0;0;0;212;2;210
212000154;300;248;250;6;121;178;1;121;1;3;117;0;0;0
212000155;300;261;261;2;152;147;1;152;3;2;147;0;0;0
212000156;400;554;554;4;220;399;1;0;0;0;0;220;0;220
212000157;200;132;132;4;61;138;1;61;3;1;57;0;0;0
212000158;100;47;47;8;32;67;1;32;2;0;30;0;0;0
212000159;300;252;252;4;123;176;1;123;10;0;113;0;0;0
212000160;500;546;546;2;266;499;1;0;0;0;0;266;3;263
212000161;300;374;375;1;200;299;1;0;0;0;0;200;0;200
212000162;500;493;494;0;208;499;1;0;0;0;0;208;2;206
212000163;300;327;327;4;137;299;1;0;0;0;0;137;3;134
212000164;400;483;483;4;129;399;1;0;0;0;0;129;0;129
212000165;900;944;944;5;183;899;1;0;0;0;0;183;3;180
212000166;800;786;786;5;327;799;1;0;0;0;0;327;2;325
212000167;600;634;634;4;223;599;1;0;0;0;0;223;0;223
212000168;800;819;819;6;113;800;0;0;0;0;0;113;0;113
212000169;700;746;749;3;250;700;0;0;0;0;0;250;5;245
212000170;1000;970;970;6;411;1000;0;0;0;0;0;411;4;407
212000171;500;497;501;8;173;499;1;0;0;0;0;173;0;173
212000172;600;619;623;2;232;599;1;0;0;0;0;232;1;231
212000173;600;677;684;0;251;599;1;0;0;0;0;251;0;251
212000174;800;824;824;1;81;796;4;0;0;0;0;81;0;81
212000175;700;724;722;3;158;699;1;0;0;0;0;158;1;157
212000176;700;695;696;7;239;700;0;0;0;0;0;239;1;238
212000177;500;542;542;2;209;499;1;0;0;0;0;209;4;205
212000178;300;297;297;4;177;121;2;177;3;1;173;0;0;0
212000179;600;581;581;5;190;600;0;0;0;0;0;190;2;188
212000180;400;427;427;5;183;400;0;0;0;0;0;183;2;181
212000181;300;292;293;3;156;143;1;156;9;0;147;0;0;0
212000182;400;445;446;7;86;399;1;0;0;0;0;86;0;86
212000183;100;56;56;7;55;45;0;55;1;0;54;0;0;0
212000184;100;30;30;33;61;38;1;61;3;2;56;0;0;0
212000185;100;19;19;7;18;81;1;18;2;0;16;0;0;0
212000186;100;38;38;22;48;51;1;48;0;2;46;0;0;0
212000187;100;94;94;13;68;31;1;68;14;0;54;0;0;0
212000188;100;10;10;72;75;24;1;75;3;2;70;0;0;0
212400001;500;544;544;5;186;499;1;0;0;0;0;186;3;183
212400002;700;724;724;6;237;699;1;0;0;0;0;237;8;229
212400003;600;590;590;5;253;599;1;0;0;0;0;253;5;248
212400004;600;682;683;5;273;599;1;0;0;0;0;273;3;270
212400005;800;818;821;7;178;799;1;0;0;0;0;178;1;177
212400006;700;753;753;6;176;699;1;0;0;0;0;176;0;176
212400007;600;668;669;3;261;599;1;0;0;0;0;261;0;261
212400008;500;471;471;4;172;499;1;0;0;0;0;172;1;171
212400009;600;659;659;0;213;600;0;0;0;0;0;213;2;211
212400010;800;811;813;4;116;799;1;0;0;0;0;116;0;116
212400011;800;863;864;3;316;799;1;0;0;0;0;316;3;313
212400012;600;595;596;0;85;599;1;0;0;0;0;85;8;77
212400013;700;718;719;2;160;699;1;0;0;0;0;160;1;159
212400014;900;912;913;2;283;899;1;0;0;0;0;283;5;278
212400015;200;133;133;7;76;123;1;76;6;1;69;0;0;0
212400016;100;66;66;7;56;43;1;56;0;0;56;0;0;0
212400018;400;418;418;3;146;399;1;0;0;0;0;146;1;145
212400019;400;392;392;6;141;399;1;0;0;0;0;141;0;141
212400020;900;911;911;8;277;900;0;0;0;0;0;277;0;277
220200001;500;560;560;1;307;499;1;0;0;0;0;307;4;303
220200002;300;246;252;0;112;186;2;112;5;1;106;0;0;0
220200003;400;453;466;3;214;399;1;0;0;0;0;214;3;211
220200004;300;198;216;1;128;171;1;128;3;1;124;0;0;0
220200005;400;389;391;3;164;399;1;0;0;0;0;164;0;164
220200006;100;28;28;6;26;73;1;26;0;0;26;0;0;0
220200007;300;206;206;1;126;173;1;126;3;0;123;0;0;0
220200008;200;162;173;3;97;102;1;97;1;0;96;0;0;0
220200009;100;47;48;1;28;71;1;28;0;0;28;0;0;0
220200010;300;213;213;2;92;207;1;92;2;1;89;0;0;0
220200011;300;276;279;3;125;173;2;125;1;4;120;0;0;0
220200012;300;235;246;1;141;158;1;141;3;1;137;0;0;0
220200013;100;32;32;5;24;75;1;24;0;0;24;0;0;0
220200014;300;277;280;1;129;169;2;129;1;0;128;0;0;0
220200015;100;47;47;7;30;69;1;30;0;0;30;0;0;0
220200016;100;78;78;1;46;53;1;46;1;0;45;0;0;0
220200017;100;120;120;5;61;38;1;61;1;0;60;0;0;0
220200018;100;28;28;1;29;70;1;29;1;0;28;0;0;0
220200019;100;30;30;1;30;69;1;30;1;0;29;0;0;0
220200020;100;20;20;1;20;79;1;20;0;0;20;0;0;0
220200021;100;16;16;4;19;81;0;19;2;0;17;0;0;0
220500001;700;733;768;1;391;699;1;0;0;0;0;391;2;389
220500002;700;751;773;1;414;699;1;0;0;0;0;414;0;414
220500003;700;763;797;3;407;700;0;0;0;0;0;407;8;399
220500004;200;132;132;0;69;130;1;69;1;0;68;0;0;0
220500005;400;388;398;1;228;399;1;0;0;0;0;228;1;227
220500006;300;258;295;1;155;300;0;0;0;0;0;155;1;154
220500007;100;70;78;0;50;49;1;50;0;0;50;0;0;0
220500008;100;55;55;0;55;44;1;55;0;2;53;0;0;0
220500009;100;46;46;0;46;53;1;46;1;0;45;0;0;0
220500010;100;44;44;0;44;55;1;44;0;0;44;0;0;0
220900001;600;666;666;7;266;599;1;0;0;0;0;266;4;262
220900002;600;241;639;8;249;599;1;0;0;0;0;249;1;248
220900003;500;581;581;9;235;499;1;0;0;0;0;235;4;231
220900004;800;811;813;5;266;799;1;0;0;0;0;266;3;263
220900005;400;447;449;8;197;399;1;0;0;0;0;197;3;194
220900006;500;514;515;7;214;499;1;0;0;0;0;214;1;213
220900007;900;972;973;4;349;899;1;0;0;0;0;349;7;342
220900008;500;508;510;1;195;499;1;0;0;0;0;195;4;191
220900009;500;593;595;1;243;499;1;0;0;0;0;243;3;240
220900010;300;311;312;1;122;298;2;0;0;0;0;122;3;119
220900011;400;380;380;3;129;399;1;0;0;0;0;129;1;128
220900012;700;789;789;5;299;699;1;0;0;0;0;299;3;296
220900013;700;773;777;2;376;699;1;0;0;0;0;376;2;374
220900014;500;569;569;1;292;499;1;0;0;0;0;292;2;290
220900015;100;76;76;0;43;56;1;43;1;0;42;0;0;0
220900016;100;69;69;2;44;51;5;44;4;0;40;0;0;0
220900017;500;602;605;1;302;499;1;0;0;0;0;302;0;302
220900018;300;226;226;3;115;184;1;115;3;1;111;0;0;0
220900019;500;515;516;3;160;499;1;0;0;0;0;160;1;159
220900020;300;228;228;3;84;215;1;84;0;3;81;0;0;0
220900021;400;284;284;3;131;268;1;131;2;1;128;0;0;0
220900022;100;40;39;8;35;64;1;35;2;0;33;0;0;0
220900023;100;23;23;17;24;75;1;24;0;2;22;0;0;0
220900024;200;92;92;39;86;113;1;86;2;2;82;0;0;0
221000001;600;595;605;9;351;599;1;0;0;0;0;351;3;348
221000002;800;829;835;4;467;799;1;0;0;0;0;467;3;464
221000003;500;573;573;7;394;499;1;0;0;0;0;394;0;394
221000004;500;667;571;3;361;499;1;0;0;0;0;361;4;357
221000005;700;742;744;1;309;700;0;0;0;0;0;309;4;305
221000006;700;721;723;1;309;700;0;0;0;0;0;309;1;308
221000007;400;480;419;3;211;399;1;0;0;0;0;211;2;209
221000008;700;739;741;5;249;699;1;0;0;0;0;249;1;248
221000009;300;255;240;0;123;176;1;123;2;0;121;0;0;0
221000010;600;633;638;0;293;599;1;0;0;0;0;293;0;293
221000011;500;587;587;2;236;499;1;0;0;0;0;236;0;236
221000012;500;769;618;2;343;500;0;0;0;0;0;343;2;341
221000013;100;26;26;1;27;73;0;27;0;0;27;0;0;0
221100001;800;852;856;1;332;799;1;0;0;0;0;332;2;330
221100002;400;477;480;1;200;399;1;0;0;0;0;200;3;197
221100003;400;456;458;1;186;399;1;0;0;0;0;186;1;185
221100004;700;751;751;4;349;699;1;0;0;0;0;349;8;341
221100005;700;787;791;3;357;699;1;0;0;0;0;357;7;350
221100006;500;495;517;7;247;499;1;0;0;0;0;247;5;242
221100007;0;802;798;4;375;0;0;0;0;0;0;375;5;370
221100008;782;318;782;3;318;781;1;0;0;0;0;318;2;316
221100009;800;885;886;4;390;799;1;0;0;0;0;390;5;385
221100010;300;252;253;6;140;159;1;140;9;0;131;0;0;0
221100011;400;430;431;3;172;399;1;0;0;0;0;172;4;168
221100012;300;338;338;5;107;299;1;0;0;0;0;107;2;105
221100013;100;37;37;8;35;64;1;35;3;0;32;0;0;0
221100014;800;917;918;1;223;799;1;0;0;0;0;223;1;222
221100015;200;98;98;6;35;164;1;35;1;0;34;0;0;0
221100016;100;59;59;6;38;61;1;38;1;0;37;0;0;0
221100017;200;94;94;7;61;138;1;61;0;0;61;0;0;0
221100018;100;38;38;7;23;76;1;23;0;0;23;0;0;0
221100019;700;785;785;1;308;699;1;0;0;0;0;308;4;304
221100020;637;637;640;2;268;636;1;0;0;0;0;268;2;266
221100021;500;565;567;3;240;499;1;0;0;0;0;240;1;239
221100022;100;20;20;0;20;79;1;20;2;0;18;0;0;0
221600001;800;902;903;6;468;800;0;0;0;0;0;468;4;464
221600002;500;530;530;0;243;499;1;0;0;0;0;243;4;239
221600003;600;587;589;7;254;599;1;0;0;0;0;254;6;248
221600004;300;368;374;7;217;300;0;0;0;0;0;217;4;213
221600005;400;410;410;5;186;400;0;0;0;0;0;186;1;185
221600006;600;681;681;4;300;599;1;0;0;0;0;300;3;297
221600007;700;778;778;3;315;700;0;0;0;0;0;315;5;310
221600008;300;204;204;5;115;185;0;115;3;4;108;0;0;0
221600009;0;149;347;1;150;0;0;0;0;0;0;150;1;149
221600010;300;138;263;4;138;162;0;138;3;2;133;0;0;0
221600011;200;153;156;6;116;84;0;116;2;1;113;0;0;0
221600012;200;124;124;2;86;113;1;86;0;1;85;0;0;0
221600013;200;166;170;7;131;68;1;131;2;7;122;0;0;0
221600014;100;70;72;9;50;50;0;50;0;2;48;0;0;0
221600015;200;173;188;3;101;98;1;101;1;2;98;0;0;0
221600016;300;220;221;6;147;153;0;147;2;1;144;0;0;0
221600017;200;184;185;3;99;99;2;99;0;1;98;0;0;0
221600018;600;750;758;7;423;599;1;0;0;0;0;423;12;411
221600019;200;175;175;4;108;92;0;108;3;1;104;0;0;0
221600020;300;261;261;2;180;120;0;180;2;0;178;0;0;0
221600021;300;324;335;4;240;300;0;0;0;0;0;240;4;236
221600022;200;112;112;4;74;125;1;74;0;0;74;0;0;0
221600023;300;306;306;2;190;300;0;0;0;0;0;190;1;189
221600024;200;163;165;1;106;94;0;106;1;0;105;0;0;0
221600025;100;75;77;1;59;41;0;59;0;0;59;0;0;0
221600026;400;406;407;3;168;400;0;0;0;0;0;168;1;167
221600027;400;462;472;2;267;399;1;0;0;0;0;267;5;262
221600028;200;98;98;6;63;137;0;63;1;0;62;0;0;0
221600029;200;99;99;5;66;133;1;66;1;0;65;0;0;0
221600030;300;363;363;4;183;300;0;0;0;0;0;183;2;181
221600031;300;222;224;3;146;154;0;146;0;1;145;0;0;0
221600032;200;163;163;2;126;74;0;126;3;0;123;0;0;0
221600033;100;56;56;6;36;64;0;36;0;0;36;0;0;0
221600034;200;94;95;2;49;149;2;49;0;1;48;0;0;0
221600035;100;22;22;16;32;68;0;32;2;4;26;0;0;0
221600036;100;78;78;0;74;26;0;74;0;0;74;0;0;0
221800001;600;605;605;0;205;599;1;0;0;0;0;205;1;204
221800002;600;637;637;1;190;599;1;0;0;0;0;190;0;190
221800003;600;663;663;7;179;599;1;0;0;0;0;179;1;178
221800004;500;536;537;9;151;499;1;0;0;0;0;151;1;150
221800005;500;527;527;8;134;499;1;0;0;0;0;134;1;133
221800006;600;613;614;6;214;599;1;0;0;0;0;214;3;211
221800007;100;46;47;8;21;78;1;21;0;0;21;0;0;0
221800008;200;97;97;6;47;152;1;47;2;1;44;0;0;0
221800009;200;200;100;5;53;147;0;53;0;0;53;0;0;0
221800010;100;68;68;7;34;64;2;34;1;0;33;0;0;0
221800011;200;135;135;6;52;147;1;52;0;0;52;0;0;0
221800012;200;117;117;5;54;145;1;54;1;0;53;0;0;0
221800013;200;94;94;6;58;141;1;58;0;1;57;0;0;0
221800014;300;194;195;3;58;241;1;58;3;0;55;0;0;0
221800015;100;31;65;6;37;62;1;37;0;0;37;0;0;0
221800016;300;323;323;4;113;300;0;0;0;0;0;113;0;113
221800017;200;162;162;4;86;113;1;86;1;0;85;0;0;0
221800018;300;175;175;1;91;208;1;91;4;0;87;0;0;0
221800019;200;152;152;4;78;121;1;78;0;0;78;0;0;0
221800020;100;58;58;5;38;61;1;38;4;1;33;0;0;0
221800021;100;50;50;7;43;56;1;43;1;0;42;0;0;0
221800022;100;31;31;7;26;73;1;26;0;1;25;0;0;0
222700001;500;547;554;4;328;499;1;0;0;0;0;328;11;317
222700002;600;698;703;4;347;600;0;0;0;0;0;347;8;339
222700003;400;384;390;1;177;399;1;0;0;0;0;177;5;172
222700004;400;469;471;7;220;400;0;0;0;0;0;220;4;216
222700005;400;461;465;4;253;400;0;0;0;0;0;253;3;250
222700006;700;726;726;3;325;699;1;0;0;0;0;325;4;321
222700007;300;230;230;1;114;185;1;114;0;2;112;0;0;0
222700008;400;297;298;6;159;240;1;159;2;6;151;0;0;0
222700009;300;267;270;5;204;95;1;204;1;7;196;0;0;0
222700010;200;137;137;7;91;109;0;91;0;0;91;0;0;0
222700011;800;941;941;3;450;799;1;0;0;0;0;450;9;441
222700012;700;837;839;5;370;699;1;0;0;0;0;370;7;363
222700013;400;583;583;7;279;399;1;0;0;0;0;279;3;276
222700014;200;130;130;6;82;118;0;82;0;3;79;0;0;0
222700015;100;71;71;79;45;54;1;45;1;0;44;0;0;0
222700016;100;19;19;6;20;79;1;20;0;1;19;0;0;0
222700017;300;200;200;4;116;183;1;116;0;2;114;0;0;0
222700018;200;165;165;3;100;99;1;100;0;1;99;0;0;0
222700019;100;49;49;8;31;68;1;31;0;2;29;0;0;0
222700020;300;182;189;7;155;144;1;155;1;4;150;0;0;0
222700021;200;123;123;7;77;123;0;77;0;0;77;0;0;0
222700022;300;280;280;5;175;125;0;175;5;1;169;0;0;0
222700023;300;356;358;4;187;299;1;0;0;0;0;187;4;183
222700024;200;176;176;3;96;103;1;96;0;0;96;0;0;0
222700025;200;138;138;5;73;126;1;73;1;0;72;0;0;0
222700026;100;48;48;0;48;51;1;48;1;1;46;0;0;0
223100001;700;813;814;1;287;699;1;0;0;0;0;287;10;277
223100002;500;611;611;3;247;499;1;0;0;0;0;247;6;241
223100003;700;905;906;8;380;699;1;0;0;0;0;380;5;375
223100004;200;117;117;6;72;127;1;72;0;0;72;0;0;0
223100005;600;703;706;9;282;599;1;0;0;0;0;282;6;276
223100006;600;672;672;5;317;599;1;0;0;0;0;317;3;314
223100007;400;448;449;7;211;399;1;0;0;0;0;211;3;208
223100008;500;605;605;7;302;499;1;0;0;0;0;302;3;299
223100009;500;525;525;10;253;499;1;0;0;0;0;253;1;252
223100010;600;643;643;8;255;599;1;0;0;0;0;255;1;254
223100011;700;847;848;8;288;699;1;0;0;0;0;288;3;285
223100012;500;560;562;11;255;499;1;0;0;0;0;255;7;248
223100013;500;498;499;10;240;499;1;0;0;0;0;240;3;237
223100014;700;866;868;7;373;699;1;0;0;0;0;373;13;360
223100015;600;622;622;7;246;599;1;0;0;0;0;246;6;240
223100016;600;676;676;8;303;599;1;0;0;0;0;303;3;300
223100017;700;740;741;9;304;699;1;0;0;0;0;304;5;299
223100018;700;763;764;9;318;699;1;0;0;0;0;318;5;313
223100019;600;670;673;10;242;599;1;0;0;0;0;242;3;239
223100020;500;631;632;9;291;499;1;0;0;0;0;291;11;280
223100021;700;801;803;10;328;699;1;0;0;0;0;328;9;319
223100022;700;699;699;5;313;699;1;0;0;0;0;313;6;307
223100023;700;916;916;10;339;699;1;0;0;0;0;339;9;330
223100024;800;815;819;5;323;799;1;0;0;0;0;323;3;320
223100025;600;649;652;7;320;599;1;0;0;0;0;320;6;314
223100026;600;621;621;9;275;600;0;0;0;0;0;275;11;264
223100027;600;698;700;8;313;599;1;0;0;0;0;313;5;308
223100028;600;705;706;6;309;599;1;0;0;0;0;309;4;305
223100029;500;543;543;9;238;499;1;0;0;0;0;238;5;233
223100030;600;674;676;5;275;599;1;0;0;0;0;275;7;268
223100031;500;564;555;10;203;499;1;0;0;0;0;203;3;200
223100032;600;678;683;10;249;599;1;0;0;0;0;249;6;243
223100033;600;698;699;7;257;599;1;0;0;0;0;257;5;252
223100034;500;572;573;3;176;500;0;0;0;0;0;176;4;172
223100035;500;505;507;6;157;499;1;0;0;0;0;157;3;154
223100036;300;105;305;6;111;299;1;0;0;0;0;111;2;109
223100037;600;647;647;8;259;599;1;0;0;0;0;259;5;254
223100038;300;373;373;7;152;299;1;0;0;0;0;152;3;149
223100039;500;507;507;6;253;499;1;0;0;0;0;253;7;246
223100040;600;635;636;10;312;599;1;0;0;0;0;312;8;304
223100041;400;293;293;6;152;247;1;152;4;1;147;0;0;0
223100042;200;94;94;2;64;135;1;64;1;0;63;0;0;0
223100043;200;91;91;7;53;146;1;53;0;0;53;0;0;0
223100044;200;104;104;5;73;126;1;73;0;4;69;0;0;0
223100045;200;110;110;5;60;139;1;60;2;1;57;0;0;0
223100046;500;521;522;4;234;499;1;0;0;0;0;234;4;230
223100047;400;477;480;2;210;399;1;0;0;0;0;210;5;205
223100048;300;271;272;2;158;141;1;158;3;0;155;0;0;0
223100049;300;336;337;2;132;299;1;0;0;0;0;132;2;130
223100050;200;97;97;3;60;139;1;60;0;1;59;0;0;0
223100051;200;157;157;3;87;112;1;87;1;0;86;0;0;0
223100052;100;68;68;1;41;58;1;41;2;0;39;0;0;0
223100053;200;176;176;2;108;91;1;108;4;0;104;0;0;0
223100054;200;102;102;4;55;144;1;55;5;0;50;0;0;0
223100055;200;100;100;3;57;142;1;57;0;0;57;0;0;0
223100056;200;168;168;1;110;89;1;110;2;3;105;0;0;0
223100057;100;67;67;7;44;55;1;44;2;1;41;0;0;0
223100058;200;101;101;3;60;139;1;60;0;0;60;0;0;0
223100059;500;562;563;1;248;499;1;0;0;0;0;248;9;239
223100060;100;78;78;5;51;48;1;51;0;3;48;0;0;0
223100061;200;109;109;0;49;150;1;49;0;3;46;0;0;0
223100062;100;51;75;3;51;48;1;51;3;3;45;0;0;0
223100063;100;85;86;6;62;37;1;62;0;0;62;0;0;0
223100064;100;40;40;6;22;77;1;22;0;0;22;0;0;0
223100065;100;31;31;6;11;88;1;11;0;0;11;0;0;0
223100066;100;92;92;8;51;48;1;51;1;0;50;0;0;0
223100067;100;67;67;9;42;57;1;42;11;0;31;0;0;0
223100068;100;56;57;7;35;64;1;35;1;0;34;0;0;0
223100069;600;685;685;5;241;599;1;0;0;0;0;241;2;239
223100070;700;801;804;5;212;699;1;0;0;0;0;212;7;205
223100071;100;58;58;6;27;72;1;27;0;0;27;0;0;0
223100072;100;39;39;8;27;72;1;27;1;0;26;0;0;0
223100073;100;45;45;3;35;64;1;35;2;0;33;0;0;0
223100074;100;24;25;7;19;80;1;19;0;0;19;0;0;0
223100075;100;75;75;6;37;62;1;37;0;0;37;0;0;0
223100076;200;133;133;5;67;132;1;67;3;1;63;0;0;0
223100077;200;109;109;6;54;145;1;54;1;2;51;0;0;0
223100078;400;301;301;8;130;269;1;130;6;1;123;0;0;0
223100079;100;30;30;6;13;86;1;13;1;1;11;0;0;0
223100080;300;304;304;5;134;299;1;0;0;0;0;134;1;133
223100081;100;55;55;5;41;58;1;41;0;0;41;0;0;0
223100082;100;48;48;8;23;76;1;23;0;0;23;0;0;0
223100083;100;35;36;6;28;71;1;28;1;0;27;0;0;0
223100084;200;166;166;3;71;128;1;71;7;2;62;0;0;0
223100085;100;43;43;8;40;59;1;40;2;2;36;0;0;0
223100086;100;47;47;6;37;61;2;37;0;0;37;0;0;0
223100087;400;410;411;4;222;399;1;0;0;0;0;222;5;217
223100088;200;180;180;6;98;101;1;98;2;1;95;0;0;0
223100089;100;45;45;38;63;36;1;63;2;1;60;0;0;0
223800001;700;857;858;8;351;699;1;0;0;0;0;351;4;347
223800002;700;749;750;1;332;699;1;0;0;0;0;332;3;329
223800003;700;750;750;4;331;699;1;0;0;0;0;331;3;328
223800004;600;670;670;2;241;599;1;0;0;0;0;241;2;239
223800005;723;723;723;1;295;722;1;0;0;0;0;295;5;290
223800006;500;521;521;0;200;499;1;0;0;0;0;200;2;198
223800007;400;464;464;5;218;399;1;0;0;0;0;218;1;217
223800008;100;66;66;4;42;57;1;42;1;0;41;0;0;0
223800009;300;330;330;3;152;299;1;0;0;0;0;152;1;151
223800010;200;110;110;4;69;130;1;69;1;1;67;0;0;0
223800011;200;128;128;5;87;112;1;87;2;3;82;0;0;0
223800012;200;141;141;6;71;128;1;71;0;3;68;0;0;0
223800013;300;338;338;5;128;299;1;0;0;0;0;128;0;128
223800014;100;41;41;7;33;66;1;33;0;1;32;0;0;0
223800015;100;40;41;7;29;69;2;29;0;0;29;0;0;0
223800016;100;17;17;7;14;85;1;14;0;0;14;0;0;0
234602001;300;740;740;9;347;299;1;0;0;0;0;347;10;337
234602002;300;856;856;7;451;299;1;0;0;0;0;451;9;442
234602003;500;735;735;5;338;187;1;312;5;1;306;26;0;26
234602004;200;656;656;26;355;199;1;0;0;0;0;355;11;344
234602005;200;700;701;7;313;199;1;0;0;0;0;313;1;312
234602006;200;590;590;10;281;200;0;0;0;0;0;281;2;279
234602007;200;695;695;9;284;200;0;0;0;0;0;284;6;278
234602008;300;836;836;9;370;300;0;0;0;0;0;370;7;363
234602009;300;834;834;10;356;0;300;0;0;0;0;356;5;351
234602010;200;742;742;4;339;200;0;0;0;0;0;339;13;326
234602011;300;833;833;12;357;299;1;0;0;0;0;357;8;349
234602012;200;712;714;8;330;199;1;0;0;0;0;330;7;323
234602013;300;820;822;11;427;299;1;0;0;0;0;427;7;420
234602014;300;754;754;5;364;300;0;0;0;0;0;364;3;361
234602015;300;721;721;10;371;299;1;0;0;0;0;371;10;361
234602016;300;802;802;11;444;299;1;0;0;0;0;444;10;434
234602017;300;762;762;7;376;300;0;0;0;0;0;376;1;375
234602018;300;901;901;8;465;299;1;0;0;0;0;465;4;461
234602019;300;788;788;14;371;299;1;0;0;0;0;371;7;364
234602020;300;889;889;9;453;299;1;0;0;0;0;453;8;445
234602021;300;748;749;41;414;300;0;0;0;0;0;414;5;409
234602022;300;754;754;7;369;299;1;0;0;0;0;369;6;363
234602023;300;847;847;7;395;299;1;0;0;0;0;395;7;388
234602024;300;743;743;5;326;299;1;0;0;0;0;326;2;324
234602025;0;334;780;9;343;0;0;0;0;0;0;343;6;337
234602026;800;800;802;8;433;800;0;0;0;0;0;433;5;428
234602027;300;871;871;7;401;299;1;0;0;0;0;401;7;394
234602028;300;780;781;7;369;299;1;0;0;0;0;369;8;361
234602029;300;972;972;8;489;300;0;0;0;0;0;489;11;478
234602030;300;975;975;23;490;299;1;0;0;0;0;490;11;479
234602031;300;794;794;12;372;299;1;0;0;0;0;372;5;367
234602032;300;904;904;11;420;299;1;0;0;0;0;420;8;412
234602033;300;750;750;7;329;299;1;0;0;0;0;329;3;326
234602034;300;817;817;6;393;299;1;0;0;0;0;393;5;388
234602035;300;783;783;23;360;299;1;0;0;0;0;361;3;358
234602036;300;767;767;10;376;299;1;0;0;0;0;376;7;369
234602037;300;736;736;7;363;299;1;0;0;0;0;363;3;360
234602038;300;761;762;12;351;300;0;0;0;0;0;351;7;344
234602039;300;812;812;8;358;299;1;0;0;0;0;358;8;350
234602040;300;744;744;6;318;299;1;0;0;0;0;318;2;316
234602041;300;897;897;6;402;299;1;0;0;0;0;402;8;394
234602042;300;742;742;5;359;299;1;0;0;0;0;359;5;354
234602043;300;663;664;11;311;299;1;0;0;0;0;311;3;308
234602044;300;691;692;11;321;299;1;0;0;0;0;321;7;314
234602045;300;795;796;6;371;299;1;0;0;0;0;371;4;367
234602046;300;750;750;9;369;299;1;0;0;0;0;369;2;367
234602047;300;743;745;7;345;299;1;0;0;0;0;345;7;338
234602048;300;808;808;17;473;299;1;0;0;0;0;473;12;461
234602049;300;877;877;5;456;300;0;0;0;0;0;456;7;449
234602050;300;783;783;8;329;299;1;0;0;0;0;329;6;323
234602051;200;651;653;20;358;199;1;0;0;0;0;358;10;348
234602052;300;731;732;8;350;299;1;0;0;0;0;350;10;340
234602053;200;571;571;3;292;200;0;0;0;0;0;292;8;284
234602054;200;656;656;6;304;200;0;0;0;0;0;304;7;297
234602055;300;925;925;16;455;300;0;0;0;0;0;455;7;448
234602056;300;900;900;17;438;300;0;0;0;0;0;438;1;437
234602057;300;801;801;20;398;299;1;0;0;0;0;398;5;393
234602058;300;768;768;11;350;299;1;0;0;0;0;350;3;347
234602059;300;812;814;7;382;300;0;0;0;0;0;382;3;379
234602060;300;782;783;15;386;300;0;0;0;0;0;386;4;382
234602061;300;805;805;6;399;299;1;0;0;0;0;399;5;394
234602062;300;945;948;10;455;299;1;0;0;0;0;455;5;450
234602063;300;830;830;7;407;299;1;0;0;0;0;407;3;404
234602064;300;794;794;8;352;299;1;0;0;0;0;352;4;348
234602065;300;856;856;7;389;299;1;0;0;0;0;389;2;387
234602066;300;821;821;7;405;299;1;0;0;0;0;405;6;399
234602067;300;798;798;12;408;300;0;0;0;0;0;408;7;401
234602068;300;750;754;9;358;300;0;0;0;0;0;358;11;347
234602069;300;850;853;7;417;300;0;0;0;0;0;417;5;412
234602070;300;721;721;17;346;299;1;0;0;0;0;346;12;334
234602071;751;752;752;10;332;751;0;0;0;0;0;332;5;327
234602072;300;824;829;6;415;299;1;0;0;0;0;415;7;408
234602073;0;946;946;10;519;0;0;0;0;0;0;519;8;511
234602074;300;849;849;10;435;299;1;0;0;0;0;435;4;431
234602075;300;824;828;7;436;299;1;0;0;0;0;436;8;428
234602076;300;843;846;6;356;300;0;0;0;0;0;356;6;350
234602077;300;786;787;5;388;299;1;0;0;0;0;388;3;385
234602078;200;629;631;7;252;200;0;0;0;0;0;252;6;246
234602079;300;748;748;8;319;299;1;0;0;0;0;319;7;312
234602080;300;893;893;8;465;300;0;0;0;0;0;465;11;454
234602081;300;790;790;7;319;299;1;0;0;0;0;319;3;316
234602082;300;775;778;6;347;300;0;0;0;0;0;347;15;332
234602083;300;772;774;13;340;299;1;0;0;0;0;340;3;337
234602084;300;813;813;12;405;300;0;0;0;0;0;405;3;402
234602085;300;874;874;7;424;300;0;0;0;0;0;424;2;422
234602086;674;674;674;8;305;673;1;0;0;0;0;305;5;300
234602087;300;701;701;8;336;299;1;0;0;0;0;336;3;333
234602088;300;793;794;10;408;299;1;0;0;0;0;408;4;404
234602089;300;775;775;7;390;299;1;0;0;0;0;390;7;383
234602090;300;881;882;8;447;300;0;0;0;0;0;447;3;444
234602091;300;729;731;6;326;299;1;0;0;0;0;326;3;323
234602092;300;817;819;8;407;299;1;0;0;0;0;407;6;401
234602093;400;39;39;278;287;110;3;287;4;8;275;0;0;0
234602094;200;96;96;43;79;120;1;79;2;5;72;0;0;0
234602096;100;57;57;12;66;32;2;66;0;0;66;0;0;0
234602097;100;11;11;6;10;89;1;10;1;0;9;0;0;0
234608001;200;606;608;9;295;199;1;0;0;0;0;295;3;292
234608002;200;508;509;8;233;199;1;0;0;0;0;233;2;231
234608003;200;658;660;13;329;199;1;0;0;0;0;329;3;326
234608004;300;717;717;12;380;299;1;0;0;0;0;380;4;376
234608005;300;680;680;11;364;299;1;0;0;0;0;364;1;363
234608006;300;670;672;9;392;299;1;0;0;0;0;392;6;386
234608007;300;707;707;7;334;299;1;0;0;0;0;334;7;327
234608008;300;713;714;5;338;299;1;0;0;0;0;338;1;337
234608009;300;672;672;10;366;299;1;0;0;0;0;366;1;365
234608010;200;603;603;9;275;199;1;0;0;0;0;275;5;270
234608011;200;614;615;8;319;199;1;0;0;0;0;319;10;309
234608012;300;677;677;8;301;299;1;0;0;0;0;301;6;295
234608013;300;662;663;7;286;299;1;0;0;0;0;286;3;283
234608014;200;596;596;5;290;199;1;0;0;0;0;290;6;284
234608015;200;513;513;11;220;199;1;0;0;0;0;220;4;216
234608016;300;748;748;10;255;299;1;0;0;0;0;255;4;251
234608017;200;505;505;33;293;199;1;0;0;0;0;293;1;292
234608018;600;703;703;13;346;599;1;0;0;0;0;346;5;341
234608019;300;755;755;9;323;299;1;0;0;0;0;323;8;315
234608020;200;648;648;6;256;199;1;0;0;0;0;256;3;253
234608021;200;602;602;8;282;199;1;0;0;0;0;282;2;280
234608022;300;655;655;5;255;299;1;0;0;0;0;255;2;253
234608023;300;720;720;9;272;299;1;0;0;0;0;272;7;265
234608024;300;683;684;8;289;299;1;0;0;0;0;289;5;284
234608025;200;508;511;5;183;199;1;0;0;0;0;183;2;181
234608026;200;326;327;19;180;199;1;0;0;0;0;180;4;176
234608027;300;960;962;9;487;299;1;0;0;0;0;487;5;482
234608028;200;656;657;6;323;200;0;0;0;0;0;323;2;321
234608029;200;627;629;4;324;199;1;0;0;0;0;324;9;315
234608030;200;630;632;9;271;199;1;0;0;0;0;271;4;267
234608031;200;446;446;8;143;199;1;0;0;0;0;143;4;139
234608032;200;547;548;9;180;199;1;0;0;0;0;180;5;175
234608033;200;646;646;10;323;199;1;0;0;0;0;323;5;318
234608034;200;543;544;15;268;200;0;0;0;0;0;268;1;267
234608035;300;797;797;7;358;299;1;0;0;0;0;358;3;355
234608036;200;551;553;7;240;199;1;0;0;0;0;240;3;237
234608037;300;737;737;7;340;299;1;0;0;0;0;340;7;333
234608038;300;968;969;8;441;299;1;0;0;0;0;441;6;435
234608039;300;739;739;10;384;299;1;0;0;0;0;384;5;379
234608040;300;765;770;6;371;299;1;0;0;0;0;371;2;369
234608041;200;619;620;9;310;199;1;0;0;0;0;310;6;304
234608042;300;801;803;6;400;299;1;0;0;0;0;400;4;396
234608043;300;735;735;7;226;299;1;0;0;0;0;226;3;223
234608044;300;671;673;5;326;300;0;0;0;0;0;326;5;321
234608045;200;501;501;13;251;199;1;0;0;0;0;251;4;247
234608046;300;46;46;82;112;187;1;112;3;0;109;0;0;0
234608047;300;81;81;21;74;225;1;74;2;1;71;0;0;0
234608048;300;199;199;53;230;69;1;230;10;12;208;0;0;0
234608049;100;30;30;8;37;63;0;37;1;0;36;0;0;0
234609001;200;714;714;19;369;199;1;0;0;0;0;369;2;367
234609002;200;611;612;12;278;199;1;0;0;0;0;278;4;274
234609003;200;625;625;8;293;200;0;0;0;0;0;293;1;292
234609004;200;557;557;9;257;199;1;0;0;0;0;257;9;248
234609005;200;639;640;17;362;199;1;0;0;0;0;362;5;357
234609006;200;656;658;9;327;199;1;0;0;0;0;327;2;325
234609007;200;654;654;6;361;199;1;0;0;0;0;361;6;355
234609008;200;683;683;9;357;199;1;0;0;0;0;357;2;355
234609009;200;709;712;14;395;200;0;0;0;0;0;395;2;393
234609010;200;669;669;13;359;200;0;0;0;0;0;359;7;352
234609011;200;619;619;5;306;200;0;0;0;0;0;306;6;300
234609012;200;674;674;8;373;200;0;0;0;0;0;373;3;370
234609013;200;679;679;3;348;199;1;0;0;0;0;348;2;346
234609014;200;667;668;6;331;200;0;0;0;0;0;331;5;326
234609015;200;546;546;7;271;200;0;0;0;0;0;271;5;266
234609016;200;711;711;5;355;199;1;0;0;0;0;355;3;352
234609017;200;721;721;6;321;200;0;0;0;0;0;321;0;321
234609018;200;725;725;7;370;199;1;0;0;0;0;370;1;369
234609019;200;531;531;10;240;200;0;0;0;0;0;240;3;237
234609020;200;558;558;6;254;200;0;0;0;0;0;254;4;250
234609021;200;540;541;10;294;200;0;0;0;0;0;294;4;290
234609022;200;584;585;9;294;200;0;0;0;0;0;294;2;292
234609023;200;677;677;9;346;200;0;0;0;0;0;346;6;340
234609024;200;675;676;9;329;200;0;0;0;0;0;329;1;328
234609025;200;612;613;11;308;200;0;0;0;0;0;308;3;305
234609026;200;629;629;16;323;199;1;0;0;0;0;323;2;321
234609027;200;662;662;6;325;199;1;0;0;0;0;325;6;319
234609028;200;708;709;5;380;199;1;0;0;0;0;380;6;374
234609029;200;687;687;7;371;199;1;0;0;0;0;371;6;365
234609030;200;543;543;7;265;199;1;0;0;0;0;265;1;264
234609031;200;578;578;9;296;199;1;0;0;0;0;296;5;291
234609032;200;551;553;11;279;199;1;0;0;0;0;279;1;278
234609033;200;461;461;8;220;199;1;0;0;0;0;220;3;217
234609034;200;648;648;4;326;200;0;0;0;0;0;326;6;320
234609035;200;513;513;5;275;199;1;0;0;0;0;275;3;272
234609036;200;622;622;10;320;199;1;0;0;0;0;320;5;315
234609037;200;444;444;14;253;199;1;0;0;0;0;253;3;250
234609038;200;530;530;3;289;199;1;0;0;0;0;289;3;286
234609039;200;560;561;6;265;199;1;0;0;0;0;265;6;259
234609040;200;603;603;6;328;199;1;0;0;0;0;328;2;326
234609041;200;642;643;18;355;199;1;0;0;0;0;355;4;351
234609042;200;575;575;16;295;199;1;0;0;0;0;295;5;290
234609043;200;487;487;6;241;199;1;0;0;0;0;241;5;236
234609044;200;684;684;8;351;199;1;0;0;0;0;351;8;343
234609045;200;712;712;7;362;199;1;0;0;0;0;362;3;359
234609046;200;703;704;6;354;199;1;0;0;0;0;354;4;350
234609047;200;536;537;7;269;199;1;0;0;0;0;269;3;266
234609048;200;627;629;9;289;198;2;0;0;0;0;289;4;285
234609049;200;648;648;5;303;199;1;0;0;0;0;303;3;300
234609050;200;643;643;10;339;199;1;0;0;0;0;339;8;331
234609051;200;651;651;8;340;199;1;0;0;0;0;340;2;338
234609052;200;454;454;10;220;199;1;0;0;0;0;220;1;219
234609053;200;650;650;11;307;199;1;0;0;0;0;307;9;298
234609054;200;669;669;6;339;198;2;0;0;0;0;339;2;337
234609055;200;587;588;6;302;200;0;0;0;0;0;302;5;297
234609056;200;573;573;5;283;199;1;0;0;0;0;283;5;278
234609057;200;508;508;7;244;199;1;0;0;0;0;244;1;243
234609058;200;575;576;8;316;199;1;0;0;0;0;316;5;311
234609059;200;542;542;6;284;199;1;0;0;0;0;284;2;282
234609060;200;843;843;24;483;199;1;0;0;0;0;483;4;479
234609061;200;650;653;8;335;199;1;0;0;0;0;335;9;326
234609062;200;645;645;3;331;200;0;0;0;0;0;331;2;329
234609063;200;680;680;9;355;199;1;0;0;0;0;355;4;351
234609064;200;684;684;9;349;200;0;0;0;0;0;349;4;345
234609065;200;663;663;10;383;199;1;0;0;0;0;383;3;380
234609066;200;612;612;7;272;199;1;0;0;0;0;272;5;267
234609067;200;551;551;6;276;199;1;0;0;0;0;276;4;272
234609068;200;744;746;8;360;199;1;0;0;0;0;360;6;354
234609069;200;631;631;7;324;199;1;0;0;0;0;324;9;315
234609070;200;507;507;7;254;199;1;0;0;0;0;254;4;250
234609071;200;481;481;5;287;200;0;0;0;0;0;287;1;286
234609072;200;658;658;9;343;199;1;0;0;0;0;343;4;339
234609073;200;457;458;7;249;199;1;0;0;0;0;249;5;244
234609074;200;501;501;7;223;199;1;0;0;0;0;223;3;220
234609075;200;720;722;5;407;199;1;0;0;0;0;407;7;400
234609076;200;696;697;7;368;199;1;0;0;0;0;368;9;359
234609077;200;831;831;7;435;199;1;0;0;0;0;435;7;428
234609078;200;494;494;4;259;199;1;0;0;0;0;259;2;257
234609079;200;347;350;7;179;199;1;0;0;0;0;179;4;175
234609080;500;471;471;200;235;255;10;235;8;0;227;0;0;0
234609081;100;33;33;26;29;70;1;29;0;1;28;0;0;0
234609082;100;20;20;9;29;71;0;29;0;0;29;0;0;0
234610001;400;402;483;43;264;400;0;0;0;0;0;264;2;262
234610002;400;451;451;10;182;399;1;0;0;0;0;182;4;178
234610003;600;680;680;7;269;599;1;0;0;0;0;269;4;265
234610004;400;495;495;10;182;399;1;0;0;0;0;182;4;178
234610005;400;434;434;7;182;399;1;0;0;0;0;182;2;180
234610006;400;476;476;7;220;399;1;0;0;0;0;220;0;220
234610007;500;583;583;6;243;499;1;0;0;0;0;243;1;242
234610008;500;571;571;9;224;499;1;0;0;0;0;224;3;221
234610009;300;406;407;5;172;299;1;0;0;0;0;172;3;169
234610010;500;543;543;6;248;499;1;0;0;0;0;248;2;246
234610011;300;394;394;6;199;299;1;0;0;0;0;199;2;197
234610012;300;370;370;5;152;299;1;0;0;0;0;152;0;152
234610013;500;587;587;16;267;499;1;0;0;0;0;267;4;263
234610014;400;509;509;8;213;399;1;0;0;0;0;213;4;209
234610015;300;384;384;9;177;299;1;0;0;0;0;177;6;171
234610016;500;522;522;7;255;499;1;0;0;0;0;255;2;253
234610017;400;487;487;8;191;399;1;0;0;0;0;191;4;187
234610018;500;599;599;5;285;499;1;0;0;0;0;285;5;280
234610019;700;751;752;6;317;700;0;0;0;0;0;317;2;315
234610020;500;545;545;5;264;499;1;0;0;0;0;264;3;261
234610021;400;446;447;7;170;399;1;0;0;0;0;170;4;166
234610022;500;592;592;4;287;498;2;0;0;0;0;287;4;283
234610023;500;605;605;35;311;499;1;0;0;0;0;311;3;308
234610024;600;664;665;9;292;599;1;0;0;0;0;292;6;286
234610025;500;578;578;0;277;499;1;0;0;0;0;277;3;274
234610026;400;498;498;5;222;398;2;0;0;0;0;222;1;221
234610027;600;632;632;11;276;599;1;0;0;0;0;276;0;276
234610028;700;749;749;5;382;699;1;0;0;0;0;382;8;374
234610029;500;526;526;8;254;500;0;0;0;0;0;254;5;249
234610030;625;625;625;6;327;625;0;0;0;0;0;327;10;317
234610031;400;455;455;8;218;399;1;0;0;0;0;218;3;215
234610032;500;579;579;10;302;499;1;0;0;0;0;302;5;297
234610033;600;655;656;8;317;599;1;0;0;0;0;317;3;314
234610034;700;724;724;7;356;700;0;0;0;0;0;356;2;354
234610035;500;623;626;7;314;499;1;0;0;0;0;314;4;310
234610036;700;725;725;7;371;692;1;7;1;0;6;364;6;358
234610037;400;485;485;9;237;399;1;0;0;0;0;237;3;234
234610038;500;591;591;6;307;499;1;0;0;0;0;307;2;305
234610039;600;639;639;19;303;599;1;0;0;0;0;303;5;298
234610040;600;625;625;9;332;599;1;0;0;0;0;332;7;325
234610041;500;515;515;9;262;499;1;0;0;0;0;262;2;260
234610042;400;481;481;5;245;399;1;0;0;0;0;245;7;238
234610043;600;679;679;6;367;599;1;0;0;0;0;367;7;360
234610044;600;717;718;9;406;599;1;0;0;0;0;406;8;398
234610045;600;726;729;10;373;598;2;0;0;0;0;373;3;370
234610046;600;681;681;12;378;599;1;0;0;0;0;378;5;373
234610047;400;485;485;12;233;399;1;0;0;0;0;233;4;229
234610048;500;611;611;8;296;499;1;0;0;0;0;296;5;291
234610049;500;516;516;24;266;500;0;0;0;0;0;266;4;262
234610050;600;688;690;8;353;600;0;0;0;0;0;353;1;352
234610051;500;620;614;7;321;499;1;0;0;0;0;321;8;313
234610052;500;518;518;8;262;499;1;0;0;0;0;262;4;258
234610053;700;805;805;18;444;692;1;7;0;1;6;437;6;431
234610054;600;708;708;8;375;599;1;0;0;0;0;375;8;367
234610055;600;780;781;11;370;599;1;0;0;0;0;370;9;361
234610056;700;813;813;7;388;699;1;0;0;0;0;388;5;383
234610057;700;876;876;8;436;699;1;0;0;0;0;436;9;427
234610058;600;660;660;6;293;599;1;0;0;0;0;293;4;289
234610059;700;763;763;7;360;699;1;0;0;0;0;360;3;357
234610060;700;787;787;8;356;700;0;0;0;0;0;356;5;351
234610061;500;576;577;7;255;499;1;0;0;0;0;255;1;254
234610062;500;593;594;7;252;500;0;0;0;0;0;252;6;246
234610063;400;413;414;11;185;399;1;0;0;0;0;185;5;180
234610064;500;551;551;8;269;499;1;0;0;0;0;269;3;266
234610065;500;551;551;11;244;499;1;0;0;0;0;244;2;242
234610066;700;918;918;8;454;700;0;0;0;0;0;454;7;447
234610067;500;619;619;15;274;499;1;0;0;0;0;274;6;268
234610068;800;1038;1038;9;9;800;0;0;0;0;0;9;0;9
234610069;500;632;632;5;280;219;1;280;4;10;266;0;0;0
234610070;500;578;571;7;279;500;0;0;0;0;0;279;4;275
234610071;400;973;973;3;500;399;1;0;0;0;0;500;10;490
234610072;600;641;642;13;313;599;1;0;0;0;0;313;1;312
234610073;500;589;589;6;254;499;1;0;0;0;0;254;5;249
234610074;600;755;755;8;343;599;1;0;0;0;0;343;8;335
234610075;500;564;564;8;316;500;0;0;0;0;0;316;5;311
234610076;700;817;817;4;342;700;0;0;0;0;0;342;9;333
234610077;700;917;917;12;361;699;1;0;0;0;0;361;4;357
234610078;600;609;609;10;247;598;2;0;0;0;0;247;9;238
234610079;500;555;555;8;268;499;1;0;0;0;0;268;2;266
234610080;500;566;566;8;314;499;1;0;0;0;0;314;9;305
234610081;500;544;544;8;257;499;1;0;0;0;0;257;4;253
234610082;600;658;658;9;320;599;1;0;0;0;0;320;8;312
234610083;500;592;592;4;328;500;0;0;0;0;0;328;3;325
234610084;400;460;461;13;226;399;1;0;0;0;0;226;7;219
234610085;400;404;404;8;185;399;1;0;0;0;0;185;1;184
234610086;400;491;491;7;217;399;1;0;0;0;0;217;8;209
234610087;400;493;493;6;242;399;1;0;0;0;0;242;2;240
234610088;600;694;694;7;323;599;1;0;0;0;0;323;6;317
234610089;400;475;475;7;191;399;1;0;0;0;0;191;0;191
234610090;500;534;536;7;254;499;1;0;0;0;0;254;1;253
234610091;600;687;687;13;393;599;1;0;0;0;0;393;3;390
234610092;400;447;447;5;222;399;1;0;0;0;0;222;0;222
234610093;500;589;589;9;318;500;0;0;0;0;0;318;4;314
234610094;600;705;705;7;354;599;1;0;0;0;0;354;6;348
234610095;500;504;504;8;217;500;0;0;0;0;0;217;6;211
234610096;500;522;522;8;259;500;0;0;0;0;0;259;6;253
234610097;500;628;628;8;342;500;0;0;0;0;0;342;6;336
234610098;600;856;856;12;434;599;1;0;0;0;0;434;9;425
234610099;600;748;749;8;359;599;1;0;0;0;0;359;2;357
234610100;646;646;646;6;306;646;0;0;0;0;0;306;5;301
234610101;600;885;885;7;421;599;1;0;0;0;0;421;7;414
234610102;500;560;560;5;303;499;1;0;0;0;0;303;3;300
234610103;600;838;839;5;347;599;1;0;0;0;0;347;5;342
234610104;100;32;32;22;26;73;1;26;0;0;26;0;0;0
234610105;100;32;32;38;50;47;3;50;1;0;49;0;0;0
234610106;100;64;64;29;60;39;1;60;3;1;56;0;0;0
234610108;100;51;51;44;52;47;1;52;2;2;48;0;0;0
234610109;100;81;81;41;52;46;2;52;1;2;49;0;0;0
234610112;200;63;63;83;105;93;2;105;3;2;100;0;0;0
234610113;700;463;463;154;212;486;2;212;6;3;203;0;0;0
234610118;100;16;16;32;43;56;1;43;1;1;41;0;0;0
234610120;100;40;40;6;43;56;1;43;1;0;42;0;0;0
234610121;100;13;13;17;30;68;2;30;0;2;28;0;0;0
234615001;500;674;675;64;383;499;1;0;0;0;0;383;4;379
234615002;500;709;710;11;347;499;1;0;0;0;0;347;5;342
234615003;500;792;792;8;393;499;1;0;0;0;0;393;3;390
234615004;500;744;745;4;348;499;1;0;0;0;0;348;3;345
234615005;500;621;621;4;273;499;1;0;0;0;0;273;6;267
234615006;500;696;697;6;298;499;1;0;0;0;0;298;3;295
234615007;500;525;526;6;221;499;1;0;0;0;0;221;0;221
234615008;500;804;806;6;373;499;1;0;0;0;0;373;1;372
234615009;500;819;820;3;422;499;1;0;0;0;0;422;7;415
234615010;500;763;763;4;353;499;1;0;0;0;0;353;3;350
234615011;500;822;822;6;341;499;1;0;0;0;0;341;4;337
234615012;500;748;748;5;375;499;1;0;0;0;0;375;3;372
234615013;500;865;865;9;477;499;1;0;0;0;0;477;8;469
234615014;500;604;605;7;262;499;1;0;0;0;0;262;5;257
234615015;500;584;585;13;292;500;0;0;0;0;0;292;2;290
234615016;500;672;672;8;300;499;1;0;0;0;0;300;5;295
234615017;500;765;767;6;325;500;0;0;0;0;0;325;1;324
234615018;500;723;726;4;333;499;1;0;0;0;0;333;10;323
234615019;500;641;642;6;317;499;1;0;0;0;0;317;7;310
234615020;500;637;639;5;325;499;1;0;0;0;0;325;3;322
234615021;500;832;832;5;439;499;1;0;0;0;0;439;6;433
234615022;500;743;743;7;349;499;1;0;0;0;0;349;13;336
234615023;500;839;839;8;417;499;1;0;0;0;0;417;1;416
234615024;500;754;754;6;308;500;0;0;0;0;0;308;6;302
234615025;500;786;787;7;352;499;1;0;0;0;0;352;8;344
234615026;500;892;895;9;397;499;1;0;0;0;0;397;8;389
234615027;500;561;561;21;276;499;1;0;0;0;0;276;2;274
234615028;500;592;592;6;282;499;1;0;0;0;0;282;2;280
234615029;500;706;707;8;359;499;1;0;0;0;0;359;8;351
234615030;500;518;518;7;256;499;1;0;0;0;0;256;5;251
234615031;500;803;803;7;391;499;1;0;0;0;0;391;6;385
234615032;500;634;628;6;287;499;1;0;0;0;0;287;7;280
234615033;500;569;569;10;255;499;1;0;0;0;0;255;3;252
234615034;500;718;718;7;360;498;2;0;0;0;0;360;3;357
234615035;500;653;653;10;355;499;1;0;0;0;0;355;7;348
234615036;500;543;543;6;162;499;1;0;0;0;0;162;9;153
234615037;500;822;822;8;402;500;0;0;0;0;0;402;7;395
234615038;500;937;939;5;426;500;0;0;0;0;0;426;9;417
234615039;500;782;782;6;419;499;1;0;0;0;0;419;5;414
234615040;500;691;691;4;327;499;1;0;0;0;0;327;5;322
234615041;500;817;819;6;436;499;1;0;0;0;0;436;10;426
234615042;500;768;769;7;385;499;1;0;0;0;0;385;8;377
234615043;500;720;723;2;328;499;1;0;0;0;0;328;6;322
234615044;500;571;571;22;319;499;1;0;0;0;0;319;2;317
234615045;500;831;831;13;374;499;1;0;0;0;0;374;3;371
234615046;500;911;912;6;428;499;1;0;0;0;0;428;5;423
234615047;500;993;993;7;590;499;1;0;0;0;0;590;5;585
234615048;500;804;805;6;397;499;1;0;0;0;0;397;2;395
234615049;500;729;729;40;335;499;1;0;0;0;0;335;3;332
234615050;500;847;848;7;401;499;1;0;0;0;0;401;8;393
234615051;500;785;787;5;353;499;1;0;0;0;0;353;11;342
234615052;500;933;935;9;478;499;1;0;0;0;0;478;5;473
234615053;500;886;889;6;397;499;1;0;0;0;0;397;5;392
234615054;500;824;825;5;368;500;0;0;0;0;0;368;4;364
234615055;500;761;761;9;385;499;1;0;0;0;0;385;7;378
234615056;500;895;895;6;407;499;1;0;0;0;0;407;7;400
234615057;500;703;703;6;293;499;1;0;0;0;0;293;2;291
234615058;500;903;904;10;461;499;1;0;0;0;0;461;5;456
234615059;500;678;679;10;329;499;1;0;0;0;0;329;5;324
234615060;500;760;760;5;312;499;1;0;0;0;0;312;4;308
234615061;500;759;760;3;415;500;0;0;0;0;0;415;5;410
234615062;500;670;670;7;335;500;0;0;0;0;0;335;3;332
234615063;528;528;528;21;262;527;1;0;0;0;0;262;4;258
234615064;500;627;628;6;296;499;1;0;0;0;0;296;3;293
234615065;500;687;688;6;315;499;1;0;0;0;0;315;2;313
234615066;500;688;691;6;278;499;1;0;0;0;0;278;3;275
234615067;500;734;734;5;307;499;1;0;0;0;0;307;3;304
234615068;500;669;671;8;321;499;1;0;0;0;0;321;9;312
234615069;500;799;800;11;423;500;0;0;0;0;0;423;7;416
234615070;500;733;733;8;369;499;1;0;0;0;0;369;11;358
234615071;500;738;739;7;416;499;1;0;0;0;0;416;4;412
234615072;500;792;792;7;381;499;1;0;0;0;0;381;6;375
234615073;500;646;650;6;236;499;1;0;0;0;0;236;4;232
234615074;500;564;564;5;235;499;1;0;0;0;0;235;3;232
234615075;500;582;582;20;282;499;1;0;0;0;0;282;9;273
234615076;500;790;791;6;299;499;1;0;0;0;0;299;4;295
234615077;500;774;774;8;321;499;1;0;0;0;0;321;3;318
234615078;500;661;661;9;300;499;1;0;0;0;0;300;3;297
234615079;500;679;679;7;283;498;2;0;0;0;0;283;4;279
234615080;500;609;609;3;245;500;0;0;0;0;0;245;3;242
234615081;500;660;661;9;259;499;1;0;0;0;0;259;3;256
234615082;500;871;871;6;428;499;1;0;0;0;0;428;8;420
234615083;500;802;802;6;370;499;1;0;0;0;0;370;6;364
234615084;500;694;694;8;309;498;2;0;0;0;0;309;6;303
234615085;500;716;717;6;355;500;0;0;0;0;0;355;9;346
234615086;500;908;908;8;454;498;2;0;0;0;0;454;11;443
234615087;500;712;712;7;369;499;1;0;0;0;0;369;11;358
234615088;500;674;675;6;359;499;1;0;0;0;0;359;6;353
234615089;500;610;610;7;276;499;1;0;0;0;0;276;5;271
234615090;500;575;576;21;286;499;1;0;0;0;0;286;2;284
234615091;500;601;603;5;294;499;1;0;0;0;0;294;8;286
234615092;500;941;942;8;495;498;2;0;0;0;0;495;2;493
234615093;500;658;658;7;283;500;0;0;0;0;0;283;8;275
234615094;500;531;531;47;253;499;1;0;0;0;0;253;5;248
234615095;500;778;779;7;336;499;1;0;0;0;0;336;9;327
234615096;500;592;592;6;257;500;0;0;0;0;0;257;7;250
234615097;500;700;700;5;283;499;1;0;0;0;0;283;2;281
234615098;500;848;848;7;426;500;0;0;0;0;0;426;6;420
234615099;500;774;774;5;370;500;0;0;0;0;0;370;4;366
234615100;500;888;888;9;426;499;1;0;0;0;0;426;9;417
234615101;500;828;829;6;421;499;1;0;0;0;0;421;6;415
234615102;500;832;833;6;422;499;1;0;0;0;0;422;8;414
234615103;500;682;683;3;308;499;1;0;0;0;0;308;4;304
234615104;500;663;664;5;200;499;1;0;0;0;0;200;3;197
234615105;500;289;746;9;298;499;1;0;0;0;0;298;8;290
234615106;500;676;676;8;289;500;0;0;0;0;0;289;1;288
234615107;500;628;631;8;255;499;1;0;0;0;0;255;5;250
234615108;500;557;557;6;234;500;0;0;0;0;0;234;1;233
234615109;500;629;629;3;264;499;1;0;0;0;0;264;2;262
234615110;500;749;752;5;366;500;0;0;0;0;0;366;6;360
234615111;500;747;747;5;313;499;1;0;0;0;0;313;4;309
234615112;500;792;792;9;365;499;1;0;0;0;0;365;6;359
234615113;500;971;971;9;402;499;1;0;0;0;0;402;3;399
234615114;500;837;837;7;285;499;1;0;0;0;0;285;12;273
234615115;500;752;752;9;304;499;1;0;0;0;0;304;1;303
234615116;500;905;907;4;444;499;1;0;0;0;0;444;5;439
234615117;500;887;886;21;454;499;1;0;0;0;0;454;7;447
234615118;500;600;600;14;263;500;0;0;0;0;0;263;4;259
234615119;500;308;758;6;314;500;0;0;0;0;0;314;6;308
234615120;500;809;809;9;364;499;1;0;0;0;0;364;6;358
234615121;500;744;744;4;256;499;1;0;0;0;0;256;1;255
234615122;500;922;923;8;375;500;0;0;0;0;0;375;6;369
234615123;500;844;844;5;366;499;1;0;0;0;0;366;11;355
234615124;500;732;732;7;231;499;1;0;0;0;0;231;2;229
234615125;500;614;614;5;203;499;1;0;0;0;0;203;1;202
234615126;200;64;64;163;169;30;1;169;5;5;159;0;0;0
234615127;200;24;24;5;6;193;1;6;0;0;6;0;0;0
234615128;100;12;12;9;11;88;1;11;0;0;11;0;0;0
234615129;100;22;22;7;28;72;0;28;0;0;28;0;0;0
234616001;600;803;803;94;502;599;1;0;0;0;0;502;6;496
234616002;500;406;406;204;408;499;1;0;0;0;0;408;8;400
234616003;600;461;461;176;433;599;1;0;0;0;0;433;8;425
234616004;500;561;561;84;381;499;1;0;0;0;0;381;6;375
234616005;800;526;526;198;482;799;1;0;0;0;0;482;13;469
234616006;600;232;446;167;399;599;1;0;0;0;0;399;9;390
234616007;755;755;755;46;420;754;1;0;0;0;0;420;5;415
234616008;600;488;488;59;348;600;0;0;0;0;0;348;0;348
234616009;600;788;788;82;496;600;0;0;0;0;0;496;12;484
234616010;400;395;397;8;193;399;1;0;0;0;0;193;2;191
234616011;300;342;342;11;152;299;1;0;0;0;0;152;3;149
234616012;400;444;444;9;188;399;1;0;0;0;0;188;3;185
234616013;400;511;514;8;237;399;1;0;0;0;0;237;6;231
234616014;400;447;447;6;227;399;1;0;0;0;0;227;2;225
234616015;400;264;264;10;150;249;1;150;1;3;146;0;0;0
234616016;400;625;625;8;320;399;1;0;0;0;0;320;15;305
234616017;300;506;508;10;210;299;1;0;0;0;0;210;6;204
234616018;500;714;716;6;364;500;0;0;0;0;0;364;2;362
234616019;500;642;644;7;344;499;1;0;0;0;0;344;6;338
234616020;400;456;457;7;208;399;1;0;0;0;0;208;3;205
234616021;500;745;745;5;425;499;1;0;0;0;0;425;7;418
234616022;300;451;451;7;228;299;1;0;0;0;0;228;6;222
234616023;500;735;735;6;341;499;1;0;0;0;0;341;3;338
234616024;400;392;393;8;185;399;1;0;0;0;0;185;1;184
234616025;400;485;487;9;252;399;1;0;0;0;0;252;9;243
234616026;400;513;513;16;228;399;1;0;0;0;0;228;3;225
234616027;400;643;643;8;271;399;1;0;0;0;0;271;6;265
234616028;400;477;478;17;256;399;1;0;0;0;0;256;4;252
234616029;400;534;534;6;260;399;1;0;0;0;0;260;3;257
234616030;400;451;452;7;195;399;1;0;0;0;0;195;2;193
234616031;400;489;490;8;240;399;1;0;0;0;0;240;5;235
234616032;500;392;392;26;251;499;1;0;0;0;0;251;2;249
234616033;400;375;375;6;185;399;1;0;0;0;0;185;4;181
234616034;500;603;604;7;268;499;1;0;0;0;0;268;7;261
234616035;400;485;485;8;229;399;1;0;0;0;0;229;3;226
234616036;400;385;385;6;178;399;1;0;0;0;0;178;2;176
234616037;300;353;341;12;188;299;1;0;0;0;0;188;5;183
234616038;400;431;431;7;229;399;1;0;0;0;0;229;5;224
234616039;400;491;494;10;194;399;1;0;0;0;0;194;6;188
234616040;500;592;593;10;285;499;1;0;0;0;0;285;5;280
234616041;500;433;434;6;209;499;1;0;0;0;0;209;4;205
234616042;500;607;608;6;292;499;1;0;0;0;0;292;4;288
234616043;400;445;446;4;232;399;1;0;0;0;0;232;6;226
234616044;400;481;481;8;201;399;1;0;0;0;0;201;0;201
234616045;500;640;641;8;295;499;1;0;0;0;0;295;6;289
234616046;700;833;833;17;524;699;1;0;0;0;0;524;9;515
234616047;400;588;589;15;308;399;1;0;0;0;0;308;5;303
234616048;700;640;640;113;445;699;1;0;0;0;0;445;6;439
234616049;500;495;495;192;411;499;1;0;0;0;0;411;7;404
234616050;800;638;638;82;429;799;1;0;0;0;0;429;9;420
234616051;700;577;578;58;377;699;1;0;0;0;0;377;6;371
234616052;500;597;597;18;355;499;1;0;0;0;0;355;5;350
234616053;500;710;710;30;430;499;1;0;0;0;0;430;5;425
234616054;400;233;69;17;145;253;2;145;11;3;131;0;0;0
234616055;100;10;10;30;35;63;2;35;0;0;35;0;0;0
234616056;100;26;26;18;28;71;1;28;0;1;27;0;0;0
234617001;800;876;876;7;292;799;1;0;0;0;0;292;7;285
234617002;600;652;652;4;367;599;1;0;0;0;0;367;2;365
234617003;900;952;952;6;450;899;1;0;0;0;0;450;7;443
234617004;900;899;900;3;415;899;1;0;0;0;0;415;9;406
234617005;700;764;764;6;382;700;0;0;0;0;0;382;7;375
234617006;800;886;887;13;487;800;0;0;0;0;0;487;6;481
234617007;900;925;925;7;488;899;1;0;0;0;0;488;8;480
234617008;800;828;829;4;407;799;1;0;0;0;0;407;2;405
234617009;800;893;894;8;426;800;0;0;0;0;0;426;12;414
234617010;800;899;899;6;447;799;1;0;0;0;0;447;15;432
234617011;830;830;830;8;406;829;1;0;0;0;0;406;5;401
234617012;800;850;847;7;407;799;1;0;0;0;0;407;8;399
234617013;800;818;818;6;399;798;2;0;0;0;0;399;6;393
234617014;500;585;585;4;215;500;0;0;0;0;0;215;5;210
234617015;400;378;378;5;150;400;0;0;0;0;0;150;3;147
234617016;700;745;745;5;298;699;1;0;0;0;0;298;8;290
234617017;800;819;819;3;356;799;1;0;0;0;0;356;14;342
234617018;700;750;752;4;255;699;1;0;0;0;0;255;7;248
234617019;600;638;638;5;230;599;1;0;0;0;0;230;3;227
234617020;900;908;908;11;451;899;1;0;0;0;0;451;7;444
234617021;700;711;711;10;347;700;0;0;0;0;0;347;8;339
234617022;600;682;684;5;319;600;0;0;0;0;0;319;3;316
234617023;600;633;634;6;320;599;1;0;0;0;0;320;3;317
234617024;800;847;847;9;419;799;1;0;0;0;0;419;4;415
234617025;800;862;862;6;414;799;1;0;0;0;0;414;5;409
234617026;600;600;601;9;259;599;1;0;0;0;0;259;5;254
234617027;900;961;961;5;397;899;1;0;0;0;0;397;5;392
234617028;800;841;841;7;405;799;1;0;0;0;0;405;3;402
234617029;700;712;712;3;313;699;1;0;0;0;0;313;4;309
234617030;800;848;848;4;355;800;0;0;0;0;0;355;5;350
234617031;600;607;607;4;276;600;0;0;0;0;0;276;7;269
234617032;800;839;840;7;320;800;0;0;0;0;0;320;7;313
234617033;500;496;496;5;197;500;0;0;0;0;0;197;3;194
234617034;900;907;908;9;438;899;1;0;0;0;0;438;14;424
234617035;800;821;821;9;370;799;1;0;0;0;0;370;9;361
234617036;600;637;637;6;293;600;0;0;0;0;0;293;4;289
234617037;800;878;878;7;420;799;1;0;0;0;0;420;9;411
234617038;600;686;686;6;313;599;1;0;0;0;0;313;4;309
234617039;700;738;738;5;312;700;0;0;0;0;0;312;4;308
234617040;800;878;879;7;423;799;1;0;0;0;0;423;4;419
234617041;700;783;783;4;203;700;0;0;0;0;0;203;5;198
234617042;700;344;794;4;344;699;1;0;0;0;0;344;10;334
234617043;900;972;972;7;517;899;1;0;0;0;0;517;15;502
234617044;800;822;822;15;442;799;1;0;0;0;0;442;2;440
234617045;800;814;814;14;447;799;1;0;0;0;0;447;7;440
234617046;800;876;876;7;400;799;1;0;0;0;0;400;5;395
234617047;700;718;718;7;367;700;0;0;0;0;0;367;7;360
234617048;800;889;889;11;469;799;1;0;0;0;0;469;5;464
234617049;900;952;952;6;502;900;0;0;0;0;0;502;10;492
234617050;800;861;863;12;436;800;0;0;0;0;0;436;7;429
234617051;800;896;896;4;457;800;0;0;0;0;0;457;8;449
234617052;800;887;887;7;432;800;0;0;0;0;0;432;6;426
234617053;900;967;968;10;489;900;0;0;0;0;0;489;9;480
234617054;900;923;923;11;414;899;1;0;0;0;0;414;9;405
234617055;800;861;861;8;441;800;0;0;0;0;0;441;10;431
234617056;700;763;764;5;369;699;1;0;0;0;0;369;6;363
234617057;400;407;407;10;230;400;0;0;0;0;0;230;8;222
234617058;600;668;668;6;291;599;1;0;0;0;0;291;4;287
234617059;500;571;572;8;234;499;1;0;0;0;0;234;2;232
234617060;500;584;584;15;269;499;1;0;0;0;0;269;6;263
234617061;700;765;766;6;388;699;1;0;0;0;0;388;7;381
234617062;800;853;853;9;402;799;1;0;0;0;0;402;3;399
234617063;800;683;684;20;308;799;1;0;0;0;0;308;4;304
234617064;600;638;638;8;310;599;1;0;0;0;0;310;4;306
234617065;600;658;658;6;279;599;1;0;0;0;0;279;5;274
234617066;600;673;673;8;226;599;1;0;0;0;0;226;1;225
234617067;600;686;686;10;341;599;1;0;0;0;0;341;3;338
234617068;800;872;872;7;439;799;1;0;0;0;0;439;11;428
234617069;800;870;870;7;429;799;1;0;0;0;0;429;3;426
234617070;700;735;734;10;382;699;1;0;0;0;0;382;4;378
234617071;900;952;952;7;455;899;1;0;0;0;0;455;10;445
234617072;500;588;588;8;299;499;1;0;0;0;0;299;7;292
234617073;700;365;751;7;372;699;1;0;0;0;0;372;7;365
234617074;200;49;49;50;63;135;2;63;1;5;57;0;0;0
234617075;100;15;15;7;22;78;0;22;2;0;20;0;0;0
234623001;300;665;666;6;246;299;1;0;0;0;0;246;7;239
234623002;200;487;487;7;196;199;1;0;0;0;0;196;3;193
234623003;300;828;828;2;308;299;1;0;0;0;0;308;5;303
234623004;300;753;754;6;290;299;1;0;0;0;0;290;8;282
234623005;300;738;738;4;273;299;1;0;0;0;0;273;13;260
234623006;300;759;759;5;301;299;1;0;0;0;0;301;5;296
234623007;200;604;604;2;150;199;1;0;0;0;0;150;4;146
234623008;300;608;611;6;259;299;1;0;0;0;0;259;9;250
234623009;300;701;701;2;318;299;1;0;0;0;0;318;7;311
234623010;400;982;983;5;482;399;1;0;0;0;0;482;15;467
234623011;300;676;676;2;252;299;1;0;0;0;0;252;1;251
234623012;300;660;660;4;271;299;1;0;0;0;0;271;5;266
234623013;300;666;666;6;315;299;1;0;0;0;0;315;2;313
234623014;300;593;593;4;264;299;1;0;0;0;0;264;5;259
234623015;400;685;686;5;295;399;1;0;0;0;0;295;8;287
234623016;300;566;567;5;283;299;1;0;0;0;0;283;2;281
234623017;300;850;850;5;366;299;1;0;0;0;0;366;9;357
234623018;300;814;817;18;371;299;1;0;0;0;0;371;6;365
234623019;300;778;778;6;313;299;1;0;0;0;0;313;9;304
234623020;300;701;703;8;318;299;1;0;0;0;0;318;11;307
234623021;400;864;864;5;408;399;1;0;0;0;0;408;7;401
234623022;300;641;642;7;330;299;1;0;0;0;0;330;3;327
234623023;200;510;510;2;209;199;1;0;0;0;0;209;3;206
234623024;200;508;508;3;216;199;1;0;0;0;0;216;5;211
234623025;300;640;641;4;269;299;1;0;0;0;0;269;7;262
234623026;300;847;849;4;371;299;1;0;0;0;0;371;13;358
234623027;400;932;933;4;438;399;1;0;0;0;0;438;5;433
234623028;400;929;927;4;443;399;1;0;0;0;0;443;6;437
234623029;400;811;808;14;430;399;1;0;0;0;0;430;6;424
234623030;400;748;750;1;344;399;1;0;0;0;0;344;5;339
234623031;200;571;571;3;212;199;1;0;0;0;0;212;7;205
234623032;100;65;66;10;46;53;1;46;0;1;45;0;0;0
244601001;300;677;678;20;236;299;1;0;0;0;0;236;1;235
244601002;300;702;702;10;313;299;1;0;0;0;0;313;6;307
244601003;300;699;699;7;297;300;0;0;0;0;0;297;3;294
244601004;300;704;704;13;303;300;0;0;0;0;0;303;1;302
244601005;400;797;797;10;349;399;1;0;0;0;0;349;3;346
244601006;300;673;673;15;306;300;0;0;0;0;0;306;7;299
244601007;300;753;753;11;361;300;0;0;0;0;0;361;6;355
244601008;300;614;614;9;271;299;1;0;0;0;0;271;2;269
244601009;400;840;840;10;383;400;0;0;0;0;0;383;5;378
244601010;300;773;778;13;354;299;1;0;0;0;0;354;4;350
244601011;400;796;798;6;324;316;2;82;0;4;78;242;3;239
244601012;300;761;761;11;317;299;1;0;0;0;0;317;3;314
244601013;400;817;817;5;350;400;0;0;0;0;0;350;6;344
244601014;400;780;784;7;357;400;0;0;0;0;0;357;1;356
244601015;300;518;519;5;238;299;1;0;0;0;0;238;4;234
244601016;300;707;707;7;324;299;1;0;0;0;0;324;9;315
244601017;300;501;501;17;255;299;1;0;0;0;0;255;2;253
244601018;300;715;717;7;324;299;1;0;0;0;0;324;6;318
244601019;300;740;741;8;338;300;0;0;0;0;0;338;3;335
244601020;300;681;681;9;294;300;0;0;0;0;0;294;4;290
244601021;297;759;759;8;331;296;1;0;0;0;0;331;6;325
244601022;400;829;829;9;387;399;1;0;0;0;0;387;4;383
244601023;640;640;640;14;299;640;0;0;0;0;0;299;4;295
244601024;300;668;669;7;300;300;0;0;0;0;0;300;8;292
244601025;300;590;590;11;262;299;1;0;0;0;0;262;3;259
244601026;300;714;715;5;316;299;1;0;0;0;0;316;2;314
244601027;300;645;645;8;261;299;1;0;0;0;0;261;4;257
244601028;400;854;855;8;302;399;1;0;0;0;0;302;2;300
244601029;400;906;907;10;397;400;0;0;0;0;0;397;7;390
244601030;300;689;683;6;307;300;0;0;0;0;0;307;2;305
244601031;300;534;534;8;244;299;1;0;0;0;0;244;2;242
244601032;300;769;771;9;396;299;1;0;0;0;0;396;6;390
244601033;300;729;730;9;332;300;0;0;0;0;0;332;2;330
244601034;300;676;677;8;295;300;0;0;0;0;0;295;4;291
244601035;300;724;725;9;358;299;1;0;0;0;0;358;6;352
244601036;400;791;791;10;356;400;0;0;0;0;0;356;4;352
244601037;400;855;855;3;433;400;0;0;0;0;0;433;2;431
244601038;400;844;845;3;411;399;1;0;0;0;0;411;6;405
244601039;400;849;849;6;402;399;1;0;0;0;0;402;10;392
244601040;300;678;678;11;355;300;0;0;0;0;0;355;5;350
244601041;400;844;844;11;443;400;0;0;0;0;0;443;4;439
244601042;350;694;696;9;355;350;0;0;0;0;0;355;2;353
244601043;100;56;56;49;54;45;1;54;0;2;52;0;0;0
244601044;100;33;33;28;44;55;1;44;0;0;44;0;0;0
244601045;100;59486;59486;35;67;100;0;0;0;0;0;67;1;66
244601046;100;21;21;4;24;75;1;24;0;1;23;0;0;0
244603001;200;442;442;16;154;199;1;0;0;0;0;154;1;153
244603002;300;609;609;8;218;299;1;0;0;0;0;218;4;214
244603003;400;729;730;12;243;399;1;0;0;0;0;243;10;233
244603004;400;749;749;7;218;399;1;0;0;0;0;218;4;214
244603005;100;23;23;10;33;66;1;33;0;1;32;0;0;0
244603006;500;872;872;10;235;499;1;0;0;0;0;235;3;232
244603007;500;932;934;9;339;499;1;0;0;0;0;339;4;335
244603008;500;901;901;7;192;500;0;0;0;0;0;192;4;188
244603009;400;748;748;7;161;399;1;0;0;0;0;161;3;158
244603011;500;983;984;14;294;499;1;0;0;0;0;294;5;289
244603012;300;483;484;16;162;299;1;0;0;0;0;162;2;160
244603013;300;558;558;9;154;298;2;0;0;0;0;154;4;150
244603014;500;847;847;14;272;500;0;0;0;0;0;272;7;265
244603016;200;382;382;29;152;199;1;0;0;0;0;152;5;147
244603017;300;547;547;6;146;299;1;0;0;0;0;146;1;145
244603018;500;875;876;6;238;500;0;0;0;0;0;238;3;235
244603020;400;782;782;10;240;399;1;0;0;0;0;240;3;237
244603021;400;772;772;3;190;400;0;0;0;0;0;190;1;189
244603022;500;871;872;10;316;500;0;0;0;0;0;316;9;307
244603024;600;904;904;12;380;599;1;0;0;0;0;380;3;377
244603025;500;971;972;8;416;500;0;0;0;0;0;416;3;413
244603026;400;772;772;9;327;399;1;0;0;0;0;327;3;324
244603027;400;753;753;15;362;399;1;0;0;0;0;362;4;358
244603028;400;709;709;9;292;398;2;0;0;0;0;292;7;285
244603031;400;801;802;9;314;399;1;0;0;0;0;314;3;311
244603032;500;983;985;6;402;499;1;0;0;0;0;402;13;389
244603034;300;566;569;7;248;299;1;0;0;0;0;248;6;242
244603035;300;642;643;7;270;299;1;0;0;0;0;270;2;268
244603036;400;791;791;26;366;399;1;0;0;0;0;366;9;357
244603037;500;892;892;5;297;499;1;0;0;0;0;297;6;291
244603038;500;820;820;5;387;499;1;0;0;0;0;387;6;381
244603039;200;350;351;45;192;199;1;0;0;0;0;192;6;186
244603040;300;533;533;7;259;299;1;0;0;0;0;259;2;257
244603041;300;666;668;6;263;299;1;0;0;0;0;263;3;260
244603042;500;821;823;5;357;499;1;0;0;0;0;357;5;352
244603043;500;965;966;10;434;499;1;0;0;0;0;434;8;426
244603044;500;907;907;5;398;499;1;0;0;0;0;398;8;390
244603045;500;917;917;10;379;498;2;0;0;0;0;379;4;375
244603046;500;873;874;7;386;499;1;0;0;0;0;386;6;380
244603047;400;794;794;13;338;399;1;0;0;0;0;338;9;329
244603048;500;960;964;10;421;499;1;0;0;0;0;421;6;415
244603050;500;857;858;8;356;499;1;0;0;0;0;356;3;353
244603052;400;724;725;20;359;400;0;0;0;0;0;359;3;356
244603053;500;921;921;7;404;499;1;0;0;0;0;404;3;401
244603054;400;816;816;6;337;399;1;0;0;0;0;337;4;333
244603055;400;791;791;10;365;399;1;0;0;0;0;365;5;360
244603056;300;590;591;8;224;299;1;0;0;0;0;224;2;222
244603057;400;719;719;6;308;399;1;0;0;0;0;308;5;303
244603058;600;524;524;11;237;599;1;0;0;0;0;237;4;233
244603059;300;572;572;5;268;299;1;0;0;0;0;268;4;264
244603060;300;568;570;13;246;299;1;0;0;0;0;246;4;242
244603061;300;524;526;6;210;299;1;0;0;0;0;210;1;209
244603062;300;633;634;1;265;299;1;0;0;0;0;265;7;258
244603063;300;640;641;5;224;299;1;0;0;0;0;224;2;222
244603064;500;845;847;9;378;499;1;0;0;0;0;378;8;370
244604001;500;458;458;13;242;499;1;0;0;0;0;242;5;237
244604002;600;752;752;10;293;600;0;0;0;0;0;293;3;290
244604003;500;472;473;14;205;500;0;0;0;0;0;205;3;202
244604004;500;372;372;12;177;499;1;0;0;0;0;177;3;174
244604005;500;425;425;10;186;499;1;0;0;0;0;186;1;185
244604006;500;421;421;8;202;499;1;0;0;0;0;202;2;200
244604007;600;612;612;10;219;599;1;0;0;0;0;219;3;216
244604008;600;555;555;7;256;600;0;0;0;0;0;256;3;253
244604009;600;652;654;8;313;599;1;0;0;0;0;313;5;308
244604010;600;527;529;8;245;599;1;0;0;0;0;245;3;242
244604011;500;334;335;7;146;499;1;0;0;0;0;146;1;145
244604012;600;698;698;11;353;599;1;0;0;0;0;353;4;349
244604013;600;725;725;7;349;599;1;0;0;0;0;349;8;341
244604016;600;747;747;7;328;600;0;0;0;0;0;328;6;322
244604018;500;406;406;4;175;500;0;0;0;0;0;175;0;175
244604019;500;404;404;7;198;500;0;0;0;0;0;198;2;196
244604020;500;448;450;5;202;500;0;0;0;0;0;202;3;199
244604021;500;465;465;5;188;500;0;0;0;0;0;188;1;187
244604022;600;583;583;280;280;599;1;0;0;0;0;280;2;278
244604023;600;563;563;7;278;600;0;0;0;0;0;278;4;274
244604024;600;587;588;17;303;599;1;0;0;0;0;303;5;298
244604025;600;623;623;7;334;599;1;0;0;0;0;334;2;332
244604027;700;818;817;8;413;699;1;0;0;0;0;413;5;408
244604028;600;660;662;6;339;599;1;0;0;0;0;339;3;336
244604029;700;811;813;8;425;698;2;0;0;0;0;425;8;417
244604030;600;606;607;15;336;599;1;0;0;0;0;336;8;328
244604031;500;348;350;13;190;500;0;0;0;0;0;190;4;186
244604032;600;492;492;8;259;599;1;0;0;0;0;259;1;258
244604033;600;734;732;10;389;600;0;0;0;0;0;389;10;379
244604034;500;344;345;7;187;499;1;0;0;0;0;187;3;184
244604035;500;466;467;8;212;500;0;0;0;0;0;212;1;211
244604036;600;660;661;7;285;599;1;0;0;0;0;285;4;281
244604037;500;431;431;14;234;498;2;0;0;0;0;234;1;233
244604038;500;448;448;8;245;500;0;0;0;0;0;245;4;241
244604039;600;514;515;11;257;599;1;0;0;0;0;257;4;253
244604040;500;464;467;6;236;499;1;0;0;0;0;236;7;229
244604042;600;526;526;7;237;599;1;0;0;0;0;237;4;233
244604043;600;554;556;8;275;600;0;0;0;0;0;275;6;269
244604044;600;632;633;7;264;600;0;0;0;0;0;264;1;263
244604045;600;510;512;9;285;600;0;0;0;0;0;285;4;281
244604046;600;640;629;11;319;600;0;0;0;0;0;319;5;314
244604047;600;642;643;9;267;599;1;0;0;0;0;267;1;266
244604048;600;499;499;3;245;600;0;0;0;0;0;245;4;241
244604049;600;583;585;8;286;600;0;0;0;0;0;286;6;280
244604050;500;360;360;6;166;500;0;0;0;0;0;166;5;161
244604051;600;730;730;5;342;600;0;0;0;0;0;342;2;340
244604052;500;432;432;13;212;499;1;0;0;0;0;212;5;207
244604053;600;749;755;9;340;600;0;0;0;0;0;340;1;339
244604054;600;578;578;6;262;599;1;0;0;0;0;262;3;259
244604055;600;520;521;7;262;600;0;0;0;0;0;262;6;256
244604056;600;609;608;7;299;599;1;0;0;0;0;299;2;297
244604057;600;754;755;9;347;600;0;0;0;0;0;347;5;342
244604058;600;556;557;11;280;593;7;0;0;0;0;280;5;275
244604059;500;461;462;16;237;500;0;0;0;0;0;237;4;233
244604060;200;29;29;134;141;58;1;141;4;3;134;0;0;0
244604061;102;17;17;4;21;79;2;21;2;0;19;0;0;0
244605001;300;418;419;18;198;299;1;0;0;0;0;198;3;195
244605002;300;535;535;7;249;299;1;0;0;0;0;249;1;248
244605003;300;610;611;8;269;299;1;0;0;0;0;269;5;264
244605004;300;487;487;13;213;299;1;0;0;0;0;213;5;208
244605005;400;793;793;7;345;399;1;0;0;0;0;345;6;339
244605006;300;540;540;5;252;299;1;0;0;0;0;252;6;246
244605007;400;664;665;5;314;399;1;0;0;0;0;314;5;309
244605008;400;817;818;11;358;400;0;0;0;0;0;358;7;351
244605009;400;819;820;14;380;399;1;0;0;0;0;380;7;373
244605010;400;733;733;6;366;399;1;0;0;0;0;366;6;360
244605011;500;955;956;9;450;499;1;0;0;0;0;450;8;442
244605012;400;773;773;2;366;399;1;0;0;0;0;366;5;361
244605013;300;526;527;7;247;299;1;0;0;0;0;247;3;244
244605014;400;720;721;10;335;400;0;0;0;0;0;335;4;331
244605015;300;598;599;7;272;299;1;0;0;0;0;272;6;266
244605016;500;825;825;4;397;499;1;0;0;0;0;397;9;388
244605017;500;937;938;5;432;499;1;0;0;0;0;432;9;423
244605018;500;934;934;9;431;499;1;0;0;0;0;431;9;422
244605019;500;869;869;6;418;499;1;0;0;0;0;418;6;412
244605020;200;369;370;4;153;199;1;0;0;0;0;153;1;152
244605021;300;550;550;4;226;300;0;0;0;0;0;226;4;222
244605022;200;398;398;4;177;199;1;0;0;0;0;177;2;175
244605023;300;527;527;6;243;300;0;0;0;0;0;243;2;241
244605024;200;213;213;29;65;133;2;65;1;1;63;0;0;0
244605025;400;662;662;5;274;400;0;0;0;0;0;274;5;269
244605026;300;456;456;13;215;299;1;0;0;0;0;215;3;212
244605027;400;716;716;9;320;399;1;0;0;0;0;320;5;315
244605028;400;717;717;7;315;399;1;0;0;0;0;315;5;310
244605029;300;590;590;5;263;299;1;0;0;0;0;263;3;260
244605030;400;712;712;7;344;399;1;0;0;0;0;344;7;337
244605031;300;555;556;6;231;299;1;0;0;0;0;231;4;227
244605032;300;517;520;7;220;299;1;0;0;0;0;220;2;218
244605033;300;521;521;4;223;299;1;0;0;0;0;223;1;222
244605034;400;659;660;8;291;398;2;0;0;0;0;291;5;286
244605035;200;307;308;10;133;200;0;0;0;0;0;133;2;131
244605036;300;531;531;8;219;299;1;0;0;0;0;219;6;213
244605037;300;413;413;8;193;300;0;0;0;0;0;193;6;187
244605038;400;687;688;8;319;400;0;0;0;0;0;319;3;316
244605039;300;507;508;4;210;299;1;0;0;0;0;210;4;206
244605040;300;485;485;9;210;299;1;0;0;0;0;210;5;205
244605041;400;733;734;8;308;399;1;0;0;0;0;308;2;306
244605042;300;536;536;6;220;300;0;0;0;0;0;220;4;216
244605043;400;722;722;6;213;399;1;0;0;0;0;213;8;205
244605044;400;755;756;5;267;399;1;0;0;0;0;267;7;260
244605045;500;912;914;7;293;499;1;0;0;0;0;293;14;279
244605046;300;577;577;6;223;300;0;0;0;0;0;223;7;216
244605047;300;545;545;4;223;299;1;0;0;0;0;223;1;222
244605048;300;576;579;6;224;299;1;0;0;0;0;224;9;215
244605049;400;702;704;7;234;399;1;0;0;0;0;234;2;232
244605050;400;707;708;6;265;400;0;0;0;0;0;265;6;259
244605051;300;598;598;5;260;300;0;0;0;0;0;260;2;258
244605052;200;368;370;8;118;199;1;0;0;0;0;118;3;115
244605053;300;515;515;6;202;300;0;0;0;0;0;202;7;195
244605054;500;868;871;9;382;500;0;0;0;0;0;382;6;376
244605055;300;514;516;8;228;299;1;0;0;0;0;228;4;224
244605056;300;528;529;8;217;299;1;0;0;0;0;217;6;211
244605057;400;641;642;8;236;399;1;0;0;0;0;236;1;235
244605058;500;841;840;2;329;500;0;0;0;0;0;329;5;324
244605059;400;775;775;9;327;399;1;0;0;0;0;327;5;322
244605060;500;923;924;6;312;500;0;0;0;0;0;312;6;306
244605061;500;935;935;3;381;500;0;0;0;0;0;381;3;378
244605062;200;145;145;8;56;143;1;56;1;3;52;0;0;0
244605063;200;36;36;40;54;145;1;54;1;0;53;0;0;0
244605064;200;28;28;51;75;123;2;75;3;2;70;0;0;0
244605065;300;113;113;49;159;138;3;159;15;3;141;0;0;0
244605066;200;21;21;19;39;160;1;39;0;0;39;0;0;0
244605067;200;13;13;6;12;188;0;12;0;1;11;0;0;0
244606001;500;850;850;7;377;500;0;0;0;0;0;377;8;369
244606002;500;774;774;2;304;499;1;0;0;0;0;304;4;300
244606003;500;799;800;10;307;499;1;0;0;0;0;307;7;300
244606004;500;880;881;7;393;500;0;0;0;0;0;393;11;382
244606005;500;787;787;7;347;500;0;0;0;0;0;347;6;341
244606006;500;815;815;7;345;500;0;0;0;0;0;345;4;341
244606007;500;849;850;11;293;500;0;0;0;0;0;293;7;286
244606008;500;818;818;5;341;500;0;0;0;0;0;341;5;336
244606009;500;745;745;6;255;499;1;0;0;0;0;255;2;253
244606010;500;812;812;6;297;500;0;0;0;0;0;297;5;292
244606011;500;810;811;4;332;499;1;0;0;0;0;332;10;322
244606012;500;774;775;6;306;499;1;0;0;0;0;306;14;292
244606013;500;728;728;4;244;500;0;0;0;0;0;244;2;242
244606014;500;799;799;4;269;500;0;0;0;0;0;269;3;266
244606015;500;710;710;19;299;499;1;0;0;0;0;299;7;292
244606016;500;785;785;4;293;500;0;0;0;0;0;293;2;291
244606017;500;794;794;10;358;500;0;0;0;0;0;358;5;353
244606018;500;813;815;7;325;500;0;0;0;0;0;325;5;320
244606019;500;843;843;6;366;500;0;0;0;0;0;366;9;357
244606020;500;684;684;6;270;499;1;0;0;0;0;270;3;267
244606021;500;822;822;8;351;499;1;0;0;0;0;351;8;343
244606022;500;741;741;16;316;499;1;0;0;0;0;316;1;315
244606023;500;890;890;7;399;499;1;0;0;0;0;399;11;388
244606024;500;970;970;11;446;499;1;0;0;0;0;446;3;443
244606025;500;849;849;8;385;499;1;0;0;0;0;385;1;384
244606026;500;852;852;9;329;499;1;0;0;0;0;329;7;322
244606027;500;779;779;9;328;499;1;0;0;0;0;328;5;323
244606028;500;824;824;6;366;499;1;0;0;0;0;366;4;362
244606029;500;737;740;9;318;499;1;0;0;0;0;318;5;313
244606030;500;812;812;7;340;499;1;0;0;0;0;340;10;330
244606031;500;804;805;8;349;500;0;0;0;0;0;349;6;343
244606032;500;737;737;8;373;499;1;0;0;0;0;373;1;372
244606033;500;775;775;8;310;500;0;0;0;0;0;310;6;304
244606034;500;759;759;7;331;499;1;0;0;0;0;331;8;323
244606035;500;831;831;5;353;499;1;0;0;0;0;353;8;345
244606036;500;725;725;7;318;499;1;0;0;0;0;318;7;311
244606037;500;720;720;8;273;499;1;0;0;0;0;273;3;270
244606038;500;675;675;7;285;280;1;219;3;6;210;66;0;66
244606039;500;771;771;12;351;499;1;0;0;0;0;351;9;342
244606040;500;947;947;10;444;499;1;0;0;0;0;444;12;432
244606041;500;814;814;10;320;499;1;0;0;0;0;320;6;314
244606042;500;823;824;7;318;216;3;281;2;5;274;37;0;37
244606043;500;835;835;9;313;499;1;0;0;0;0;313;7;306
244606044;500;796;796;9;355;499;1;0;0;0;0;355;9;346
244606045;500;721;721;5;296;499;1;0;0;0;0;296;5;291
244606046;500;922;922;5;400;500;0;0;0;0;0;400;7;393
244606047;500;773;773;14;345;500;0;0;0;0;0;345;7;338
244606048;500;738;738;6;332;499;1;0;0;0;0;332;5;327
244606049;500;823;823;6;389;499;1;0;0;0;0;389;5;384
244606050;500;813;813;5;322;498;2;0;0;0;0;322;10;312
244606051;500;719;719;9;83;499;1;0;0;0;0;83;0;83
244606052;500;784;786;3;266;499;1;0;0;0;0;266;1;265
244606053;500;813;813;9;337;499;1;0;0;0;0;337;10;327
244606054;500;778;778;7;318;499;1;0;0;0;0;318;8;310
244606055;500;765;765;12;303;499;1;0;0;0;0;303;7;296
244606056;500;778;778;19;363;499;1;0;0;0;0;363;1;362
244606057;500;738;738;7;277;499;1;0;0;0;0;277;3;274
244606058;500;858;858;8;342;206;0;294;8;10;276;48;1;47
244606059;500;876;876;6;341;499;1;0;0;0;0;341;10;331
244606060;500;880;873;7;338;499;1;0;0;0;0;338;5;333
244606061;500;782;782;14;290;499;1;0;0;0;0;290;6;284
244606062;500;790;792;3;300;500;0;0;0;0;0;300;2;298
244606063;500;839;839;6;344;499;1;0;0;0;0;344;5;339
244606064;500;818;818;5;320;499;1;0;0;0;0;320;5;315
244606065;500;824;825;5;298;499;1;0;0;0;0;298;8;290
244606066;500;798;798;5;310;499;1;0;0;0;0;310;5;305
244606067;500;824;824;5;310;500;0;0;0;0;0;310;4;306
244606068;500;857;857;5;365;499;1;0;0;0;0;365;6;359
244606069;500;922;922;8;438;499;1;0;0;0;0;438;9;429
244606070;500;648;648;7;260;499;1;0;0;0;0;260;3;257
244606071;500;892;892;7;408;499;1;0;0;0;0;408;6;402
244606072;500;826;826;5;356;500;0;0;0;0;0;356;10;346
244606073;500;830;831;11;297;499;1;0;0;0;0;297;6;291
244606074;500;868;868;7;306;499;1;0;0;0;0;306;8;298
244606075;500;669;669;8;230;499;1;0;0;0;0;230;5;225
244606076;500;858;858;14;340;499;1;0;0;0;0;340;7;333
244606077;500;783;783;3;327;499;1;0;0;0;0;327;2;325
244606078;500;774;774;10;343;499;1;0;0;0;0;343;8;335
244606079;500;672;674;5;286;499;1;0;0;0;0;286;4;282
244606080;500;650;653;10;273;499;1;0;0;0;0;273;9;264
244606081;500;786;786;9;359;499;1;0;0;0;0;359;6;353
244606082;500;751;751;3;284;499;1;0;0;0;0;284;6;278
244606083;500;643;643;4;243;499;1;0;0;0;0;243;4;239
244606084;100;34;34;2;35;63;2;35;2;0;33;0;0;0
244607001;700;525;525;9;260;699;1;0;0;0;0;260;2;258
244607002;500;422;423;9;226;499;1;0;0;0;0;226;4;222
244607003;700;456;456;7;225;699;1;0;0;0;0;225;0;225
244607004;700;711;712;7;378;699;1;0;0;0;0;378;4;374
244607005;700;933;933;9;434;699;1;0;0;0;0;434;5;429
244607006;700;693;694;5;344;699;1;0;0;0;0;344;2;342
244607007;700;931;931;10;480;700;0;0;0;0;0;480;5;475
244607008;700;727;728;9;344;699;1;0;0;0;0;344;5;339
244607009;700;703;705;22;357;699;1;0;0;0;0;357;8;349
244607010;700;677;677;25;349;699;1;0;0;0;0;349;3;346
244607011;700;505;508;17;287;699;1;0;0;0;0;287;3;284
244607012;700;569;569;6;266;699;1;0;0;0;0;266;9;257
244607013;500;429;429;8;196;499;1;0;0;0;0;196;1;195
244607014;700;763;763;7;381;700;0;0;0;0;0;381;1;380
244607015;700;586;586;16;295;700;0;0;0;0;0;295;9;286
244607016;700;743;743;8;374;700;0;0;0;0;0;374;5;369
244607017;700;831;831;6;421;699;1;0;0;0;0;421;5;416
244607018;700;616;619;11;308;699;1;0;0;0;0;308;5;303
244607019;700;721;722;5;364;700;0;0;0;0;0;364;6;358
244607020;700;621;621;7;284;699;1;0;0;0;0;284;4;280
244607021;700;873;873;7;397;699;1;0;0;0;0;397;6;391
244607022;700;497;500;13;164;699;1;0;0;0;0;164;1;163
244607023;700;559;563;8;295;699;1;0;0;0;0;295;6;289
244607024;700;730;730;6;370;699;1;0;0;0;0;364;8;356
244607025;700;808;808;7;359;699;1;0;0;0;0;359;4;355
244607026;700;616;616;6;350;699;1;0;0;0;0;350;4;346
244607027;500;432;432;5;199;499;1;0;0;0;0;199;2;197
244607028;700;836;836;17;424;699;1;0;0;0;0;424;8;416
244607029;700;656;657;16;354;699;1;0;0;0;0;354;4;350
244607030;700;575;575;6;273;699;1;0;0;0;0;273;2;271
244607031;700;486;486;8;226;700;0;0;0;0;0;226;3;223
244607032;700;653;653;11;349;700;0;0;0;0;0;349;3;346
244607033;700;594;595;7;305;699;1;0;0;0;0;305;1;304
244607034;700;604;606;7;305;699;1;0;0;0;0;305;7;298
244607035;700;545;545;8;279;700;0;0;0;0;0;279;3;276
244607036;700;920;920;9;453;699;1;0;0;0;0;453;2;451
244607037;700;802;802;8;401;699;1;0;0;0;0;401;4;397
244607038;700;649;649;8;332;700;0;0;0;0;0;332;8;324
244607039;800;801;801;8;416;799;1;0;0;0;0;416;4;412
244607040;700;874;874;17;419;700;0;0;0;0;0;419;7;412
244607041;630;630;630;4;335;629;1;0;0;0;0;335;2;333
244607042;700;912;916;9;429;699;1;0;0;0;0;429;7;422
244607043;700;956;956;9;499;699;1;0;0;0;0;499;7;492
244607044;700;818;819;9;447;700;0;0;0;0;0;447;5;442
244607045;700;794;794;7;384;700;0;0;0;0;0;384;7;377
244607046;700;803;803;5;379;699;1;0;0;0;0;379;7;372
244607047;870;870;870;17;398;869;1;0;0;0;0;398;9;389
244607048;700;826;826;6;412;699;1;0;0;0;0;412;9;403
244607049;700;698;698;8;326;699;1;0;0;0;0;326;5;321
244607050;700;696;696;4;331;699;1;0;0;0;0;331;7;324
244607051;700;564;564;7;272;699;1;0;0;0;0;272;3;269
244607052;700;741;741;7;342;699;1;0;0;0;0;342;3;339
244607053;700;441;442;12;178;699;1;0;0;0;0;178;4;174
244607054;700;494;494;5;198;700;0;0;0;0;0;198;5;193
244607055;700;943;944;8;413;699;1;0;0;0;0;413;9;404
244607056;700;519;519;6;225;699;1;0;0;0;0;225;5;220
244607057;700;600;600;5;254;699;1;0;0;0;0;254;3;251
244607058;700;593;593;6;254;700;0;0;0;0;0;254;5;249
244607059;700;911;911;6;439;699;1;0;0;0;0;439;13;426
244607060;700;907;908;7;434;700;0;0;0;0;0;434;8;426
244607061;700;462;462;7;185;699;1;0;0;0;0;185;1;184
244607062;700;834;834;5;356;699;1;0;0;0;0;356;4;352
244607063;700;476;477;17;249;699;1;0;0;0;0;249;4;245
244607064;700;467;467;9;208;699;1;0;0;0;0;208;2;206
244607065;700;559;559;8;234;700;0;0;0;0;0;234;9;225
244607066;700;606;609;7;241;699;1;0;0;0;0;241;4;237
244607067;700;522;522;9;208;700;0;0;0;0;0;208;2;206
244607068;700;640;641;8;224;699;1;0;0;0;0;224;6;218
244607069;700;663;663;5;267;700;0;0;0;0;0;267;8;259
244607070;700;536;536;5;79;700;0;0;0;0;0;79;0;79
244607071;700;835;838;5;87;700;0;0;0;0;0;87;0;87
244607072;700;517;517;5;90;700;0;0;0;0;0;90;1;89
244607073;700;880;880;4;119;700;0;0;0;0;0;119;1;118
244607074;700;783;783;5;100;700;0;0;0;0;0;100;1;99
244607075;700;790;792;5;164;700;0;0;0;0;0;164;2;162
244607076;700;640;640;8;117;700;0;0;0;0;0;117;1;116
244607077;700;914;914;9;128;700;0;0;0;0;0;128;0;128
244607078;700;323;323;40;125;699;1;0;0;0;0;125;4;121
244607079;700;488;488;5;216;699;1;0;0;0;0;216;7;209
244607080;700;970;971;9;545;700;0;0;0;0;0;545;9;536
244607081;700;705;706;9;372;700;0;0;0;0;0;372;5;367
244607082;700;555;555;9;291;699;1;0;0;0;0;291;2;289
244607083;700;596;598;5;315;699;1;0;0;0;0;315;5;310
244607084;700;764;765;6;400;699;1;0;0;0;0;400;4;396
244607085;700;638;638;9;335;699;1;0;0;0;0;335;3;332
244607086;100;32;32;6;38;62;0;38;0;1;37;0;0;0
244614001;500;690;690;12;321;499;1;0;0;0;0;321;9;312
244614002;500;740;740;8;316;499;1;0;0;0;0;316;6;310
244614003;500;706;707;5;286;499;1;0;0;0;0;286;6;280
244614004;500;793;793;7;311;499;1;0;0;0;0;311;6;305
244614005;500;826;826;4;310;499;1;0;0;0;0;310;7;303
244614006;500;810;811;5;285;499;1;0;0;0;0;285;3;282
244614007;500;762;762;5;267;499;1;0;0;0;0;267;3;264
244614008;500;698;698;5;302;499;1;0;0;0;0;302;5;297
244614009;500;705;705;6;250;499;1;0;0;0;0;250;3;247
244614010;500;763;763;5;297;499;1;0;0;0;0;297;4;293
244614011;500;654;657;16;285;499;1;0;0;0;0;285;7;278
244614012;500;764;764;4;277;499;1;0;0;0;0;277;8;269
244614013;500;714;714;5;285;499;1;0;0;0;0;285;5;280
244614014;500;858;858;3;321;499;1;0;0;0;0;321;9;312
244614015;500;796;796;5;305;499;1;0;0;0;0;305;8;297
244614016;500;840;842;3;324;499;1;0;0;0;0;324;5;319
244614017;500;702;702;6;310;499;1;0;0;0;0;310;8;302
244614018;500;712;712;5;238;499;1;0;0;0;0;238;4;234
244614019;500;951;953;5;246;499;1;0;0;0;0;246;1;245
244614021;500;627;631;19;270;499;1;0;0;0;0;270;4;266
244614022;500;744;744;6;262;499;1;0;0;0;0;262;1;261
244614023;500;649;694;6;308;499;1;0;0;0;0;308;8;300
244614024;500;919;919;13;257;499;1;0;0;0;0;257;11;246
244614025;500;659;659;7;247;499;1;0;0;0;0;247;4;243
244614026;500;761;761;14;319;499;1;0;0;0;0;319;4;315
244614027;500;768;768;8;303;499;1;0;0;0;0;303;7;296
244614028;500;630;631;6;240;499;1;0;0;0;0;240;4;236
244614029;500;735;738;5;266;499;1;0;0;0;0;266;4;262
244614030;500;737;738;6;210;499;1;0;0;0;0;210;9;201
244614031;500;860;861;19;385;499;1;0;0;0;0;385;4;381
244614032;500;724;726;9;329;499;1;0;0;0;0;329;2;327
244614033;500;678;683;7;278;499;1;0;0;0;0;278;9;269
244614034;500;654;654;7;294;499;1;0;0;0;0;294;7;287
244614035;500;743;745;2;304;499;1;0;0;0;0;304;12;292
244614036;500;699;700;3;270;499;1;0;0;0;0;270;6;264
244614037;500;746;747;6;289;499;1;0;0;0;0;289;2;287
244614038;500;711;712;4;293;499;1;0;0;0;0;293;3;290
244614039;500;681;681;2;277;499;1;0;0;0;0;277;11;266
244614040;500;859;859;9;393;499;1;0;0;0;0;393;12;381
244614041;500;758;759;5;310;499;1;0;0;0;0;310;7;303
244614042;500;811;814;2;317;499;1;0;0;0;0;317;7;310
244614043;500;646;646;14;277;499;1;0;0;0;0;277;11;266
244614044;500;674;675;4;317;499;1;0;0;0;0;317;6;311
244614045;500;715;715;7;327;499;1;0;0;0;0;327;9;318
244614046;500;731;733;7;330;500;0;0;0;0;0;330;7;323
244614047;500;711;701;10;329;499;1;0;0;0;0;329;3;326
244614048;500;680;680;4;291;499;1;0;0;0;0;291;5;286
244614049;500;682;682;7;313;499;1;0;0;0;0;313;6;307
244614050;500;774;775;9;315;499;1;0;0;0;0;315;6;309
244614051;500;641;642;9;264;499;1;0;0;0;0;264;3;261
244614052;500;623;623;7;286;499;1;0;0;0;0;286;2;284
244614053;500;683;684;7;312;499;1;0;0;0;0;312;5;307
244614054;500;717;717;4;305;500;0;0;0;0;0;305;10;295
244614055;500;806;807;11;475;499;1;0;0;0;0;475;4;471
244614056;500;773;773;7;442;499;1;0;0;0;0;442;6;436
244614057;500;865;865;8;383;499;1;0;0;0;0;383;6;377
244614058;500;797;799;7;422;499;1;0;0;0;0;422;5;417
244614059;500;819;819;2;385;499;1;0;0;0;0;385;5;380
244614060;500;815;815;7;409;500;0;0;0;0;0;409;9;400
244614061;500;713;713;5;301;499;1;0;0;0;0;301;2;299
244614062;500;777;779;7;302;499;1;0;0;0;0;302;8;294
244614063;500;745;745;8;332;499;1;0;0;0;0;332;3;329
244614064;500;750;750;11;360;499;1;0;0;0;0;360;2;358
244614065;500;692;692;9;303;499;1;0;0;0;0;303;9;294
244614066;500;755;756;10;320;499;1;0;0;0;0;320;11;309
244614067;500;633;633;6;286;499;1;0;0;0;0;286;5;281
244614068;500;638;638;5;320;499;1;0;0;0;0;320;6;314
244614069;500;658;659;6;279;500;0;0;0;0;0;279;5;274
244614070;500;679;679;3;263;499;1;0;0;0;0;263;3;260
244614071;500;669;669;6;283;499;1;0;0;0;0;283;12;271
244614072;500;640;640;6;286;500;0;0;0;0;0;286;7;279
244614073;500;750;750;8;321;499;1;0;0;0;0;321;7;314
244614074;500;607;609;3;341;500;0;0;0;0;0;341;4;337
244614075;500;895;899;4;230;499;1;0;0;0;0;230;3;227
244614076;500;741;741;2;225;499;1;0;0;0;0;225;5;220
244614077;500;701;703;11;309;499;1;0;0;0;0;309;6;303
244614078;500;672;672;2;268;499;1;0;0;0;0;268;8;260
244622001;500;804;804;9;278;499;1;0;0;0;0;278;10;268
244622002;400;776;779;3;304;399;1;0;0;0;0;304;8;296
244622003;300;622;622;4;206;299;1;0;0;0;0;206;3;203
244622004;500;934;935;5;375;499;1;0;0;0;0;375;4;371
244622005;400;663;664;5;241;399;1;0;0;0;0;241;6;235
244622006;400;678;679;6;271;399;1;0;0;0;0;271;8;263
244622007;500;699;699;4;283;499;1;0;0;0;0;283;1;282
244622008;300;865;867;3;148;299;1;0;0;0;0;148;1;147
244622009;300;740;740;2;151;299;1;0;0;0;0;151;2;149
244622010;300;816;816;4;145;299;1;0;0;0;0;145;2;143
244622011;300;911;911;6;168;299;1;0;0;0;0;168;4;164
244622012;300;959;960;1;192;299;1;0;0;0;0;192;2;190
244622013;300;932;933;3;162;300;0;0;0;0;0;162;1;161
244622014;300;565;565;9;161;299;1;0;0;0;0;161;2;159
244622015;400;639;640;2;227;399;1;0;0;0;0;227;9;218
244622016;300;759;759;3;161;299;1;0;0;0;0;161;3;158
244622017;300;678;678;2;188;299;1;0;0;0;0;188;3;185
244622018;600;912;912;6;306;599;1;0;0;0;0;306;12;294
244622019;400;653;653;4;178;399;1;0;0;0;0;178;2;176
244622020;300;571;572;3;160;299;1;0;0;0;0;160;1;159
244622021;300;432;433;4;152;299;1;0;0;0;0;152;1;151
244622022;300;542;542;4;186;299;1;0;0;0;0;186;4;182
244622023;500;891;892;8;273;499;1;0;0;0;0;273;5;268
244622024;300;392;392;6;168;299;1;0;0;0;0;168;0;168
244622025;300;475;475;6;180;299;1;0;0;0;0;180;2;178
244622026;300;443;443;6;179;299;1;0;0;0;0;179;2;177
244622027;300;489;489;5;196;299;1;0;0;0;0;196;3;193
244622028;400;542;542;9;211;399;1;0;0;0;0;211;5;206
254611001;500;610;612;8;271;500;0;0;0;0;0;271;3;268
254611002;500;720;721;3;300;500;0;0;0;0;0;300;7;293
254611003;500;629;629;6;293;500;0;0;0;0;0;293;6;287
254611004;500;535;535;7;239;500;0;0;0;0;0;239;3;236
254611005;500;500;699;6;321;500;0;0;0;0;0;321;4;317
254611006;500;597;597;25;116;500;0;0;0;0;0;116;3;113
254611007;500;925;925;10;418;500;0;0;0;0;0;418;4;414
254611008;500;534;535;6;250;500;0;0;0;0;0;250;2;248
254611009;500;711;711;6;283;500;0;0;0;0;0;283;7;276
254611010;500;824;824;10;335;500;0;0;0;0;0;335;4;331
254611011;500;568;569;6;261;500;0;0;0;0;0;261;3;258
254611012;500;571;571;45;297;500;0;0;0;0;0;297;8;289
254611013;500;799;799;7;352;500;0;0;0;0;0;352;8;344
254611014;821;821;822;3;382;821;0;0;0;0;0;382;3;379
254611015;500;663;663;5;292;500;0;0;0;0;0;292;2;290
254611016;500;760;761;5;315;469;0;31;0;0;31;284;11;273
254611017;500;733;734;8;357;500;0;0;0;0;0;357;7;350
254611018;500;850;850;6;422;500;0;0;0;0;0;422;13;409
254611019;500;750;750;6;352;500;0;0;0;0;0;352;5;347
254611020;500;500;792;3;336;500;0;0;0;0;0;336;7;329
254611021;500;680;682;6;293;500;0;0;0;0;0;293;4;289
254611022;500;605;605;6;263;500;0;0;0;0;0;263;3;260
254611023;500;628;628;8;283;500;0;0;0;0;0;283;8;275
254611024;500;725;725;2;313;500;0;0;0;0;0;313;6;307
254611025;500;644;645;5;265;500;0;0;0;0;0;265;10;255
254611026;500;525;525;4;191;500;0;0;0;0;0;191;3;188
254611027;500;484;484;38;221;500;0;0;0;0;0;221;7;214
254611028;500;688;690;7;315;500;0;0;0;0;0;315;8;307
254611029;500;559;559;5;199;500;0;0;0;0;0;199;6;193
254611030;500;559;559;9;256;500;0;0;0;0;0;256;2;254
254611031;500;664;664;7;288;500;0;0;0;0;0;288;7;281
254611032;500;654;655;5;300;500;0;0;0;0;0;300;8;292
254611033;500;534;534;6;232;500;0;0;0;0;0;232;4;228
254611034;500;678;679;7;313;500;0;0;0;0;0;313;8;305
254611035;500;717;717;7;303;500;0;0;0;0;0;303;3;300
254611036;500;606;606;14;252;500;0;0;0;0;0;252;7;245
254611037;500;670;670;6;270;500;0;0;0;0;0;270;3;267
254611038;500;603;603;3;237;500;0;0;0;0;0;237;5;232
254611039;500;720;720;6;314;500;0;0;0;0;0;314;4;310
254611040;500;874;875;6;299;500;0;0;0;0;0;299;2;297
254611041;500;514;515;3;210;500;0;0;0;0;0;210;4;206
254611042;500;617;617;6;297;500;0;0;0;0;0;297;11;286
254611043;500;629;630;8;245;500;0;0;0;0;0;245;0;245
254611044;500;533;533;5;220;500;0;0;0;0;0;220;4;216
254611045;500;656;656;5;285;500;0;0;0;0;0;285;3;282
254611046;500;639;640;7;249;500;0;0;0;0;0;249;2;247
254611047;500;651;651;4;271;500;0;0;0;0;0;271;4;267
254611048;500;609;609;4;260;499;1;0;0;0;0;260;4;256
254611049;500;492;492;8;196;500;0;0;0;0;0;196;7;189
254611050;500;488;488;8;213;500;0;0;0;0;0;213;5;208
254611051;500;687;687;4;304;500;0;0;0;0;0;304;4;300
254611052;500;555;555;7;266;500;0;0;0;0;0;266;10;256
254611053;500;514;514;7;219;500;0;0;0;0;0;219;4;215
254611054;500;656;656;9;290;500;0;0;0;0;0;290;6;284
254611055;500;607;608;8;284;500;0;0;0;0;0;284;6;278
254611056;500;604;604;7;23;500;0;0;0;0;0;23;0;23
254611057;500;806;808;5;163;500;0;0;0;0;0;163;1;162
254611058;500;630;630;11;43;500;0;0;0;0;0;43;0;43
254611059;500;901;901;6;99;500;0;0;0;0;0;99;0;99
254611060;500;935;935;12;113;500;0;0;0;0;0;113;3;110
254611061;500;939;940;6;45;500;0;0;0;0;0;45;0;45
254611062;500;918;918;7;29;500;0;0;0;0;0;29;1;28
254611063;500;578;578;7;66;500;0;0;0;0;0;66;3;63
254611064;500;923;923;3;51;500;0;0;0;0;0;51;0;51
254611065;500;844;845;5;41;500;0;0;0;0;0;41;0;41
254611066;500;825;825;6;39;500;0;0;0;0;0;39;3;36
254611067;500;850;850;5;113;500;0;0;0;0;0;113;1;112
254611068;100;60;60;49;61;39;0;61;3;3;55;0;0;0
254611069;500;599;599;5;258;500;0;0;0;0;0;258;4;254
254611070;500;561;561;5;200;500;0;0;0;0;0;200;4;196
254611071;500;903;904;7;37;499;1;0;0;0;0;37;0;37
254611073;100;77;77;79;90;10;0;90;4;2;84;0;0;0
254611074;500;579;579;6;37;500;0;0;0;0;0;37;0;37
254611075;200;415;417;7;14;200;0;0;0;0;0;14;0;14
254611076;200;472;472;7;19;200;0;0;0;0;0;19;0;19
254611078;100;32;32;8;39;61;0;39;0;0;39;0;0;0
254612001;500;958;958;7;453;499;1;0;0;0;0;453;12;441
254612002;500;915;915;6;372;499;1;0;0;0;0;372;6;366
254612003;500;883;885;7;382;499;1;0;0;0;0;382;6;376
254612004;500;846;846;7;369;499;1;0;0;0;0;369;12;357
254612005;500;785;785;10;318;499;1;0;0;0;0;318;3;315
254612006;500;264;637;7;271;499;1;0;0;0;0;271;4;267
254612007;500;760;760;12;365;327;3;170;0;5;165;195;6;189
254612008;500;674;674;6;261;241;2;257;2;7;248;4;0;4
254612009;500;725;725;6;318;499;1;0;0;0;0;318;6;312
254612010;500;627;627;4;277;499;1;0;0;0;0;277;4;273
254612011;500;625;625;6;272;499;1;0;0;0;0;272;6;266
254612012;500;446;446;6;180;499;1;0;0;0;0;180;5;175
254612013;500;530;529;5;189;499;1;0;0;0;0;189;6;183
254612014;500;610;610;5;212;288;2;210;2;2;206;2;0;2
254612015;500;680;681;8;328;499;1;0;0;0;0;328;6;322
254612016;600;681;683;8;343;599;1;0;0;0;0;343;2;341
254612017;500;914;914;9;438;499;1;0;0;0;0;438;7;431
254612018;500;637;637;8;277;499;1;0;0;0;0;277;4;273
254612019;500;469;469;10;233;499;1;0;0;0;0;233;5;228
254612020;500;654;654;27;334;499;1;0;0;0;0;334;8;326
254612021;500;673;673;7;307;499;1;0;0;0;0;307;6;301
254612022;500;813;813;12;386;498;2;0;0;0;0;386;11;375
254612023;500;894;896;8;433;499;1;0;0;0;0;433;5;428
254612024;500;695;695;9;331;500;0;0;0;0;0;331;6;325
254612025;500;731;731;8;387;500;0;0;0;0;0;387;8;379
254612026;500;645;645;4;278;500;0;0;0;0;0;278;0;278
254612027;500;845;846;7;385;499;1;0;0;0;0;385;5;380
254612028;500;732;732;7;303;499;1;0;0;0;0;303;9;294
254612029;500;703;703;4;322;499;1;0;0;0;0;322;1;321
254612030;500;768;768;7;353;499;1;0;0;0;0;353;5;348
254612031;500;750;750;7;350;499;1;0;0;0;0;350;5;345
254612032;500;798;798;6;391;499;1;0;0;0;0;391;6;385
254612033;500;715;716;6;307;499;1;0;0;0;0;307;6;301
254612034;500;611;611;21;309;499;1;0;0;0;0;309;2;307
254612035;500;680;680;9;253;499;1;0;0;0;0;253;11;242
254612036;500;670;670;8;307;499;1;0;0;0;0;307;4;303
254612037;500;530;530;16;243;500;0;0;0;0;0;243;4;239
254612038;500;673;666;7;319;218;1;281;6;8;267;38;0;38
254612039;500;723;723;5;322;499;1;0;0;0;0;322;3;319
254612040;300;374;374;18;185;300;0;0;0;0;0;185;4;181
254612041;200;18;18;77;95;104;1;95;5;0;90;0;0;0
254613001;400;703;703;12;303;400;0;0;0;0;0;303;2;301
254613002;300;691;691;8;304;300;0;0;0;0;0;304;2;302
254613003;400;865;866;21;365;400;0;0;0;0;0;365;6;359
254613004;400;864;864;3;355;400;0;0;0;0;0;355;4;351
254613005;500;905;905;6;395;500;0;0;0;0;0;395;4;391
254613006;400;847;850;3;185;400;0;0;0;0;0;185;1;184
254613007;400;775;778;4;330;400;0;0;0;0;0;330;7;323
254613008;400;709;710;7;308;400;0;0;0;0;0;308;5;303
254613009;400;879;883;4;383;400;0;0;0;0;0;383;11;372
254613010;400;869;869;6;377;399;1;0;0;0;0;377;5;372
254613011;500;946;946;22;397;499;1;0;0;0;0;397;8;389
254613012;500;907;909;8;370;499;1;0;0;0;0;370;4;366
254613013;500;906;907;6;361;499;1;0;0;0;0;361;11;350
254613014;500;919;919;7;337;499;1;0;0;0;0;337;4;333
254613015;500;965;966;7;392;499;1;0;0;0;0;392;10;382
254613016;500;920;920;8;369;499;1;0;0;0;0;369;3;366
254613017;400;841;843;8;306;400;0;0;0;0;0;306;12;294
254613018;400;864;865;6;337;400;0;0;0;0;0;337;4;333
254613019;500;922;923;6;309;499;1;0;0;0;0;309;7;302
254613020;500;901;901;6;366;500;0;0;0;0;0;366;4;362
254613021;400;882;884;5;294;400;0;0;0;0;0;294;6;288
254613022;500;945;945;5;344;499;1;0;0;0;0;344;6;338
254613023;500;946;946;6;342;499;1;0;0;0;0;342;8;334
254613024;500;963;963;5;362;499;1;0;0;0;0;362;6;356
254613025;500;973;974;6;386;499;1;0;0;0;0;386;9;377
254613026;400;843;843;12;354;399;1;0;0;0;0;354;4;350
254613027;400;817;818;9;321;399;1;0;0;0;0;321;2;319
254613028;400;895;895;5;342;399;1;0;0;0;0;342;4;338
254613029;400;902;903;5;342;399;1;0;0;0;0;342;4;338
254613030;400;874;876;8;306;399;1;0;0;0;0;306;5;301
254613031;400;790;790;9;295;399;1;0;0;0;0;295;9;286
254613032;400;812;813;3;312;399;1;0;0;0;0;312;5;307
254613033;400;797;799;8;338;399;1;0;0;0;0;338;4;334
254613034;400;866;867;20;342;399;1;0;0;0;0;342;7;335
254613035;400;869;869;5;313;400;0;0;0;0;0;313;3;310
254613036;400;871;872;6;341;399;1;0;0;0;0;341;4;337
254613037;500;917;917;9;390;499;1;0;0;0;0;390;7;383
254613038;400;865;865;5;314;399;1;0;0;0;0;314;4;310
254613039;500;905;909;6;320;499;1;0;0;0;0;320;5;315
254613040;500;911;911;9;365;499;1;0;0;0;0;365;5;360
254613041;500;965;967;7;403;499;1;0;0;0;0;403;9;394
254613042;400;893;894;5;366;399;1;0;0;0;0;366;10;356
254613043;500;913;914;7;377;499;1;0;0;0;0;377;4;373
254613044;500;927;931;5;316;499;1;0;0;0;0;316;5;311
254613045;400;895;895;6;383;399;1;0;0;0;0;383;4;379
254613046;400;755;756;6;299;399;1;0;0;0;0;299;3;296
254613047;400;808;810;8;331;399;1;0;0;0;0;331;4;327
254613048;400;851;854;20;347;399;1;0;0;0;0;347;4;343
254613049;400;851;852;5;367;399;1;0;0;0;0;367;10;357
254613050;400;889;889;8;342;399;1;0;0;0;0;342;3;339
254613051;400;758;758;8;319;399;1;0;0;0;0;319;5;314
254613052;300;668;669;8;279;299;1;0;0;0;0;279;5;274
254613053;400;817;819;6;359;400;0;0;0;0;0;359;7;352
254613054;860;860;860;5;379;860;0;0;0;0;0;379;10;369
254613055;400;713;716;7;320;400;0;0;0;0;0;320;5;315
254613056;400;822;822;6;247;400;0;0;0;0;0;247;4;243
254613057;400;837;839;8;341;399;1;0;0;0;0;341;8;333
254613058;400;728;728;8;303;399;1;0;0;0;0;303;7;296
254613059;500;783;783;8;319;500;0;0;0;0;0;319;6;313
254613060;400;814;814;6;301;399;1;0;0;0;0;301;3;298
254613061;300;675;675;8;245;299;1;0;0;0;0;245;4;241
254613062;400;745;746;6;275;399;1;0;0;0;0;275;1;274
254613063;400;863;865;8;344;399;1;0;0;0;0;344;7;337
254613064;500;914;914;10;335;499;1;0;0;0;0;335;8;327
254613065;400;883;883;4;343;399;1;0;0;0;0;343;8;335
254613066;400;735;736;6;294;400;0;0;0;0;0;294;6;288
254613067;400;826;826;4;319;399;1;0;0;0;0;319;2;317
254613068;400;777;777;6;365;399;1;0;0;0;0;365;9;356
254613069;400;866;866;2;302;399;1;0;0;0;0;302;10;292
254613070;300;597;597;5;257;299;1;0;0;0;0;257;5;252
254613071;300;614;614;5;287;299;1;0;0;0;0;287;10;277
254613072;100;21;21;4;25;73;2;25;1;0;24;0;0;0
254618001;600;547;548;6;252;599;1;0;0;0;0;252;4;248
254618002;900;869;870;10;463;900;0;0;0;0;0;463;11;452
254618003;700;671;672;9;338;700;0;0;0;0;0;338;4;334
254618004;800;750;750;3;363;800;0;0;0;0;0;363;11;352
254618005;800;649;649;6;325;800;0;0;0;0;0;325;6;319
254618006;811;818;811;7;351;811;0;0;0;0;0;351;6;345
254618007;700;659;659;9;279;699;1;0;0;0;0;279;6;273
254618008;800;746;746;7;349;799;1;0;0;0;0;349;10;339
254618009;800;844;846;2;400;799;1;0;0;0;0;400;6;394
254618010;700;728;728;5;362;700;0;0;0;0;0;362;2;360
254618011;700;691;691;6;306;699;1;0;0;0;0;306;4;302
254618012;700;683;683;6;335;699;1;0;0;0;0;335;9;326
254618013;700;645;645;4;301;699;1;0;0;0;0;301;9;292
254618014;600;630;630;1;282;599;1;0;0;0;0;282;6;276
254618015;600;603;603;7;290;599;1;0;0;0;0;290;10;280
254618016;800;805;805;3;335;800;0;0;0;0;0;335;5;330
254618017;700;653;653;5;266;699;1;0;0;0;0;266;9;257
254618018;700;689;689;7;311;699;1;0;0;0;0;311;10;301
254618019;700;731;734;7;309;700;0;0;0;0;0;309;0;309
254618020;700;693;693;5;323;700;0;0;0;0;0;323;4;319
254618021;600;578;579;8;255;599;1;0;0;0;0;255;6;249
254618022;800;790;790;3;346;799;1;0;0;0;0;346;4;342
254618023;700;649;650;5;267;699;1;0;0;0;0;267;5;262
254618024;800;812;815;5;370;799;1;0;0;0;0;370;10;360
254618025;500;509;496;13;214;500;0;0;0;0;0;214;4;210
254618026;700;691;691;3;287;699;1;0;0;0;0;287;5;282
254618027;600;537;539;5;225;599;1;0;0;0;0;225;2;223
254618028;700;710;711;7;282;700;0;0;0;0;0;282;9;273
254618029;700;645;649;6;323;700;0;0;0;0;0;323;4;319
254618030;600;617;618;8;301;599;1;0;0;0;0;301;7;294
254618031;600;599;599;9;309;600;0;0;0;0;0;309;6;303
254618032;700;713;714;8;278;700;0;0;0;0;0;278;3;275
254618033;500;511;511;6;247;499;1;0;0;0;0;247;4;243
254618034;700;735;735;5;321;699;1;0;0;0;0;321;6;315
254618035;600;544;544;8;288;599;1;0;0;0;0;288;1;287
254618036;900;840;843;4;368;900;0;0;0;0;0;368;7;361
254618037;700;682;682;5;335;700;0;0;0;0;0;335;2;333
254618038;700;676;676;7;293;699;1;0;0;0;0;293;6;287
254618039;800;753;754;4;304;799;1;0;0;0;0;304;5;299
254618040;600;598;598;3;282;599;1;0;0;0;0;282;7;275
254618041;700;663;663;5;275;699;1;0;0;0;0;275;7;268
254618042;700;692;692;7;321;698;2;0;0;0;0;321;6;315
254618043;650;651;651;3;296;650;0;0;0;0;0;296;8;288
254618044;700;711;711;6;306;699;1;0;0;0;0;306;9;297
254618045;100;28;28;53;69;30;1;69;10;2;57;0;0;0
254618046;600;589;591;4;294;599;1;0;0;0;0;294;5;289
254618047;500;503;503;24;226;500;0;0;0;0;0;226;4;222
254618048;700;653;654;8;310;700;0;0;0;0;0;310;7;303
254618049;900;863;863;4;391;900;0;0;0;0;0;391;3;388
254618050;800;756;756;6;399;800;0;0;0;0;0;399;11;388
254618051;700;698;698;5;328;699;1;0;0;0;0;328;9;319
254618052;600;600;600;14;247;600;0;0;0;0;0;247;6;241
254618053;518;518;519;7;263;518;0;0;0;0;0;263;7;256
254618054;800;783;783;5;357;799;1;0;0;0;0;357;5;352
254618055;800;783;783;6;416;800;0;0;0;0;0;416;8;408
254618056;600;554;555;8;219;599;1;0;0;0;0;219;1;218
254618057;600;608;608;3;293;600;0;0;0;0;0;293;5;288
254618058;600;567;567;5;258;599;1;0;0;0;0;258;6;252
254618059;500;500;501;25;238;499;1;0;0;0;0;238;6;232
254618060;600;551;551;10;241;600;0;0;0;0;0;241;0;241
254618061;900;854;854;8;405;900;0;0;0;0;0;405;11;394
254618062;800;760;760;7;367;799;1;0;0;0;0;367;7;360
254618063;400;575;575;8;316;399;1;0;0;0;0;316;4;312
254618064;600;602;603;4;273;599;1;0;0;0;0;273;7;266
254618065;600;579;579;5;292;599;1;0;0;0;0;292;6;286
254618066;600;620;620;7;263;599;1;0;0;0;0;263;5;258
254618067;600;542;542;7;227;599;1;0;0;0;0;227;5;222
254618068;600;534;535;10;271;598;2;0;0;0;0;271;6;265
254618069;600;613;613;5;289;599;1;0;0;0;0;289;11;278
254618070;600;572;573;6;260;600;0;0;0;0;0;260;6;254
254618071;700;638;638;4;284;700;0;0;0;0;0;284;3;281
254618073;100;18;18;20;35;65;0;35;1;1;33;0;0;0
254618074;200;55;55;25;56;142;2;56;1;3;52;0;0;0
254619001;500;849;849;8;363;500;0;0;0;0;0;363;7;356
254619002;300;500;500;10;227;299;1;0;0;0;0;227;2;225
254619003;400;774;774;7;278;399;1;0;0;0;0;278;1;277
254619004;400;793;793;6;211;399;1;0;0;0;0;211;1;210
254619005;400;747;747;7;293;399;1;0;0;0;0;293;7;286
254619006;400;726;726;5;212;400;0;0;0;0;0;212;3;209
254619007;400;685;686;8;287;397;3;0;0;0;0;287;2;285
254619008;300;558;558;7;232;299;1;0;0;0;0;232;7;225
254619009;400;662;664;8;277;399;1;0;0;0;0;277;9;268
254619010;300;593;593;5;204;299;1;0;0;0;0;204;5;199
254619011;400;687;687;9;282;399;1;0;0;0;0;282;5;277
254619012;200;301;301;9;100;199;1;0;0;0;0;100;4;96
254619013;300;486;487;7;178;299;1;0;0;0;0;178;1;177
254619014;400;712;712;12;295;399;1;0;0;0;0;295;4;291
254619015;500;859;859;13;316;500;0;0;0;0;0;316;11;305
254619016;500;908;909;7;202;500;0;0;0;0;0;202;2;200
254619017;400;720;720;4;297;399;1;0;0;0;0;297;5;292
254619018;400;754;754;7;306;399;1;0;0;0;0;306;6;300
254619019;300;507;510;6;188;299;1;0;0;0;0;188;3;185
254619020;400;620;620;6;251;399;1;0;0;0;0;251;5;246
254619021;400;720;720;8;293;399;1;0;0;0;0;293;5;288
254619022;400;687;687;7;270;399;1;0;0;0;0;270;7;263
254619023;500;858;862;8;295;499;1;0;0;0;0;295;3;292
254619024;500;834;834;6;306;499;1;0;0;0;0;306;8;298
254619025;500;937;938;6;457;499;1;0;0;0;0;457;7;450
254619026;400;698;698;15;294;399;1;0;0;0;0;294;6;288
254619027;400;722;724;5;300;400;0;0;0;0;0;300;2;298
254619028;400;708;708;6;312;400;0;0;0;0;0;312;7;305
254619029;400;780;780;6;320;399;1;0;0;0;0;320;9;311
254619030;500;824;827;7;345;500;0;0;0;0;0;345;4;341
254619031;500;710;710;6;264;500;0;0;0;0;0;264;8;256
254619032;400;693;693;6;264;399;1;0;0;0;0;264;5;259
254619033;400;759;759;4;287;400;0;0;0;0;0;287;3;284
254619034;400;765;765;5;288;400;0;0;0;0;0;288;7;281
254619035;500;887;888;9;365;500;0;0;0;0;0;365;4;361
254619036;400;697;697;3;298;400;0;0;0;0;0;298;9;289
254619037;400;655;655;8;289;400;0;0;0;0;0;289;6;283
254619038;500;883;884;7;389;500;0;0;0;0;0;389;6;383
254619039;500;919;921;7;423;500;0;0;0;0;0;423;4;419
254619040;400;776;776;5;309;400;0;0;0;0;0;309;3;306
254619041;400;651;651;7;264;399;1;0;0;0;0;264;3;261
254619042;300;567;569;8;258;299;1;0;0;0;0;258;4;254
254619043;400;617;618;3;259;399;1;0;0;0;0;259;9;250
254619044;400;643;644;4;285;399;1;0;0;0;0;285;8;277
254619045;500;737;738;4;284;499;1;0;0;0;0;284;6;278
254619046;500;821;826;7;232;498;2;0;0;0;0;232;2;230
254619047;400;592;594;9;268;399;1;0;0;0;0;268;13;255
254619048;400;649;652;8;266;399;1;0;0;0;0;266;3;263
254619049;400;807;810;6;374;399;1;0;0;0;0;374;8;366
254619050;400;698;699;7;275;399;1;0;0;0;0;275;6;269
254619051;400;592;592;4;244;400;0;0;0;0;0;244;1;243
254619052;400;779;779;8;334;400;0;0;0;0;0;334;4;330
254619053;400;756;758;10;346;399;1;0;0;0;0;346;9;337
254619054;500;806;811;10;226;499;1;0;0;0;0;226;5;221
254619055;500;947;948;5;330;499;1;0;0;0;0;330;5;325
254619056;400;772;774;2;298;399;1;0;0;0;0;298;7;291
254619057;400;734;735;5;293;399;1;0;0;0;0;293;5;288
254619058;400;754;755;11;287;399;1;0;0;0;0;287;5;282
254619059;500;838;838;9;319;500;0;0;0;0;0;319;5;314
254619060;400;740;740;5;294;400;0;0;0;0;0;294;6;288
254619061;500;690;692;8;288;499;1;0;0;0;0;288;3;285
254619062;400;632;633;3;256;399;1;0;0;0;0;256;3;253
254619063;400;746;746;5;299;399;1;0;0;0;0;299;7;292
254619064;400;695;697;9;288;399;1;0;0;0;0;288;5;283
254619065;500;892;892;9;337;499;1;0;0;0;0;337;3;334
254619066;400;649;651;4;214;399;1;0;0;0;0;214;7;207
254619067;400;689;689;6;293;399;1;0;0;0;0;293;6;287
254619068;500;828;830;6;379;500;0;0;0;0;0;379;7;372
254619069;500;856;856;5;366;500;0;0;0;0;0;366;10;356
254619070;400;808;808;15;357;400;0;0;0;0;0;357;8;349
254619071;400;694;694;7;80;400;0;0;0;0;0;80;0;80
254619072;400;684;684;6;60;400;0;0;0;0;0;60;2;58
254619073;500;948;949;7;403;499;1;0;0;0;0;403;6;397
254619074;500;808;808;5;348;497;3;0;0;0;0;348;6;342
254619075;500;951;952;4;418;499;1;0;0;0;0;418;5;413
254619076;400;784;784;5;338;399;1;0;0;0;0;338;9;329
254619077;400;738;739;6;273;399;1;0;0;0;0;273;2;271
254619078;400;669;670;4;252;399;1;0;0;0;0;252;5;247
254619079;400;681;681;5;233;399;1;0;0;0;0;233;3;230
254619080;400;790;790;3;317;399;1;0;0;0;0;317;7;310
254619081;400;778;781;6;279;399;1;0;0;0;0;279;6;273
254619082;500;911;912;5;381;499;1;0;0;0;0;381;6;375
254619083;500;933;933;7;360;499;1;0;0;0;0;360;8;352
254619084;400;702;702;18;293;399;1;0;0;0;0;293;5;288
254619085;400;606;606;9;289;399;1;0;0;0;0;289;9;280
254619086;400;749;751;9;305;399;1;0;0;0;0;305;4;301
254619087;400;675;675;5;283;399;1;0;0;0;0;283;2;281
254619088;400;667;668;4;281;399;1;0;0;0;0;281;4;277
254619089;500;894;896;6;396;499;1;0;0;0;0;396;4;392
254619090;500;437;985;5;437;500;0;0;0;0;0;437;3;434
254619091;500;871;873;3;347;499;1;0;0;0;0;347;7;340
254619092;500;877;878;6;226;499;1;0;0;0;0;226;2;224
254619093;400;653;656;6;294;399;1;0;0;0;0;294;5;289
254619094;400;730;730;3;275;399;1;0;0;0;0;275;5;270
254619095;400;630;631;6;264;399;1;0;0;0;0;264;3;261
254619096;500;829;831;7;383;499;1;0;0;0;0;383;5;378
254619097;500;827;827;3;319;499;1;0;0;0;0;319;4;315
254619098;500;933;934;8;403;499;1;0;0;0;0;403;4;399
254619099;500;934;934;4;390;500;0;0;0;0;0;390;6;384
254619100;500;867;867;9;372;499;1;0;0;0;0;372;11;361
254619101;500;932;933;7;410;499;1;0;0;0;0;410;14;396
254619102;500;862;862;6;360;500;0;0;0;0;0;360;4;356
254619103;500;893;898;6;378;500;0;0;0;0;0;378;15;363
254619104;500;885;885;5;366;499;1;0;0;0;0;366;6;360
254619105;500;993;993;4;407;500;0;0;0;0;0;407;3;404
254619106;500;853;854;7;330;499;1;0;0;0;0;330;6;324
254619107;500;852;852;7;343;499;1;0;0;0;0;343;7;336
254619108;400;291;719;5;296;399;1;0;0;0;0;296;5;291
254619109;500;858;858;6;362;499;1;0;0;0;0;362;4;358
254619110;500;928;928;7;350;499;1;0;0;0;0;350;9;341
254619111;500;837;838;8;329;499;1;0;0;0;0;329;3;326
254619112;400;654;654;6;275;399;1;0;0;0;0;275;7;268
254619113;400;633;633;6;257;399;1;0;0;0;0;257;5;252
254619114;400;789;789;4;319;399;1;0;0;0;0;319;5;314
254619115;500;915;916;6;345;499;1;0;0;0;0;345;4;341
254619116;400;608;608;5;260;399;1;0;0;0;0;260;3;257
254619117;400;755;755;11;324;400;0;0;0;0;0;324;12;312
254619118;400;631;632;4;270;399;1;0;0;0;0;270;10;260
254619119;400;735;735;7;287;399;1;0;0;0;0;287;7;280
254619120;400;694;694;5;286;399;1;0;0;0;0;286;10;276
254619121;400;816;816;5;372;399;1;0;0;0;0;372;11;361
254619122;500;971;971;8;454;499;1;0;0;0;0;454;13;441
254619123;400;816;816;8;395;400;0;0;0;0;0;395;6;389
254619124;400;768;769;4;335;399;1;0;0;0;0;335;6;329
254619125;300;592;592;6;254;299;1;0;0;0;0;254;2;252
254619126;400;707;708;3;313;399;1;0;0;0;0;313;8;305
254619127;400;701;702;4;313;399;1;0;0;0;0;313;5;308
254619128;400;678;679;5;285;399;1;0;0;0;0;285;7;278
254619129;500;854;856;6;349;499;1;0;0;0;0;349;7;342
254619130;500;864;860;5;380;499;1;0;0;0;0;380;13;367
254619131;200;312;312;10;149;199;1;0;0;0;0;149;7;142
254619132;400;658;659;6;47;399;1;0;0;0;0;47;0;47
254619133;100;40;40;5;44;55;1;44;0;0;44;0;0;0
254620001;400;732;732;8;322;399;1;0;0;0;0;322;12;310
254620002;400;592;592;11;255;399;1;0;0;0;0;255;5;250
254620003;400;623;623;5;254;398;2;0;0;0;0;254;6;248
254620004;400;587;588;6;233;399;1;0;0;0;0;233;3;230
254620005;500;842;842;6;316;499;1;0;0;0;0;316;4;312
254620006;500;899;899;11;369;500;0;0;0;0;0;369;11;358
254620007;400;665;665;6;303;399;1;0;0;0;0;303;5;298
254620008;500;741;741;14;357;499;1;0;0;0;0;357;6;351
254620009;400;752;752;7;244;398;2;0;0;0;0;244;8;236
254620010;400;751;753;6;272;399;1;0;0;0;0;272;1;271
254620011;400;735;736;2;251;399;1;0;0;0;0;251;4;247
254620012;400;697;698;4;257;399;1;0;0;0;0;257;7;250
254620013;400;753;753;4;306;399;1;0;0;0;0;306;6;300
254620014;500;840;840;3;281;500;0;0;0;0;0;281;6;275
254620015;400;664;666;4;248;400;0;0;0;0;0;248;7;241
254620016;400;818;818;5;325;398;2;0;0;0;0;325;7;318
254620017;400;682;684;4;243;399;1;0;0;0;0;243;7;236
254620018;400;726;726;5;278;399;1;0;0;0;0;278;6;272
254620019;400;783;784;4;311;399;1;0;0;0;0;311;8;303
254620020;300;575;576;2;205;300;0;0;0;0;0;205;2;203
254620021;400;784;784;6;243;400;0;0;0;0;0;243;2;241
254620022;500;822;822;6;247;500;0;0;0;0;0;247;4;243
254620023;500;812;812;2;319;499;1;0;0;0;0;319;7;312
254620024;400;785;787;7;306;400;0;0;0;0;0;306;5;301
254620025;400;709;711;6;292;399;1;0;0;0;0;292;2;290
254620026;400;656;657;5;218;399;1;0;0;0;0;218;6;212
254620027;400;639;639;3;263;399;1;0;0;0;0;263;2;261
254620028;400;740;740;4;350;399;1;0;0;0;0;350;9;341
254620029;400;683;685;6;290;399;1;0;0;0;0;290;6;284
254620030;400;756;756;6;324;399;1;0;0;0;0;324;2;322
254620031;500;751;751;6;359;499;1;0;0;0;0;359;9;350
254620032;300;551;552;6;167;299;1;0;0;0;0;167;2;165
254620033;400;774;775;11;340;400;0;0;0;0;0;340;4;336
254620034;400;608;609;9;284;399;1;0;0;0;0;284;4;280
254620035;400;727;728;8;351;399;1;0;0;0;0;351;3;348
254620036;400;780;781;4;315;399;1;0;0;0;0;315;2;313
254620037;400;701;702;5;319;400;0;0;0;0;0;319;10;309
254620038;500;893;893;5;402;500;0;0;0;0;0;402;6;396
254620039;400;694;694;6;289;179;1;220;0;4;216;69;0;69
254620040;500;866;867;10;219;499;1;0;0;0;0;219;5;214
254620041;500;941;941;17;252;499;1;0;0;0;0;252;2;250
254620042;500;374;920;7;374;500;0;0;0;0;0;374;8;366
254620043;500;890;890;7;330;499;1;0;0;0;0;330;7;323
254620044;400;646;648;5;249;399;1;0;0;0;0;249;4;245
254620045;300;620;620;0;75;300;0;0;0;0;0;75;1;74
254620046;500;879;880;6;272;499;1;0;0;0;0;272;2;270
254620047;500;808;808;10;316;499;1;0;0;0;0;316;11;305
254620048;200;348;350;8;155;200;0;0;0;0;0;155;2;153
254620049;400;800;802;4;319;398;2;0;0;0;0;319;7;312
254620050;500;835;836;5;343;498;2;0;0;0;0;343;6;337
254620051;500;833;833;10;302;499;1;0;0;0;0;302;4;298
254620052;500;898;899;6;389;500;0;0;0;0;0;389;6;383
254620053;400;704;704;3;288;399;1;0;0;0;0;288;3;285
254620054;500;861;861;9;97;499;1;0;0;0;0;97;0;97
254620055;300;504;504;5;215;299;1;0;0;0;0;215;6;209
254620056;400;586;586;11;254;399;1;0;0;0;0;254;10;244
254621001;500;452;453;7;205;499;1;0;0;0;0;205;6;199
254621002;500;443;443;2;174;499;1;0;0;0;0;174;0;174
254621004;500;529;529;7;276;499;1;0;0;0;0;276;5;271
254621005;600;567;568;4;253;600;0;0;0;0;0;253;9;244
254621006;600;644;645;5;251;599;1;0;0;0;0;251;9;242
254621007;600;572;574;6;225;599;1;0;0;0;0;225;8;217
254621008;700;855;855;8;392;700;0;0;0;0;0;392;10;382
254621009;700;861;862;3;388;699;1;0;0;0;0;388;7;381
254621010;800;754;754;8;307;573;4;223;1;4;218;84;0;84
254621011;700;656;656;3;250;699;1;0;0;0;0;250;10;240
254621012;800;798;798;4;301;799;1;0;0;0;0;301;5;296
254621013;800;819;819;5;301;799;1;0;0;0;0;301;5;296
254621014;600;566;566;5;227;599;1;0;0;0;0;227;4;223
254621015;800;819;819;9;316;799;1;0;0;0;0;316;6;310
254621016;700;713;715;0;273;699;1;0;0;0;0;273;5;268
254621017;700;717;717;4;253;699;1;0;0;0;0;253;3;250
254621018;800;759;759;0;258;799;1;0;0;0;0;258;6;252
254621019;600;671;672;2;243;599;1;0;0;0;0;243;9;234
254621020;600;632;632;6;169;599;1;0;0;0;0;169;6;163
254621021;600;598;599;5;208;599;1;0;0;0;0;208;7;201
254621022;500;446;446;5;165;499;1;0;0;0;0;165;7;158
254621023;500;529;533;4;213;499;1;0;0;0;0;213;6;207
254621024;700;786;786;7;394;699;1;0;0;0;0;394;6;388
254621025;500;556;557;6;329;499;1;0;0;0;0;329;9;320
254621026;500;640;642;4;254;499;1;0;0;0;0;254;3;251
254621027;600;588;588;5;237;599;1;0;0;0;0;237;6;231
254621028;600;641;642;3;203;599;1;0;0;0;0;203;8;195
254621029;500;546;548;6;338;499;1;0;0;0;0;338;7;331
254621030;600;628;631;6;280;599;1;0;0;0;0;280;7;273
254621031;500;560;561;7;315;499;1;0;0;0;0;315;8;307
254621032;500;519;520;2;191;499;1;0;0;0;0;191;2;189
254621033;500;483;483;3;211;499;1;0;0;0;0;211;7;204
254621034;500;513;516;3;202;499;1;0;0;0;0;202;6;196
254621035;500;497;498;5;188;499;1;0;0;0;0;188;1;187
254621036;600;605;605;0;253;599;1;0;0;0;0;253;4;249
254621037;600;626;626;7;290;600;0;0;0;0;0;290;6;284
254624001;700;764;764;9;364;699;1;0;0;0;0;364;7;357
254624002;600;731;731;9;397;599;1;0;0;0;0;397;2;395
254624003;800;954;954;3;411;800;0;0;0;0;0;411;7;404
254624004;900;854;854;7;407;899;1;0;0;0;0;407;9;398
254624005;900;935;936;23;416;899;1;0;0;0;0;416;9;407
254624006;900;940;940;8;393;899;1;0;0;0;0;393;4;389
254624007;700;749;750;7;356;699;1;0;0;0;0;356;9;347
254624008;900;983;983;8;416;900;0;0;0;0;0;416;7;409
254624009;600;582;582;8;285;599;1;0;0;0;0;285;6;279
254624010;400;439;439;7;218;400;0;0;0;0;0;218;7;211
254624011;700;768;768;5;379;699;1;0;0;0;0;379;9;370
254624012;100;78;78;8;40;59;1;40;2;2;36;0;0;0
254624013;700;776;777;10;354;699;1;0;0;0;0;354;8;346
254624014;400;469;469;8;238;399;1;0;0;0;0;238;6;232
254624015;300;136;136;23;85;214;1;85;5;1;79;0;0;0
254624016;200;114;114;79;153;45;2;153;3;0;150;0;0;0
254624017;100;14;14;34;48;50;2;48;3;1;44;0;0;0
254624018;100;65;65;14;56;43;1;56;0;3;53;0;0;0
260600001;700;721;721;6;316;699;1;0;0;0;0;316;7;309
260600002;600;609;610;7;308;599;1;0;0;0;0;308;2;306
260600003;600;643;644;2;283;599;1;0;0;0;0;283;5;278
260600004;700;795;798;4;362;699;1;0;0;0;0;362;13;349
260600005;600;595;595;6;266;599;1;0;0;0;0;266;6;260
260600006;800;830;832;5;367;799;1;0;0;0;0;367;6;361
260600007;500;276;523;4;276;499;1;0;0;0;0;276;2;274
260600008;400;463;464;6;242;399;1;0;0;0;0;242;6;236
260600009;400;444;446;2;200;399;1;0;0;0;0;200;1;199
260600010;300;300;301;7;162;137;1;162;4;2;156;0;0;0
260600011;200;224;224;5;137;62;1;137;1;3;133;0;0;0
260600012;100;102;101;7;58;41;1;58;0;2;56;0;0;0
260700001;600;596;596;7;317;600;0;0;0;0;0;317;3;314
260700002;700;710;710;7;328;699;1;0;0;0;0;328;2;326
260700003;800;800;906;9;393;800;0;0;0;0;0;393;3;390
260700004;800;841;845;8;388;799;1;0;0;0;0;388;5;383
260700005;700;779;779;7;378;699;1;0;0;0;0;378;5;373
260700006;800;853;854;7;380;799;1;0;0;0;0;380;5;375
260700007;800;942;944;0;442;799;1;0;0;0;0;442;9;433
260700008;800;797;798;9;364;799;1;0;0;0;0;364;6;358
260700009;600;660;662;10;318;599;1;0;0;0;0;318;7;311
260700010;700;736;737;12;320;699;1;0;0;0;0;320;4;316
260700011;800;880;880;6;393;799;1;0;0;0;0;393;11;382
260700012;800;791;792;8;227;799;1;0;0;0;0;227;0;227
260700013;900;818;818;4;339;899;1;0;0;0;0;339;3;336
260700014;500;542;543;3;174;499;1;0;0;0;0;174;6;168
260700015;800;931;935;8;117;799;1;0;0;0;0;117;0;117
260700016;800;809;813;6;168;799;1;0;0;0;0;168;3;165
260700017;700;693;696;6;298;699;1;0;0;0;0;298;6;292
260700018;800;887;887;8;428;799;1;0;0;0;0;428;3;425
260700019;700;713;714;7;167;699;1;0;0;0;0;167;2;165
260700020;700;713;714;0;300;699;1;0;0;0;0;300;9;291
260700021;700;785;785;8;351;699;1;0;0;0;0;351;4;347
260700022;755;755;755;6;324;754;1;0;0;0;0;324;3;321
260700023;800;784;784;4;342;800;0;0;0;0;0;342;1;341
260700024;100;72;72;8;56;43;1;56;0;1;55;0;0;0
260700025;700;714;716;4;276;699;1;0;0;0;0;276;2;274
260700026;600;691;692;5;327;599;1;0;0;0;0;327;4;323
260700027;400;468;468;4;228;399;1;0;0;0;0;228;2;226
260700028;600;692;695;7;271;599;1;0;0;0;0;271;10;261
260700029;700;746;748;5;243;699;1;0;0;0;0;243;0;243
260700030;600;631;633;4;248;599;1;0;0;0;0;248;1;247
260700031;500;563;563;7;206;499;1;0;0;0;0;206;2;204
260700032;400;414;415;1;149;399;1;0;0;0;0;149;2;147
260700033;100;70;70;5;55;44;1;55;1;0;54;0;0;0
260700034;100;85;85;8;53;46;1;53;2;0;51;0;0;0
260700035;100;34;34;7;31;66;3;31;2;0;29;0;0;0
260700036;600;702;703;5;194;599;1;0;0;0;0;194;4;190
260700037;600;685;687;6;160;599;1;0;0;0;0;160;1;159
260700038;200;176;176;7;102;93;5;102;3;0;99;0;0;0
260700039;100;97;97;5;62;37;1;62;1;3;58;0;0;0
260700040;100;105;105;4;62;37;1;62;3;1;58;0;0;0
260700041;700;769;770;5;273;699;1;0;0;0;0;273;4;269
260700042;600;669;671;0;258;599;1;0;0;0;0;258;7;251
260700043;700;765;767;1;278;699;1;0;0;0;0;278;2;276
260700044;500;555;556;2;212;499;1;0;0;0;0;212;0;212
260700045;100;30;30;16;22;77;1;22;2;0;20;0;0;0
260900001;600;706;707;2;228;599;1;0;0;0;0;228;4;224
260900002;600;670;670;7;243;599;1;0;0;0;0;243;4;239
260900003;700;757;757;4;284;699;1;0;0;0;0;284;7;277
260900004;600;627;629;9;250;599;1;0;0;0;0;250;4;246
260900005;800;928;931;4;289;799;1;0;0;0;0;289;4;285
260900006;200;147;148;6;100;99;1;100;0;1;99;0;0;0
260900007;100;55;55;8;47;52;1;47;0;0;47;0;0;0
260900008;100;79;79;7;51;48;1;51;1;0;50;0;0;0
260900009;200;135;135;7;96;103;1;96;0;2;94;0;0;0
260900010;100;77;77;8;49;50;1;49;1;1;47;0;0;0
260900011;200;152;152;6;85;114;1;85;2;1;82;0;0;0
261000001;500;628;629;2;279;499;1;0;0;0;0;279;3;276
261000002;500;527;527;3;216;499;1;0;0;0;0;216;7;209
261000003;400;452;452;4;165;399;1;0;0;0;0;165;5;160
261000004;200;225;225;3;112;87;1;112;2;1;109;0;0;0
261000005;250;261;261;2;122;126;2;122;5;0;117;0;0;0
261000006;700;821;821;5;349;699;1;0;0;0;0;349;1;348
261000007;150;144;144;3;98;50;2;98;4;0;94;0;0;0
261000008;150;147;148;6;86;63;1;86;5;1;80;0;0;0
261000009;200;195;195;2;116;83;1;116;2;0;114;0;0;0
261000010;200;190;190;6;104;95;1;104;6;4;94;0;0;0
261000011;200;213;213;3;109;89;2;109;3;1;105;0;0;0
261000012;150;135;135;6;79;70;1;79;2;2;75;0;0;0
261000013;300;353;354;4;192;299;1;0;0;0;0;192;1;191
261000014;200;217;217;3;107;92;1;107;7;1;99;0;0;0
261000015;200;184;184;5;103;96;1;103;2;0;101;0;0;0
261600001;400;626;626;6;247;399;1;0;0;0;0;247;5;242
261600002;400;610;610;8;265;399;1;0;0;0;0;265;3;262
261600003;300;524;524;6;247;299;1;0;0;0;0;247;5;242
261600004;500;693;693;4;285;499;1;0;0;0;0;285;5;280
261600005;300;301;301;2;146;153;1;146;2;4;140;0;0;0
261600006;100;53;53;8;53;45;2;53;6;1;46;0;0;0
261600007;100;59;59;6;37;62;1;37;2;0;35;0;0;0
261600008;200;113;113;3;64;135;1;64;3;5;56;0;0;0
261600009;50;30;30;7;30;19;1;30;1;2;27;0;0;0
261600010;100;47;47;4;40;59;1;40;1;0;39;0;0;0
261600011;100;63;63;7;59;40;1;59;1;0;58;0;0;0
261600012;100;39;40;7;39;60;1;39;1;0;38;0;0;0
261600013;200;113;113;6;37;162;1;37;2;0;35;0;0;0
261600014;200;139;139;5;68;131;1;68;4;0;64;0;0;0
261600015;300;408;410;2;178;299;1;0;0;0;0;178;2;176
261600016;100;69;69;6;49;50;1;49;2;0;47;0;0;0
261600017;150;92;92;7;63;85;2;63;1;0;62;0;0;0
261600018;50;25;25;8;23;26;1;23;1;0;22;0;0;0
261600019;150;92;92;7;46;103;1;46;0;0;46;0;0;0
261600020;100;44;44;7;39;60;1;39;1;1;37;0;0;0
261700001;700;791;790;4;320;699;1;0;0;0;0;320;5;315
261700002;600;602;604;1;235;599;1;0;0;0;0;235;9;226
261700003;700;769;769;2;292;699;1;0;0;0;0;292;6;286
261700004;900;993;993;11;378;899;1;0;0;0;0;378;3;375
261700005;900;932;932;4;341;899;1;0;0;0;0;341;6;335
261700006;900;941;941;10;394;899;1;0;0;0;0;394;6;388
261700007;700;725;725;1;221;699;1;0;0;0;0;221;6;215
261700008;100;22;22;9;25;74;1;25;0;1;24;0;0;0
261700009;800;843;843;6;355;799;1;0;0;0;0;355;12;343
261700010;700;704;704;4;260;699;1;0;0;0;0;260;8;252
261700011;700;781;781;0;235;699;1;0;0;0;0;235;12;223
261700012;500;551;555;4;238;499;1;0;0;0;0;238;6;232
261700013;900;912;912;7;383;899;1;0;0;0;0;383;16;367
261700014;800;837;837;2;340;799;1;0;0;0;0;340;8;332
261700015;400;405;407;7;157;399;1;0;0;0;0;157;3;154
261700016;400;329;329;4;119;399;1;0;0;0;0;119;0;119
261700017;400;484;484;4;199;399;1;0;0;0;0;199;3;196
261700018;600;635;636;5;260;599;1;0;0;0;0;260;6;254
261700019;900;896;896;8;391;899;1;0;0;0;0;391;9;382
261700020;400;365;365;6;180;399;1;0;0;0;0;180;4;176
261700021;500;563;564;4;216;499;1;0;0;0;0;216;3;213
261700022;400;339;339;3;194;200;6;194;2;7;185;0;0;0
261700023;100;70;70;6;71;28;1;71;0;1;70;0;0;0
261700024;200;199;199;3;113;86;1;113;2;4;107;0;0;0
261700025;500;572;572;8;259;499;1;0;0;0;0;259;2;257
261700026;700;780;781;4;216;699;1;0;0;0;0;216;3;213
261700027;600;602;602;0;171;599;1;0;0;0;0;171;2;169
261700028;600;579;512;2;184;599;1;0;0;0;0;184;1;183
261700029;100;101;101;6;60;38;2;60;1;3;56;0;0;0
261700030;100;72;72;7;41;58;1;41;0;1;40;0;0;0
261700031;100;51;51;3;42;57;1;42;1;1;40;0;0;0
261700032;300;276;276;9;189;109;2;189;7;3;179;0;0;0
261700033;350;350;350;13;176;349;1;0;0;0;0;176;5;171
261800001;700;747;758;0;208;699;1;0;0;0;0;208;6;202
261800002;800;843;843;2;273;799;1;0;0;0;0;273;7;266
261800003;800;800;826;4;330;799;1;0;0;0;0;330;3;327
261800004;700;729;729;4;311;699;1;0;0;0;0;311;0;311
261800005;900;997;997;3;263;899;1;0;0;0;0;263;3;260
261800006;900;897;903;2;413;899;1;0;0;0;0;413;2;411
261800007;700;783;783;4;380;699;1;0;0;0;0;380;5;375
261800008;700;745;748;8;325;699;1;0;0;0;0;325;2;323
261800009;800;844;844;5;390;799;1;0;0;0;0;390;2;388
261800010;800;805;807;1;281;799;1;0;0;0;0;281;3;278
261800011;900;898;899;5;315;899;1;0;0;0;0;315;8;307
261800013;200;164;164;8;82;117;1;82;1;1;80;0;0;0
261800014;100;69;71;9;41;58;1;41;1;1;39;0;0;0
261800015;100;67;67;7;43;56;1;43;1;0;42;0;0;0
261800016;100;80;74;6;57;40;3;57;2;5;50;0;0;0
261800017;200;129;129;6;77;122;1;77;4;1;72;0;0;0
261800018;300;265;266;5;155;144;1;155;8;3;144;0;0;0
261800019;200;159;159;7;92;107;1;92;9;0;83;0;0;0
261800020;300;281;282;4;133;166;1;133;13;1;119;0;0;0
261800021;100;24;24;0;21;77;2;21;1;0;20;0;0;0
262000001;800;869;870;4;310;799;1;0;0;0;0;310;3;307
262000002;800;866;867;11;314;799;1;0;0;0;0;314;5;309
262000003;700;769;771;4;264;699;1;0;0;0;0;264;6;258
262000004;800;918;919;7;307;799;1;0;0;0;0;307;7;300
262000005;800;889;889;9;395;799;1;0;0;0;0;395;12;383
262000006;800;888;888;7;293;799;1;0;0;0;0;293;2;291
262000007;700;780;781;8;341;699;1;0;0;0;0;341;1;340
262000008;600;561;561;9;270;599;1;0;0;0;0;270;1;269
262000009;800;875;875;2;364;799;1;0;0;0;0;364;6;358
262000010;300;339;339;8;140;299;1;0;0;0;0;140;0;140
262000011;1021;1021;1024;5;385;1020;1;0;0;0;0;385;2;383
262000012;1000;964;962;3;264;999;1;0;0;0;0;264;0;264
262000013;200;176;176;6;107;92;1;107;0;1;106;0;0;0
262000014;400;426;426;4;229;399;1;0;0;0;0;229;1;228
262000015;300;234;234;6;141;158;1;141;2;2;137;0;0;0
262000016;200;139;139;3;79;120;1;79;1;0;78;0;0;0
262000017;100;26;26;5;24;75;1;24;0;0;24;0;0;0
262000018;100;67;67;7;49;50;1;49;3;1;45;0;0;0
262000019;400;407;407;4;140;399;1;0;0;0;0;140;3;137
262000020;200;219;219;4;119;80;1;119;2;0;117;0;0;0
262000021;100;62;62;6;47;52;1;47;5;0;42;0;0;0
262000022;100;34;34;7;35;64;1;35;1;0;34;0;0;0
262000023;100;40;40;6;36;62;2;36;1;0;35;0;0;0
262000024;500;498;498;6;184;499;1;0;0;0;0;184;3;181
262000025;300;294;294;5;113;186;1;113;4;3;106;0;0;0
262000026;700;681;682;9;239;699;1;0;0;0;0;239;5;234
262000027;100;23;23;8;26;73;1;26;1;1;24;0;0;0
262000028;100;63;63;4;58;41;1;58;4;1;53;0;0;0
262000029;100;72;72;4;57;42;1;57;0;0;57;0;0;0
262000030;1000;989;991;6;296;999;1;0;0;0;0;296;0;296
262400001;700;715;715;1;346;699;1;0;0;0;0;346;5;341
262400002;700;748;749;5;336;699;1;0;0;0;0;336;5;331
262400003;500;417;418;1;197;499;1;0;0;0;0;197;0;197
262500001;600;631;633;3;279;599;1;0;0;0;0;279;2;277
262500002;600;601;605;7;252;599;1;0;0;0;0;252;3;249
262500003;600;581;581;1;248;599;1;0;0;0;0;248;8;240
262500004;800;844;844;3;279;799;1;0;0;0;0;279;3;276
262500005;500;470;470;9;220;499;1;0;0;0;0;220;2;218
262500006;600;617;618;2;285;599;1;0;0;0;0;285;6;279
262500007;700;699;700;1;256;699;1;0;0;0;0;256;3;253
262500008;500;526;527;3;241;499;1;0;0;0;0;241;3;238
262500009;700;682;682;2;284;699;1;0;0;0;0;284;2;282
262500010;600;569;570;8;236;599;1;0;0;0;0;236;1;235
262500011;700;749;751;7;293;699;1;0;0;0;0;293;2;291
262500012;500;518;521;3;210;499;1;0;0;0;0;210;4;206
262500013;500;562;565;4;204;499;1;0;0;0;0;204;2;202
262500014;700;694;694;2;196;699;1;0;0;0;0;196;5;191
262500015;500;554;559;2;205;499;1;0;0;0;0;205;2;203
262500016;600;592;599;3;249;599;1;0;0;0;0;249;5;244
262500017;200;178;179;6;87;112;1;87;4;3;80;0;0;0
262500018;200;208;210;6;128;71;1;128;3;1;124;0;0;0
262500019;100;59;60;5;48;49;3;48;3;0;45;0;0;0
262500020;100;17;17;1;18;81;1;18;0;0;18;0;0;0
262500021;100;33;33;14;38;61;1;38;2;1;35;0;0;0
262600001;600;594;594;6;268;599;1;0;0;0;0;268;2;266
262600002;700;768;768;6;337;699;1;0;0;0;0;337;7;330
262600003;800;842;844;8;340;799;1;0;0;0;0;340;8;332
262600004;800;839;839;5;386;800;0;0;0;0;0;386;4;382
262600005;700;718;718;6;307;699;1;0;0;0;0;307;5;302
262600006;700;767;773;6;317;699;1;0;0;0;0;317;5;312
262600007;700;787;788;9;374;699;1;0;0;0;0;374;7;367
262600008;700;758;759;9;343;699;1;0;0;0;0;343;4;339
262600009;900;894;897;8;323;899;1;0;0;0;0;323;9;314
262600010;900;876;878;8;384;899;1;0;0;0;0;384;7;377
262600011;900;908;908;10;378;899;1;0;0;0;0;378;4;374
262600012;700;763;765;6;361;699;1;0;0;0;0;361;6;355
262600013;800;796;798;7;449;799;1;0;0;0;0;449;11;438
262600014;500;438;440;2;241;499;1;0;0;0;0;241;4;237
262600015;150;121;121;6;88;59;3;88;0;1;87;0;0;0
262600016;300;296;296;4;191;107;2;191;7;1;183;0;0;0
262600017;200;178;180;4;96;103;1;96;5;1;90;0;0;0
262600018;900;910;905;4;368;899;1;0;0;0;0;368;2;366
262600019;700;750;750;5;329;699;1;0;0;0;0;329;4;325
262600020;300;309;314;5;195;104;1;195;3;1;191;0;0;0
262600021;210;216;216;7;177;31;2;177;2;0;175;0;0;0
262600022;100;96;97;5;80;19;1;80;3;1;76;0;0;0
262600023;100;78;80;6;61;38;1;61;2;4;55;0;0;0
262600024;40;29;29;7;35;4;1;35;0;0;35;0;0;0
263400001;800;830;836;9;404;799;1;0;0;0;0;404;6;398
263400002;500;577;586;1;250;499;1;0;0;0;0;250;4;246
263400003;500;652;653;4;293;499;1;0;0;0;0;293;9;284
263400004;600;745;745;3;322;599;1;0;0;0;0;322;5;317
263400005;600;708;708;1;250;599;1;0;0;0;0;250;8;242
263400006;400;461;427;4;206;399;1;0;0;0;0;206;0;206
263400007;300;233;143;7;136;163;1;136;19;3;114;0;0;0
263400008;100;44;44;6;42;57;1;42;1;1;40;0;0;0
263400009;200;118;121;4;78;121;1;78;0;0;78;0;0;0
263400010;100;74;74;5;56;43;1;56;4;1;51;0;0;0
263400011;600;751;760;4;275;599;1;0;0;0;0;275;2;273
263400012;100;93;95;7;60;39;1;60;0;1;59;0;0;0
263400013;400;453;395;6;249;399;1;0;0;0;0;249;2;247
263400014;300;259;269;6;158;141;1;158;8;6;144;0;0;0
263400015;200;155;155;7;94;103;3;94;4;3;87;0;0;0
263400016;100;48;48;6;53;46;1;53;5;2;46;0;0;0
263900001;600;588;590;2;140;599;1;0;0;0;0;140;4;136
263900002;300;374;374;7;171;299;1;0;0;0;0;171;4;167
263900003;800;819;820;5;293;799;1;0;0;0;0;293;6;287
263900004;600;611;611;5;197;599;1;0;0;0;0;197;2;195
263900005;600;681;682;3;230;599;1;0;0;0;0;230;3;227
263900006;500;583;583;0;162;499;1;0;0;0;0;162;2;160
263900007;600;680;680;5;282;599;1;0;0;0;0;282;2;280
263900008;700;760;760;2;217;699;1;0;0;0;0;217;4;213
263900009;600;658;660;0;247;599;1;0;0;0;0;247;2;245
263900010;400;481;481;5;231;399;1;0;0;0;0;231;3;228
263900011;400;433;440;4;194;399;1;0;0;0;0;194;1;193
263900012;500;530;535;9;258;500;0;0;0;0;0;258;6;252
263900013;600;642;646;0;293;599;1;0;0;0;0;293;7;286
263900014;600;687;687;3;284;599;1;0;0;0;0;284;7;277
263900015;600;596;602;9;281;599;1;0;0;0;0;281;5;276
263900016;600;663;665;4;297;599;1;0;0;0;0;297;4;293
263900017;500;585;591;6;225;499;1;0;0;0;0;225;2;223
263900018;600;599;609;6;219;599;1;0;0;0;0;219;5;214
263900019;500;506;514;9;238;499;1;0;0;0;0;238;1;237
263900020;500;522;525;2;238;499;1;0;0;0;0;238;6;232
263900021;500;483;483;7;183;499;1;0;0;0;0;183;3;180
263900022;100;44;44;6;27;71;2;27;0;0;27;0;0;0
263900023;400;409;409;1;152;399;1;0;0;0;0;152;2;150
263900024;700;722;722;4;297;699;1;0;0;0;0;297;8;289
263900025;700;713;714;3;294;699;1;0;0;0;0;294;6;288
263900026;700;646;646;6;272;699;1;0;0;0;0;272;2;270
263900027;600;666;666;2;262;600;0;0;0;0;0;262;5;257
263900028;600;259;606;7;259;599;1;0;0;0;0;259;8;251
263900029;600;667;667;0;313;599;1;0;0;0;0;313;8;305
263900030;800;837;837;2;379;799;1;0;0;0;0;379;4;375
263900031;700;747;747;7;323;699;1;0;0;0;0;323;4;319
263900032;800;856;856;5;636;799;1;0;0;0;0;636;0;636
263900033;800;810;811;3;149;799;1;0;0;0;0;149;0;149
263900034;800;840;841;6;477;799;1;0;0;0;0;477;0;477
263900035;500;594;595;9;258;499;1;0;0;0;0;258;0;258
263900036;800;964;967;0;281;799;1;0;0;0;0;281;0;281
263900037;200;111;111;4;85;114;1;85;0;1;84;0;0;0
263900038;100;72;74;3;48;51;1;48;6;1;41;0;0;0
263900039;300;184;189;6;111;188;1;111;2;0;109;0;0;0
263900040;200;153;153;3;101;98;1;101;11;1;89;0;0;0
263900041;200;95;99;4;62;136;2;62;3;1;58;0;0;0
263900042;800;768;769;4;280;799;1;0;0;0;0;280;5;275
263900043;100;103;103;3;64;34;2;64;1;0;63;0;0;0
263900044;300;250;250;4;143;156;1;143;5;2;136;0;0;0
263900045;400;326;326;7;198;200;2;198;28;2;168;0;0;0
263900046;200;181;181;4;138;61;1;138;17;1;120;0;0;0
263900047;200;165;165;8;118;81;1;118;2;0;116;0;0;0
263900048;300;254;259;4;151;144;5;151;5;0;146;0;0;0
263900049;200;160;161;4;92;107;1;92;3;0;89;0;0;0
263900050;200;178;178;4;113;86;1;113;1;3;109;0;0;0
263900051;200;219;220;0;97;101;2;97;5;1;91;0;0;0
263900052;300;329;329;0;106;299;1;0;0;0;0;106;1;105
263900053;300;398;402;1;185;299;1;0;0;0;0;185;2;183
263900054;400;480;480;3;202;399;1;0;0;0;0;202;0;202
263900055;600;561;563;5;246;599;1;0;0;0;0;246;1;245
263900056;500;468;471;5;196;499;1;0;0;0;0;196;1;195
263900057;300;234;234;2;133;164;3;133;2;1;130;0;0;0
263900058;300;317;323;1;168;299;1;0;0;0;0;168;1;167
263900059;400;463;463;5;225;399;1;0;0;0;0;226;2;224
263900060;600;530;530;3;248;599;1;0;0;0;0;248;4;244
263900061;400;365;364;3;198;399;1;0;0;0;0;198;2;196
263900062;600;513;515;3;189;600;0;0;0;0;0;189;0;189
263900063;500;519;519;0;232;499;1;0;0;0;0;232;1;231
263900064;100;56;55;0;32;66;2;32;9;0;23;0;0;0
263900065;100;14;14;17;22;78;0;22;0;0;22;0;0;0
263900066;100;19;19;0;17;83;0;17;1;0;16;0;0;0
263900067;100;19;19;0;19;80;1;19;6;0;13;0;0;0
263900068;100;67;67;2;60;39;1;60;0;0;60;0;0;0
264300001;800;874;876;8;373;799;1;0;0;0;0;373;6;367
264300002;800;885;886;6;365;799;1;0;0;0;0;365;7;358
264300003;700;757;758;2;221;699;1;0;0;0;0;221;2;219
264300004;700;767;768;4;274;699;1;0;0;0;0;274;2;272
264300005;700;771;774;3;283;699;1;0;0;0;0;283;7;276
264300006;800;803;804;4;280;799;1;0;0;0;0;280;4;276
264300007;800;913;914;4;331;799;1;0;0;0;0;331;4;327
264300008;800;898;900;4;309;799;1;0;0;0;0;309;6;303
264300010;150;132;132;5;74;75;1;74;1;0;73;0;0;0
264300011;100;71;72;5;41;58;1;41;2;0;39;0;0;0
264300012;200;150;150;2;88;110;2;88;3;0;85;0;0;0
264300013;600;598;598;2;220;599;1;0;0;0;0;220;5;215
264300014;400;488;488;485;184;399;1;0;0;0;0;184;2;182
264300015;200;157;157;2;70;129;1;70;0;0;70;0;0;0
264300016;700;781;782;3;301;699;1;0;0;0;0;301;8;293
264300017;400;452;453;3;144;399;1;0;0;0;0;144;0;144
264300018;500;539;539;6;211;499;1;0;0;0;0;211;8;203
264300019;50;26;26;7;16;33;1;16;0;0;16;0;0;0
264300020;50;36;36;6;25;24;1;25;1;1;23;0;0;0
264300021;150;130;130;5;58;91;1;58;4;1;53;0;0;0
264300022;100;44;44;6;41;58;1;41;5;0;36;0;0;0
264300023;200;156;156;7;65;134;1;65;1;1;63;0;0;0
264300024;50;13;13;5;10;39;1;10;0;1;9;0;0;0
264300025;150;48;86;6;54;95;1;54;1;1;52;0;0;0
264300026;200;155;155;4;77;122;1;77;4;1;72;0;0;0
264300027;700;769;771;5;327;699;1;0;0;0;0;327;6;321
264300028;700;784;784;3;296;699;1;0;0;0;0;296;1;295
264300029;100;53;53;8;22;77;1;22;0;1;21;0;0;0
264300030;100;45;79;6;45;54;1;45;0;0;45;0;0;0
264300031;100;62;62;6;20;79;1;20;2;0;18;0;0;0
264300032;300;265;265;6;154;145;1;154;6;2;146;0;0;0
264300033;400;324;324;7;170;229;1;170;8;2;160;0;0;0
264300034;100;51;62;6;51;47;2;51;3;2;46;0;0;0
264300035;100;70;70;4;49;50;1;49;1;0;48;0;0;0
264300036;250;212;213;3;87;162;1;87;1;1;85;0;0;0
264300037;700;726;726;7;294;699;1;0;0;0;0;294;8;286
264300038;50;17;17;0;5;44;1;5;0;0;5;0;0;0
264300039;800;800;803;3;279;800;0;0;0;0;0;279;9;270
264300040;600;657;658;5;252;599;1;0;0;0;0;252;4;248
264300041;600;619;620;6;240;599;1;0;0;0;0;240;3;237
264300042;600;599;600;2;195;599;1;0;0;0;0;195;6;189
264300043;100;60;60;5;41;57;2;41;1;1;39;0;0;0
264500001;60;36;36;30;30;27;3;30;0;0;30;0;0;0
264500002;140;112;113;5;82;57;1;82;2;1;79;0;0;0
264500003;700;794;794;3;271;699;1;0;0;0;0;271;3;268
264500004;700;785;788;1;319;699;1;0;0;0;0;319;4;315
264500005;600;574;574;5;270;599;1;0;0;0;0;270;6;264
264500006;600;581;581;4;259;599;1;0;0;0;0;259;5;254
264500007;600;593;593;1;240;599;1;0;0;0;0;240;5;235
264500008;750;771;772;4;322;749;1;0;0;0;0;322;5;317
264500009;600;601;604;7;236;599;1;0;0;0;0;236;5;231
264500010;700;701;701;0;270;699;1;0;0;0;0;270;6;264
264500011;550;563;563;4;219;549;1;0;0;0;0;219;4;215
264500012;500;537;537;5;203;499;1;0;0;0;0;203;3;200
264500013;500;526;526;5;204;499;1;0;0;0;0;204;1;203
264500014;50;25;25;8;23;26;1;23;1;2;20;0;0;0
264500015;100;63;63;4;42;57;1;42;1;0;41;0;0;0
264500016;100;84;84;6;53;46;1;53;1;1;51;0;0;0
264500017;50;28;28;6;28;21;1;28;2;2;24;0;0;0
264700001;690;678;680;1;248;689;1;0;0;0;0;248;3;245
264700002;450;440;441;1;209;449;1;0;0;0;0;209;2;207
264700003;710;703;704;3;276;709;1;0;0;0;0;276;6;270
264700004;620;611;613;0;268;619;1;0;0;0;0;268;2;266
264700005;550;544;546;0;213;549;1;0;0;0;0;213;4;209
264700006;650;627;628;7;266;649;1;0;0;0;0;266;5;261
264700007;590;577;579;3;232;589;1;0;0;0;0;232;4;228
264700008;217;222;222;4;112;104;1;112;1;2;109;0;0;0
264700009;149;152;152;3;87;60;2;87;2;3;82;0;0;0
264700010;161;171;171;4;89;71;1;89;4;4;81;0;0;0
264700011;13;10;10;1;10;3;0;10;0;1;9;0;0;0
265400001;700;694;694;0;265;699;1;0;0;0;0;265;4;261
265400002;600;566;566;0;203;599;1;0;0;0;0;203;4;199
265500001;500;462;464;4;184;499;1;0;0;0;0;184;1;183
265500002;500;475;478;3;187;499;1;0;0;0;0;187;5;182
265500003;400;373;374;4;173;399;1;0;0;0;0;173;4;169
265500004;600;580;580;2;237;599;1;0;0;0;0;237;2;235
265500005;500;539;539;1;197;499;1;0;0;0;0;197;4;193
265500006;600;612;612;10;249;599;1;0;0;0;0;249;2;247
265500007;600;662;667;2;258;599;1;0;0;0;0;258;3;255
265500008;600;576;577;1;205;599;1;0;0;0;0;205;4;201
265500009;600;586;587;2;202;599;1;0;0;0;0;202;6;196
265500010;500;631;634;0;283;499;1;0;0;0;0;283;7;276
265500011;500;505;507;2;221;499;1;0;0;0;0;221;1;220
265500012;600;607;609;4;265;599;1;0;0;0;0;265;2;263
265500013;100;14;14;0;11;88;1;11;0;0;11;0;0;0
265500014;100;16;16;0;13;86;1;13;0;0;13;0;0;0
265600001;500;642;642;2;220;499;1;0;0;0;0;220;2;218
265600002;500;571;571;1;188;499;1;0;0;0;0;188;2;186
265600003;250;219;220;4;97;152;1;97;4;0;93;0;0;0
265600004;250;237;237;6;112;137;1;112;3;4;105;0;0;0
265600005;100;61;61;4;38;61;1;38;2;1;35;0;0;0
265600006;100;85;85;4;46;52;2;46;2;0;44;0;0;0
265700001;500;576;578;0;228;499;1;0;0;0;0;228;4;224
265700002;500;452;453;0;183;500;0;0;0;0;0;183;4;179
265800001;685;640;646;2;330;684;1;0;0;0;0;330;4;326
265800002;600;592;600;4;301;599;1;0;0;0;0;301;4;297
265800003;15;10;10;0;9;5;1;9;0;0;9;0;0;0
265900001;600;652;666;4;383;599;1;0;0;0;0;383;10;373
265900002;600;624;633;5;394;599;1;0;0;0;0;394;1;393
265900003;600;605;623;4;352;599;1;0;0;0;0;352;5;347
265900004;600;592;609;3;338;599;1;0;0;0;0;338;9;329
265900005;500;558;566;1;355;500;0;0;0;0;0;355;3;352
265900006;600;682;684;5;428;599;1;0;0;0;0;428;1;427
265900007;100;40;40;12;38;61;1;38;7;0;31;0;0;0
265900008;100;66;66;1;67;33;0;67;4;0;63;0;0;0
270400001;300;463;464;2;209;300;0;0;0;0;0;209;1;208
270400002;100;62;62;7;40;59;1;40;0;0;40;0;0;0
270400003;200;185;185;3;109;90;1;109;3;0;106;0;0;0
270400004;300;396;396;4;95;299;1;0;0;0;0;95;1;94
270400005;300;475;475;1;63;299;1;0;0;0;0;63;1;62
270400006;300;477;477;3;98;299;1;0;0;0;0;98;0;98
270400007;400;501;501;1;239;400;0;0;0;0;0;239;6;233
270400008;300;496;496;1;171;299;1;0;0;0;0;171;0;171
270400009;300;244;244;4;109;190;1;109;6;2;101;0;0;0
270400010;300;489;489;0;158;299;1;0;0;0;0;158;1;157
270400011;588;588;588;3;124;587;1;0;0;0;0;124;0;124
270400012;300;462;462;4;110;300;0;0;0;0;0;110;0;110
270400013;100;60;60;4;46;53;1;46;1;0;45;0;0;0
270400014;200;158;158;4;102;97;1;102;4;0;98;0;0;0
270400015;200;138;131;7;96;102;2;96;1;1;94;0;0;0
270400016;100;44;44;6;38;61;1;38;2;0;36;0;0;0
270400017;100;68;68;7;47;52;1;47;0;0;47;0;0;0
270400018;200;143;143;2;95;104;1;95;0;0;95;0;0;0
270400019;100;39;39;4;33;66;1;33;1;2;30;0;0;0
270400020;100;93;93;4;54;45;1;54;2;0;52;0;0;0
270400021;100;108;109;4;68;31;1;68;4;0;64;0;0;0
270400022;100;56;56;5;33;66;1;33;0;0;33;0;0;0
270400023;200;141;141;3;79;120;1;79;0;0;79;0;0;0
270700001;500;673;676;6;274;499;1;0;0;0;0;274;3;271
270700002;500;360;755;8;368;499;1;0;0;0;0;368;6;362
270700003;500;703;706;7;312;500;0;0;0;0;0;312;6;306
270700004;500;504;505;7;260;500;0;0;0;0;0;260;4;256
270700005;500;751;751;6;340;499;1;0;0;0;0;340;7;333
270700006;500;835;835;8;409;499;1;0;0;0;0;409;3;406
270700007;500;815;815;1;373;499;1;0;0;0;0;373;7;366
270700008;500;562;563;5;197;499;1;0;0;0;0;197;3;194
270700009;500;639;639;10;248;499;1;0;0;0;0;248;4;244
270700010;300;235;235;7;122;177;1;122;6;4;112;0;0;0
270700011;200;154;154;5;95;104;1;95;2;1;92;0;0;0
270700012;100;70;70;6;54;45;1;54;4;0;50;0;0;0
270700013;100;46;46;7;34;65;1;34;0;0;34;0;0;0
270700014;200;180;180;6;103;96;1;103;5;0;98;0;0;0
270700015;500;629;630;4;277;499;1;0;0;0;0;277;5;272
270700016;500;532;533;1;225;499;1;0;0;0;0;225;2;223
270700017;300;335;335;4;104;300;0;0;0;0;0;104;2;102
270700018;200;133;133;6;79;120;1;79;5;0;74;0;0;0
270700019;500;610;610;7;187;500;0;0;0;0;0;187;1;186
270700020;400;361;361;6;131;400;0;0;0;0;0;131;0;131
270700021;300;348;348;4;143;299;1;0;0;0;0;143;3;140
270700022;200;173;173;3;91;108;1;91;0;0;91;0;0;0
270700023;100;26;26;10;28;71;1;28;1;0;27;0;0;0
271200001;500;817;818;10;359;499;1;0;0;0;0;359;3;356
271200002;500;802;805;5;325;499;1;0;0;0;0;325;1;324
271200003;500;702;703;6;278;499;1;0;0;0;0;278;3;275
271200004;500;528;528;7;241;499;1;0;0;0;0;241;3;238
271200005;500;783;785;5;326;499;1;0;0;0;0;326;1;325
271200006;500;797;797;8;368;499;1;0;0;0;0;368;11;357
271200007;500;726;727;7;335;499;1;0;0;0;0;335;2;333
271200008;500;629;630;4;304;499;1;0;0;0;0;304;2;302
271200009;500;922;925;7;410;499;1;0;0;0;0;410;6;404
271200010;500;659;662;10;310;499;1;0;0;0;0;310;5;305
271200011;500;831;831;7;352;499;1;0;0;0;0;352;1;351
271200012;500;681;681;8;268;499;1;0;0;0;0;268;1;267
271200013;500;694;696;7;291;499;1;0;0;0;0;291;4;287
271200014;500;860;861;8;376;500;0;0;0;0;0;376;8;368
271200015;500;689;689;9;298;499;1;0;0;0;0;298;3;295
271200016;500;673;673;8;281;499;1;0;0;0;0;281;4;277
271200017;500;668;668;5;331;499;1;0;0;0;0;331;5;326
271200018;500;658;659;6;301;499;1;0;0;0;0;301;8;293
271200019;500;936;938;7;398;499;1;0;0;0;0;398;10;388
271200020;500;668;668;7;321;500;0;0;0;0;0;321;1;320
271200021;500;660;662;9;283;499;1;0;0;0;0;283;2;281
271200022;500;800;800;11;353;499;1;0;0;0;0;353;8;345
271200023;500;843;843;9;384;499;1;0;0;0;0;385;3;382
271200024;500;943;943;11;415;499;1;0;0;0;0;415;6;409
271200025;500;836;836;4;324;499;1;0;0;0;0;324;5;319
271200026;500;752;754;9;252;499;1;0;0;0;0;252;8;244
271200027;500;894;894;9;326;499;1;0;0;0;0;326;4;322
271200028;500;642;643;9;203;499;1;0;0;0;0;203;2;201
271200029;500;746;746;6;273;499;1;0;0;0;0;273;5;268
271200030;500;635;636;6;209;499;1;0;0;0;0;209;6;203
271200031;500;884;886;9;338;499;1;0;0;0;0;338;5;333
271200032;500;894;939;6;306;500;0;0;0;0;0;306;6;300
271200033;500;795;797;6;274;499;1;0;0;0;0;274;3;271
271200034;500;730;730;6;298;499;1;0;0;0;0;298;5;293
271200035;500;731;735;6;311;499;1;0;0;0;0;311;3;308
271200036;500;777;779;7;289;499;1;0;0;0;0;289;3;286
271200037;500;826;826;7;253;500;0;0;0;0;0;253;1;252
271200038;500;1006;1007;9;263;499;1;0;0;0;0;263;2;261
271200039;500;710;712;9;227;499;1;0;0;0;0;227;4;223
271200040;500;676;678;8;256;499;1;0;0;0;0;256;4;252
271200041;500;858;862;6;282;499;1;0;0;0;0;282;3;279
271200042;500;872;872;4;343;499;1;0;0;0;0;343;4;339
271200043;500;924;928;8;376;499;1;0;0;0;0;376;2;374
271200044;500;916;916;4;416;499;1;0;0;0;0;416;4;412
271200045;500;903;904;9;394;499;1;0;0;0;0;394;3;391
271200046;500;881;885;4;398;500;0;0;0;0;0;398;3;395
271200047;500;834;835;8;366;499;1;0;0;0;0;366;5;361
271200048;500;582;578;4;259;500;0;0;0;0;0;259;4;255
271200049;500;713;716;7;279;499;1;0;0;0;0;279;4;275
271200050;500;558;559;8;252;499;1;0;0;0;0;252;3;249
271200051;500;754;756;8;345;499;1;0;0;0;0;345;1;344
271200052;500;749;749;8;362;499;1;0;0;0;0;362;3;359
271200053;500;812;812;3;366;499;1;0;0;0;0;366;5;361
271200054;500;738;741;4;297;499;1;0;0;0;0;297;3;294
271200055;500;759;760;6;306;499;1;0;0;0;0;306;3;303
271200056;500;620;622;6;253;499;1;0;0;0;0;253;3;250
271200057;500;808;808;8;290;499;1;0;0;0;0;290;4;286
271200058;500;568;568;3;275;500;0;0;0;0;0;275;1;274
271200059;500;538;538;6;260;500;0;0;0;0;0;260;1;259
271200060;500;694;694;5;228;499;1;0;0;0;0;228;0;228
271200061;500;820;821;2;253;499;1;0;0;0;0;253;4;249
271200062;500;803;804;1;211;499;1;0;0;0;0;211;4;207
271200063;200;216;216;5;161;38;1;161;8;1;152;0;0;0
271200064;500;654;656;5;233;499;1;0;0;0;0;233;0;233
271200065;500;832;833;2;268;499;1;0;0;0;0;268;0;268
271200066;500;753;753;3;257;499;1;0;0;0;0;257;4;253
271200067;500;760;761;3;331;499;1;0;0;0;0;331;0;331
271200068;500;623;624;2;332;499;1;0;0;0;0;332;1;331
271200069;500;932;933;5;354;500;0;0;0;0;0;354;1;353
271200070;500;933;934;5;418;499;1;0;0;0;0;418;3;415
271200071;500;958;959;1;298;499;1;0;0;0;0;298;1;297
271200072;500;948;948;6;423;499;1;0;0;0;0;423;9;414
271200073;500;1040;1040;2;381;499;1;0;0;0;0;381;4;377
271200074;500;559;559;6;223;499;1;0;0;0;0;223;6;217
271200075;200;192;192;4;97;103;0;97;2;1;94;0;0;0
271200076;500;793;793;7;298;499;1;0;0;0;0;298;5;293
271200077;500;683;683;3;267;499;1;0;0;0;0;267;2;265
271200078;500;275;719;6;275;500;0;0;0;0;0;275;4;271
271200079;500;971;971;5;325;500;0;0;0;0;0;325;3;322
271200080;500;896;898;4;262;499;1;0;0;0;0;262;0;262
271200081;500;965;965;3;461;499;1;0;0;0;0;461;4;457
271200082;500;906;907;5;306;499;1;0;0;0;0;306;1;305
271200083;500;931;936;5;325;500;0;0;0;0;0;325;5;320
271200084;200;182;182;4;120;80;0;120;3;0;117;0;0;0
271200085;500;988;989;6;369;500;0;0;0;0;0;369;1;368
271200086;300;513;513;3;244;299;1;0;0;0;0;243;2;241
271200087;100;11;11;34;45;54;1;45;0;1;44;0;0;0
271200088;100;44;44;8;39;60;1;39;2;0;37;0;0;0
271200089;100;77;77;1;51;48;1;51;2;1;48;0;0;0
272200001;300;565;565;2;241;299;1;0;0;0;0;241;5;236
272200002;400;674;675;4;285;399;1;0;0;0;0;285;4;281
272200003;400;646;646;0;245;399;1;0;0;0;0;245;1;244
272200004;500;765;779;9;309;499;1;0;0;0;0;309;0;309
272200005;300;705;705;2;139;299;1;0;0;0;0;139;2;137
272200006;300;890;891;0;190;299;1;0;0;0;0;190;0;190
272200007;300;982;982;3;152;299;1;0;0;0;0;152;0;152
272200008;300;245;245;4;161;138;1;161;0;0;161;0;0;0
272200009;300;665;667;6;222;299;1;0;0;0;0;222;2;220
272200010;600;921;924;2;357;600;0;0;0;0;0;357;0;357
272200011;500;654;654;5;218;499;1;0;0;0;0;218;0;218
272200012;300;397;397;2;60;299;1;0;0;0;0;60;0;60
272200013;400;608;609;2;228;399;1;0;0;0;0;228;2;226
272200014;300;495;495;1;137;299;1;0;0;0;0;137;2;135
272200015;300;418;418;2;116;299;1;0;0;0;0;116;0;116
272200016;100;13;13;8;20;79;1;20;5;0;15;0;0;0
272300001;300;270;270;6;143;156;1;143;3;1;139;0;0;0
272300002;100;35;35;4;26;73;1;26;0;0;26;0;0;0
272300003;200;199;199;5;110;89;1;110;4;0;106;0;0;0
272300004;200;214;214;2;103;96;1;103;4;0;99;0;0;0
272300005;200;162;162;3;92;107;1;92;3;0;89;0;0;0
272300006;100;76;76;4;48;51;1;48;3;0;45;0;0;0
272300007;200;138;138;4;93;106;1;93;3;0;90;0;0;0
272300008;100;55;55;3;46;53;1;46;0;0;46;0;0;0
272300009;200;166;167;3;102;97;1;102;3;0;99;0;0;0
272300010;200;194;194;4;121;78;1;121;0;0;121;0;0;0
272300011;100;71;71;5;40;58;2;40;2;0;38;0;0;0
272300012;200;219;221;2;117;82;1;117;5;0;112;0;0;0
272300013;300;305;305;6;165;126;9;165;6;1;158;0;0;0
272400001;800;797;799;2;315;799;1;0;0;0;0;315;7;308
272400002;800;783;786;3;394;799;1;0;0;0;0;394;4;390
272400003;800;795;798;3;314;799;1;0;0;0;0;314;1;313
272400004;300;293;293;1;193;106;1;193;1;4;188;0;0;0
272400005;100;49;49;7;37;62;1;37;3;0;34;0;0;0
272400006;700;700;701;1;300;699;1;0;0;0;0;300;1;299
272400007;500;591;592;1;283;499;1;0;0;0;0;283;6;277
272400008;500;597;597;1;224;499;1;0;0;0;0;224;6;218
272400009;600;654;654;6;253;599;1;0;0;0;0;253;1;252
272400010;700;703;705;6;286;699;1;0;0;0;0;286;1;285
272400011;800;798;811;3;261;799;1;0;0;0;0;261;1;260
272400012;700;774;776;3;216;699;1;0;0;0;0;216;0;216
272400013;800;791;807;6;261;799;1;0;0;0;0;261;1;260
272400014;500;535;543;2;168;499;1;0;0;0;0;168;1;167
272400015;500;525;525;4;127;499;1;0;0;0;0;127;0;127
272400016;1000;1052;1052;3;225;999;1;0;0;0;0;225;0;225
272400017;1000;1083;1088;3;309;999;1;0;0;0;0;309;1;308
272400018;800;833;838;3;280;799;1;0;0;0;0;280;0;280
272400019;600;609;610;2;168;599;1;0;0;0;0;168;1;167
272400020;500;593;593;4;192;499;1;0;0;0;0;192;1;191
272400021;200;149;149;13;92;107;1;92;3;1;88;0;0;0
272400022;100;14;14;4;18;81;1;18;0;0;18;0;0;0
272400023;100;15;15;6;21;78;1;21;0;0;21;0;0;0
272400024;100;21;21;3;23;75;2;23;0;0;23;0;0;0
272700001;600;642;656;8;264;599;1;0;0;0;0;264;2;262
272700002;600;674;674;9;262;599;1;0;0;0;0;262;5;257
272700003;700;763;766;7;325;699;1;0;0;0;0;325;2;323
272700004;700;805;806;8;355;699;1;0;0;0;0;355;7;348
272700005;600;259;641;8;267;599;1;0;0;0;0;267;5;262
272700006;700;749;749;5;272;699;1;0;0;0;0;272;6;266
272700007;700;779;779;7;332;699;1;0;0;0;0;332;7;325
272700008;800;826;826;5;357;799;1;0;0;0;0;357;9;348
272700009;800;873;876;5;354;799;1;0;0;0;0;354;1;353
272700010;700;785;787;6;324;699;1;0;0;0;0;324;1;323
272700011;834;834;835;8;228;833;1;0;0;0;0;228;3;225
272700012;700;788;791;10;346;699;1;0;0;0;0;346;3;343
272700013;800;871;874;5;336;799;1;0;0;0;0;336;4;332
272700014;600;627;629;10;273;599;1;0;0;0;0;273;1;272
272700015;500;533;534;4;147;499;1;0;0;0;0;147;3;144
272700016;500;509;511;3;192;499;1;0;0;0;0;192;2;190
272700017;100;75;75;7;46;53;1;46;1;0;45;0;0;0
272700018;400;317;326;3;101;399;1;0;0;0;0;101;0;101
272700019;200;183;183;3;104;95;1;104;4;0;100;0;0;0
272700020;200;163;163;5;101;98;1;101;2;0;99;0;0;0
272700021;200;79;147;4;83;115;2;83;2;1;80;0;0;0
272700022;400;367;367;4;176;399;1;0;0;0;0;176;0;176
272700023;400;372;375;6;152;399;1;0;0;0;0;152;1;151
272700024;400;343;344;4;105;399;1;0;0;0;0;105;2;103
272700025;100;28;28;5;18;81;1;18;0;0;18;0;0;0
272700026;100;30;53;7;30;69;1;30;0;0;30;0;0;0
272700027;100;62;62;8;48;51;1;48;2;0;46;0;0;0
272700028;100;64;64;6;37;62;1;37;0;0;37;0;0;0
272700029;500;489;495;4;204;499;1;0;0;0;0;204;1;203
272700030;100;99;99;6;58;41;1;58;2;0;56;0;0;0
272700031;100;89;89;7;59;40;1;59;1;0;58;0;0;0
272700032;100;57;57;6;40;59;1;40;3;0;37;0;0;0
272700033;400;332;334;5;104;399;1;0;0;0;0;104;0;104
272700034;100;100;100;3;73;26;1;73;2;0;71;0;0;0
272700035;400;356;356;7;200;199;1;200;2;1;197;0;0;0
272700036;300;303;303;5;107;192;1;107;1;0;106;0;0;0
272700037;300;217;217;35;105;194;1;105;9;5;91;0;0;0
272700039;100;30;30;2;32;68;0;32;0;0;32;0;0;0
273100001;500;799;799;10;220;499;1;0;0;0;0;220;5;215
273100002;600;910;911;7;262;599;1;0;0;0;0;262;1;261
273100003;600;914;914;8;322;599;1;0;0;0;0;322;2;320
273100004;600;890;890;8;286;599;1;0;0;0;0;286;4;282
273100005;400;665;666;11;179;399;1;0;0;0;0;179;2;177
273100006;500;699;699;8;276;499;1;0;0;0;0;276;3;273
273100007;600;843;844;7;348;599;1;0;0;0;0;348;6;342
273100008;600;895;896;6;398;599;1;0;0;0;0;398;8;390
273100009;500;794;795;6;294;499;1;0;0;0;0;294;1;293
273100010;600;834;835;7;327;599;1;0;0;0;0;327;7;320
273100011;600;883;884;10;387;599;1;0;0;0;0;387;10;377
273100012;700;1004;1004;11;482;699;1;0;0;0;0;482;8;474
273100013;600;949;949;7;406;599;1;0;0;0;0;406;6;400
273100014;500;767;769;9;341;499;1;0;0;0;0;341;6;335
273100015;500;806;806;8;351;499;1;0;0;0;0;351;5;346
273100016;600;904;908;5;447;599;1;0;0;0;0;447;6;441
273100017;500;747;747;8;300;499;1;0;0;0;0;300;2;298
273100018;500;774;774;8;380;498;2;0;0;0;0;380;1;379
273100019;600;877;878;7;402;599;1;0;0;0;0;402;2;400
273100020;500;779;779;10;337;499;1;0;0;0;0;337;4;333
273100021;600;908;910;5;319;599;1;0;0;0;0;319;7;312
273100022;600;864;864;7;419;599;1;0;0;0;0;419;12;407
273100023;500;779;779;9;349;499;1;0;0;0;0;349;7;342
273100024;400;561;561;9;251;399;1;0;0;0;0;251;4;247
273100025;400;534;534;8;210;399;1;0;0;0;0;210;4;206
273100026;500;804;804;14;351;499;1;0;0;0;0;351;5;346
273100027;600;858;858;11;387;599;1;0;0;0;0;387;4;383
273100028;700;1003;1005;8;425;699;1;0;0;0;0;425;3;422
273100029;600;924;924;10;462;599;1;0;0;0;0;462;7;455
273100030;500;740;741;6;379;499;1;0;0;0;0;379;8;371
273100031;500;714;716;9;381;499;1;0;0;0;0;381;6;375
273100032;500;808;809;7;400;499;1;0;0;0;0;400;7;393
273100033;500;795;795;8;390;499;1;0;0;0;0;390;5;385
273100034;600;845;845;8;411;599;1;0;0;0;0;411;5;406
273100035;500;769;773;5;361;500;0;0;0;0;0;361;5;356
273100036;400;247;595;6;253;399;1;0;0;0;0;253;4;249
273100037;400;550;551;6;262;399;1;0;0;0;0;262;6;256
273100038;600;898;898;8;434;600;0;0;0;0;0;434;9;425
273100039;600;952;952;8;446;599;1;0;0;0;0;446;5;441
273100040;600;888;889;8;433;599;1;0;0;0;0;433;6;427
273100041;600;836;838;7;402;599;1;0;0;0;0;402;4;398
273100042;500;691;691;10;350;499;1;0;0;0;0;350;9;341
273100043;500;798;802;9;422;499;1;0;0;0;0;422;3;419
273100044;500;818;818;8;423;499;1;0;0;0;0;423;3;420
273100045;600;962;962;12;376;599;1;0;0;0;0;376;6;370
273100046;600;838;838;7;377;599;1;0;0;0;0;377;6;371
273100047;600;902;903;5;393;599;1;0;0;0;0;393;2;391
273100048;400;528;528;7;212;399;1;0;0;0;0;212;1;211
273100049;400;632;632;6;259;399;1;0;0;0;0;259;4;255
273100050;500;768;768;11;359;500;0;0;0;0;0;359;4;355
273100051;500;752;758;7;357;499;1;0;0;0;0;357;9;348
273100052;600;916;920;9;479;600;0;0;0;0;0;479;6;473
273100053;500;803;803;11;411;499;1;0;0;0;0;411;3;408
273100054;500;827;827;7;415;499;1;0;0;0;0;415;5;410
273100055;500;789;789;6;383;499;1;0;0;0;0;383;3;380
273100056;600;930;931;11;520;599;1;0;0;0;0;520;6;514
273100057;500;806;808;6;390;500;0;0;0;0;0;390;3;387
273100058;500;823;824;6;388;499;1;0;0;0;0;388;2;386
273100059;400;503;504;4;250;399;1;0;0;0;0;250;0;250
273100060;600;837;837;8;406;599;1;0;0;0;0;406;3;403
273100061;500;781;782;6;346;500;0;0;0;0;0;346;12;334
273100062;400;553;553;10;300;399;1;0;0;0;0;300;3;297
273100063;200;126;126;43;116;83;1;116;3;4;109;0;0;0
273100064;600;848;851;9;420;599;1;0;0;0;0;420;8;412
273100065;600;902;902;9;439;599;1;0;0;0;0;439;6;433
273100066;300;954;954;12;468;299;1;0;0;0;0;468;4;464
273100067;700;1014;1015;9;516;699;1;0;0;0;0;516;8;508
273100068;500;705;705;11;340;499;1;0;0;0;0;340;4;336
273100069;500;812;813;6;388;500;0;0;0;0;0;388;8;380
273100070;600;958;958;12;441;599;1;0;0;0;0;441;7;434
273100071;600;929;935;11;451;599;1;0;0;0;0;451;5;446
273100072;600;869;871;13;424;600;0;0;0;0;0;424;5;419
273100073;500;784;787;7;363;499;1;0;0;0;0;363;5;358
273100074;500;742;745;9;359;499;1;0;0;0;0;359;4;355
273100075;500;748;749;10;381;500;0;0;0;0;0;381;5;376
273100076;600;925;927;7;473;598;2;0;0;0;0;473;6;467
273100077;500;743;743;6;396;499;1;0;0;0;0;396;6;390
273100078;700;1118;1118;10;572;699;1;0;0;0;0;572;4;568
273100079;600;835;836;9;410;599;1;0;0;0;0;410;2;408
273100080;400;665;667;6;346;399;1;0;0;0;0;346;5;341
273100081;400;541;546;7;278;399;1;0;0;0;0;278;3;275
273100082;500;758;758;6;368;499;1;0;0;0;0;368;8;360
273100083;500;798;800;8;386;499;1;0;0;0;0;386;11;375
273100084;600;916;916;8;467;599;1;0;0;0;0;467;15;452
273100085;400;605;605;9;250;399;1;0;0;0;0;250;7;243
273100086;700;1127;1130;11;516;699;1;0;0;0;0;516;5;511
273100087;600;412;896;6;418;600;0;0;0;0;0;418;5;413
273100088;500;706;706;12;303;499;1;0;0;0;0;303;3;300
273100089;700;1161;1162;9;173;699;1;0;0;0;0;173;2;171
273100090;600;998;998;11;323;600;0;0;0;0;0;323;2;321
273100091;500;776;776;8;365;498;2;0;0;0;0;365;6;359
273100092;500;775;776;8;360;499;1;0;0;0;0;360;6;354
273100093;500;666;669;7;302;499;1;0;0;0;0;302;1;301
273100094;600;898;899;10;402;599;1;0;0;0;0;402;4;398
273100095;600;918;918;9;432;599;1;0;0;0;0;432;10;422
273100096;500;678;682;9;290;499;1;0;0;0;0;290;4;286
273100097;700;1000;1003;7;477;699;1;0;0;0;0;477;9;468
273100098;400;654;654;10;302;399;1;0;0;0;0;302;3;299
273100099;600;842;842;8;380;599;1;0;0;0;0;380;2;378
273100100;500;767;768;7;376;499;1;0;0;0;0;376;1;375
273100101;400;623;623;9;294;399;1;0;0;0;0;294;5;289
273100102;600;833;835;8;397;599;1;0;0;0;0;397;7;390
273100103;400;606;606;10;275;399;1;0;0;0;0;275;3;272
273100104;400;521;523;8;245;399;1;0;0;0;0;245;5;240
273100105;700;1039;1039;7;521;699;1;0;0;0;0;521;3;518
273100106;400;517;519;9;222;399;1;0;0;0;0;222;3;219
273100107;500;672;672;9;307;499;1;0;0;0;0;307;7;300
273100108;400;639;639;8;317;399;1;0;0;0;0;317;4;313
273100109;600;888;888;11;408;599;1;0;0;0;0;408;10;398
273100110;400;609;609;6;259;399;1;0;0;0;0;259;4;255
273100111;500;833;833;10;390;499;1;0;0;0;0;390;5;385
273100112;400;587;588;7;227;399;1;0;0;0;0;227;2;225
273100113;600;933;936;8;421;599;1;0;0;0;0;421;8;413
273100114;500;667;669;8;283;499;1;0;0;0;0;283;6;277
273100115;500;802;803;14;344;499;1;0;0;0;0;344;5;339
273100116;600;864;865;9;421;599;1;0;0;0;0;421;5;416
273100117;600;922;923;8;431;599;1;0;0;0;0;431;7;424
273100118;900;1392;1392;10;672;900;0;0;0;0;0;672;8;664
273100119;600;865;867;11;363;599;1;0;0;0;0;363;3;360
273100120;700;1031;1034;8;453;699;1;0;0;0;0;453;13;440
273100121;500;805;806;5;319;499;1;0;0;0;0;319;2;317
273100122;500;809;811;6;342;499;1;0;0;0;0;342;5;337
273100123;500;751;754;6;279;499;1;0;0;0;0;279;4;275
273100124;400;590;590;8;257;400;0;0;0;0;0;257;5;252
273100125;500;808;811;7;348;499;1;0;0;0;0;348;0;348
273100126;500;769;774;8;319;499;1;0;0;0;0;319;6;313
273100127;600;890;885;8;401;599;1;0;0;0;0;401;5;396
273100128;500;749;751;8;287;499;1;0;0;0;0;287;2;285
273100129;500;805;807;6;300;499;1;0;0;0;0;300;3;297
273100130;600;871;871;8;344;599;1;0;0;0;0;344;4;340
273100131;600;866;866;7;299;600;0;0;0;0;0;299;3;296
273100132;700;1106;1107;7;157;699;1;0;0;0;0;157;0;157
273100133;700;1110;1110;8;203;699;1;0;0;0;0;203;3;200
273100134;700;1145;1146;6;135;699;1;0;0;0;0;135;0;135
273100135;800;1187;1190;6;100;799;1;0;0;0;0;100;0;100
273100136;800;1208;1213;10;165;799;1;0;0;0;0;165;0;165
273100137;700;1118;1118;8;120;699;1;0;0;0;0;120;4;116
273100138;800;1205;1206;8;117;799;1;0;0;0;0;117;0;117
273100139;600;960;962;4;462;599;1;0;0;0;0;462;5;457
273100140;700;1131;1131;4;504;700;0;0;0;0;0;504;7;497
273100141;600;839;839;5;345;599;1;0;0;0;0;345;2;343
273100142;500;814;814;4;359;499;1;0;0;0;0;359;5;354
273100143;600;857;858;5;378;599;1;0;0;0;0;378;6;372
273100144;500;805;805;7;353;499;1;0;0;0;0;353;3;350
273100145;100;50;50;10;39;60;1;39;2;0;37;0;0;0
273100146;700;1009;1009;1;388;699;1;0;0;0;0;388;8;380
273100147;600;981;983;4;442;599;1;0;0;0;0;442;7;435
273100148;700;1095;1102;7;488;699;1;0;0;0;0;488;4;484
273100149;600;864;864;5;395;600;0;0;0;0;0;395;5;390
273100150;400;136;600;5;139;399;1;0;0;0;0;139;1;138
273100151;100;71;71;4;65;33;2;65;1;0;64;0;0;0
273100152;200;109;109;3;79;120;1;79;4;1;74;0;0;0
273100153;600;894;896;6;170;600;0;0;0;0;0;170;0;170
273100154;100;86;87;5;45;54;1;45;1;1;43;0;0;0
273100155;200;151;151;5;111;85;4;111;2;0;109;0;0;0
273100156;400;641;643;0;174;399;1;0;0;0;0;174;1;173
273100157;500;787;787;6;203;499;1;0;0;0;0;203;1;202
273100158;300;377;377;3;171;299;1;0;0;0;0;171;1;170
273100159;400;515;517;1;225;399;1;0;0;0;0;225;0;225
273100160;300;486;487;4;194;299;1;0;0;0;0;194;4;190
273100161;600;975;975;2;203;599;1;0;0;0;0;203;3;200
273100162;300;88;207;7;95;204;1;95;1;1;93;0;0;0
273100163;100;52;52;5;40;59;1;40;2;2;36;0;0;0
273100164;300;473;473;4;217;300;0;0;0;0;0;217;2;215
273100165;300;264;266;7;192;106;2;192;3;2;187;0;0;0
273100166;200;131;133;7;102;96;2;102;3;3;96;0;0;0
273100167;400;280;282;6;197;202;1;197;6;4;187;0;0;0
273100168;200;123;123;4;108;91;1;108;1;1;106;0;0;0
273100169;200;106;106;5;79;120;1;79;2;0;77;0;0;0
273100170;200;99;99;6;80;119;1;80;3;0;77;0;0;0
273100171;200;105;105;5;79;120;1;79;2;3;74;0;0;0
273100172;300;209;209;5;168;130;2;168;2;5;161;0;0;0
273100173;201;92;92;5;81;119;1;81;1;0;80;0;0;0
273100174;200;103;104;4;87;112;1;87;4;1;82;0;0;0
273100175;300;415;415;6;199;299;1;0;0;0;0;199;1;198
273100176;100;48;49;4;41;58;1;41;0;1;40;0;0;0
273100177;300;409;410;6;231;299;1;0;0;0;0;231;4;227
273100178;400;627;627;6;304;400;0;0;0;0;0;304;5;299
273100179;400;572;574;6;270;399;1;0;0;0;0;270;3;267
273100180;300;499;500;7;135;299;1;0;0;0;0;135;0;135
273100181;400;333;334;3;183;216;1;183;3;1;179;0;0;0
273100182;300;202;202;7;125;174;1;125;10;2;113;0;0;0
273100183;500;764;769;5;221;499;1;0;0;0;0;221;2;219
273100184;400;314;314;6;174;225;1;174;7;4;163;0;0;0
273100185;200;108;108;6;73;126;1;73;1;0;72;0;0;0
273100186;100;67;67;7;57;42;1;57;1;1;55;0;0;0
273100187;200;103;103;6;54;145;1;54;0;1;53;0;0;0
273100188;300;228;228;8;141;158;1;141;3;1;137;0;0;0
273100189;100;100;46;6;32;66;2;32;2;0;30;0;0;0
273100190;200;129;129;5;72;127;1;72;3;0;69;0;0;0
273100191;400;284;284;4;136;263;1;136;2;2;132;0;0;0
273100192;300;244;245;5;148;151;1;148;1;0;147;0;0;0
273100193;300;236;236;2;149;148;3;149;5;1;143;0;0;0
273100194;200;111;111;4;82;117;1;82;6;1;75;0;0;0
273100195;400;654;654;4;255;399;1;0;0;0;0;255;3;252
273100196;300;417;417;5;240;299;1;0;0;0;0;240;1;239
273100197;400;592;595;4;231;399;1;0;0;0;0;231;1;230
273100198;300;232;233;5;130;168;2;130;3;3;124;0;0;0
273100199;100;88;88;5;58;40;2;58;1;3;54;0;0;0
273100200;400;552;552;4;235;399;1;0;0;0;0;235;3;232
273100201;500;719;721;7;261;499;1;0;0;0;0;261;3;258
273100202;300;244;244;5;187;111;2;187;9;1;177;0;0;0
273100203;300;238;238;5;105;194;1;105;6;1;98;0;0;0
273100204;198;30;30;104;120;77;1;120;6;3;111;0;0;0
273100205;100;33;33;11;40;59;1;40;3;0;37;0;0;0
273100206;100;39;39;21;58;41;1;58;6;1;51;0;0;0
273100207;100;46;46;10;55;43;2;55;7;3;45;0;0;0
273100208;100;38;38;10;47;51;2;47;0;0;47;0;0;0
273600001;500;701;704;2;293;499;1;0;0;0;0;293;1;292
273600002;500;771;774;0;230;500;0;0;0;0;0;230;2;228
273600003;500;787;789;4;230;500;0;0;0;0;0;230;2;228
273600004;500;733;734;8;284;499;1;0;0;0;0;284;6;278
273600005;500;740;743;11;273;499;1;0;0;0;0;273;3;270
273600006;500;670;670;0;190;499;1;0;0;0;0;190;0;190
273600007;500;813;813;1;208;499;1;0;0;0;0;208;1;207
273600008;500;697;697;4;183;500;0;0;0;0;0;183;4;179
273600009;500;733;734;1;217;499;1;0;0;0;0;217;1;216
273600010;500;781;786;3;311;499;1;0;0;0;0;311;4;307
273600011;500;756;760;5;212;499;1;0;0;0;0;212;3;209
273600012;500;615;617;5;273;499;1;0;0;0;0;273;4;269
273600013;500;686;687;3;267;499;1;0;0;0;0;267;4;263
273600014;500;574;574;6;214;499;1;0;0;0;0;214;3;211
273600015;500;752;753;5;313;499;1;0;0;0;0;313;4;309
273600016;500;647;650;0;246;499;1;0;0;0;0;246;3;243
273600017;500;577;577;8;247;499;1;0;0;0;0;247;2;245
273600018;500;900;902;3;265;499;1;0;0;0;0;265;1;264
273600019;100;15;15;14;21;78;1;21;0;0;21;0;0;0
273600020;500;538;540;6;231;499;1;0;0;0;0;231;0;231
273600021;500;480;481;3;202;499;1;0;0;0;0;203;2;201
273600022;200;181;182;5;79;120;1;79;10;0;69;0;0;0
273600023;100;58;58;6;46;51;3;46;2;1;43;0;0;0
273600024;200;114;114;5;51;148;1;51;0;0;51;0;0;0
273600025;500;753;753;8;117;500;0;0;0;0;0;117;2;115
273600026;500;509;509;7;171;499;1;0;0;0;0;171;1;170
273600027;100;72;72;6;39;60;1;39;2;0;37;0;0;0
273600029;100;62;62;6;37;62;1;37;3;0;34;0;0;0
273600030;200;168;168;4;107;92;1;107;0;0;107;0;0;0
273600031;200;103;130;4;107;92;1;107;5;1;101;0;0;0
273600032;500;673;673;0;156;499;1;0;0;0;0;156;0;156
273600033;200;124;124;4;77;122;1;77;4;0;73;0;0;0
273600034;200;132;132;5;61;138;1;61;4;0;57;0;0;0
273600035;500;353;353;2;136;499;1;0;0;0;0;136;0;136
273600036;300;220;221;4;150;149;1;150;2;1;147;0;0;0
273600037;200;108;108;9;88;110;2;88;3;0;85;0;0;0
273600038;100;63;63;4;56;43;1;56;3;1;52;0;0;0
273600040;100;15;15;1;16;84;0;16;0;0;16;0;0;0
273700001;600;736;737;3;347;599;1;0;0;0;0;347;1;346
273700002;600;738;747;3;369;599;1;0;0;0;0;369;1;368
273700003;700;914;917;1;405;699;1;0;0;0;0;405;1;404
273700004;500;625;625;2;245;499;1;0;0;0;0;245;2;243
273700005;700;809;821;3;274;699;1;0;0;0;0;274;1;273
273700006;300;346;347;5;165;299;1;0;0;0;0;165;1;164
273700007;100;41;41;5;21;79;0;21;0;0;21;0;0;0
273700008;100;22;22;6;21;78;1;21;2;0;19;0;0;0
273700009;100;22;22;2;18;81;1;18;0;0;18;0;0;0
273700010;100;29;29;13;35;64;1;35;12;0;23;0;0;0
273700011;100;18;18;2;16;83;1;16;1;0;15;0;0;0
273800001;700;726;732;7;333;699;1;0;0;0;0;333;1;332
273800002;800;769;769;1;295;799;1;0;0;0;0;295;1;294
273800003;800;775;776;0;341;799;1;0;0;0;0;341;0;341
273800004;400;346;350;2;167;399;1;0;0;0;0;167;0;167
273800005;700;629;629;6;256;698;2;0;0;0;0;256;0;256
273800006;400;412;412;6;180;399;1;0;0;0;0;180;0;180
273800007;100;25;25;0;24;75;1;24;0;0;24;0;0;0
280200001;300;640;643;4;227;299;1;0;0;0;0;227;1;226
280200002;300;645;652;1;211;299;1;0;0;0;0;211;2;209
280200003;60;46;46;5;29;30;1;29;1;1;27;0;0;0
280200004;100;24;24;4;24;75;1;24;0;0;24;0;0;0
280200005;100;29;29;5;23;76;1;23;0;0;23;0;0;0
280200006;100;68;69;6;49;50;1;49;0;0;49;0;0;0
280200007;100;55;55;5;41;58;1;41;1;0;40;0;0;0
280200008;60;23;23;7;21;38;1;21;0;0;21;0;0;0
280200009;80;25;26;8;25;54;1;25;0;0;25;0;0;0
280200010;100;30;30;5;26;73;1;26;1;0;25;0;0;0
280200011;100;57;57;5;37;62;1;37;0;0;37;0;0;0
280200012;200;249;251;3;127;72;1;127;1;1;125;0;0;0
280200013;200;314;314;5;104;200;0;0;0;0;0;104;0;104
280200014;100;80;80;3;53;46;1;53;2;0;51;0;0;0
280200015;100;69;69;5;45;54;1;45;1;0;44;0;0;0
280200016;120;126;126;2;70;49;1;70;2;0;68;0;0;0
280200017;100;47;47;3;33;65;2;33;1;0;32;0;0;0
280200018;100;85;85;4;44;55;1;44;1;1;42;0;0;0
280200019;200;278;278;2;148;50;2;148;5;3;140;0;0;0
280200020;100;60;60;6;39;60;1;39;0;0;39;0;0;0
280200021;50;24;24;6;16;33;1;16;0;0;16;0;0;0
280200022;150;151;151;7;63;86;1;63;0;0;63;0;0;0
280200023;150;181;182;5;112;37;1;112;1;0;111;0;0;0
280200024;100;76;76;7;48;51;1;48;1;0;47;0;0;0
280200025;100;51;51;3;37;62;1;37;1;0;36;0;0;0
280200026;200;195;196;4;109;90;1;109;3;0;106;0;0;0
280200027;50;21;21;6;21;28;1;21;1;0;20;0;0;0
280200028;50;29;22;7;23;26;1;23;1;0;22;0;0;0
280200029;200;216;216;4;135;64;1;135;2;3;130;0;0;0
280200030;100;32;32;6;16;84;0;16;0;0;16;0;0;0
280200031;120;55;109;6;55;64;1;55;0;0;55;0;0;0
280200032;200;191;364;2;191;200;0;0;0;0;0;191;1;190
280200033;100;30;30;5;23;74;3;23;0;0;23;0;0;0
280200034;180;178;180;4;97;82;1;97;8;1;88;0;0;0
280200035;340;672;685;6;296;340;0;0;0;0;0;296;6;290
280200036;100;35;35;4;27;72;1;27;0;0;27;0;0;0
280200037;110;82;82;5;59;50;1;59;1;1;57;0;0;0
280200038;120;93;93;3;67;52;1;67;2;0;65;0;0;0
280200039;90;40;40;8;33;56;1;33;0;0;33;0;0;0
280200040;70;40;40;0;40;30;0;40;0;0;40;0;0;0
282200001;500;657;657;6;284;499;1;0;0;0;0;284;4;280
282200002;500;607;607;7;217;499;1;0;0;0;0;217;5;212
282200003;800;937;943;6;344;799;1;0;0;0;0;344;13;331
282200004;500;642;643;6;183;499;1;0;0;0;0;183;1;182
282200005;500;657;662;4;216;499;1;0;0;0;0;216;5;211
282200006;400;582;582;5;183;399;1;0;0;0;0;183;4;179
282200007;600;749;751;6;172;599;1;0;0;0;0;172;1;171
282200008;700;798;799;7;114;699;1;0;0;0;0;114;0;114
282200009;900;1083;1086;9;237;899;1;0;0;0;0;237;0;237
282200010;500;631;637;0;192;499;1;0;0;0;0;192;2;190
282200011;500;733;734;4;170;499;1;0;0;0;0;170;1;169
282200012;800;918;931;6;180;799;1;0;0;0;0;180;0;180
282200013;300;248;248;4;120;179;1;120;4;2;114;0;0;0
282200014;300;321;329;6;155;299;1;0;0;0;0;155;0;155
282200015;600;673;673;9;183;599;1;0;0;0;0;183;3;180
282200016;400;447;458;5;188;399;1;0;0;0;0;188;2;186
282200017;200;130;133;5;78;121;1;78;2;0;76;0;0;0
282200018;300;302;305;7;173;299;1;0;0;0;0;173;0;173
282200019;700;865;865;7;231;699;1;0;0;0;0;231;3;228
282200020;300;340;340;7;134;299;1;0;0;0;0;134;0;134
282200021;300;416;416;8;154;299;1;0;0;0;0;154;0;154
282200022;300;263;263;5;160;139;1;160;0;0;160;0;0;0
282200023;200;169;169;7;94;105;1;94;2;2;90;0;0;0
282200024;300;225;225;7;95;204;1;95;1;0;94;0;0;0
282200025;300;278;283;5;106;193;1;106;2;2;102;0;0;0
282200026;400;419;419;6;244;399;1;0;0;0;0;244;2;242
282200027;210;210;210;7;91;117;2;91;0;3;88;0;0;0
282200028;600;777;777;9;243;600;0;0;0;0;0;243;1;242
282200029;600;720;720;7;330;599;1;0;0;0;0;330;0;330
282200030;300;236;238;6;113;186;1;113;2;0;111;0;0;0
282200031;400;472;477;4;143;400;0;0;0;0;0;143;0;143
282200032;600;617;634;6;193;599;1;0;0;0;0;193;2;191
282200033;500;545;575;5;194;499;1;0;0;0;0;194;2;192
282200034;300;289;297;7;119;299;1;0;0;0;0;119;0;119
282200035;500;591;591;8;238;499;1;0;0;0;0;238;2;236
282200036;300;224;224;4;135;164;1;135;1;5;129;0;0;0
282200037;500;521;523;7;203;499;1;0;0;0;0;203;0;203
282200038;800;809;811;5;267;799;1;0;0;0;0;267;4;263
282200039;400;369;369;5;143;399;1;0;0;0;0;143;1;142
282200040;200;132;132;5;49;150;1;49;0;0;49;0;0;0
282200041;200;178;178;3;98;101;1;98;2;0;96;0;0;0
282200042;700;784;794;7;283;699;1;0;0;0;0;283;1;282
282200043;300;227;227;4;106;193;1;106;6;0;100;0;0;0
282200044;600;723;725;8;243;599;1;0;0;0;0;243;1;242
282200045;300;291;291;5;126;173;1;126;2;0;124;0;0;0
282200046;300;303;309;5;112;299;1;0;0;0;0;112;2;110
282200047;300;272;272;6;149;150;1;149;5;1;143;0;0;0
282200048;100;54;54;6;27;72;1;27;0;0;27;0;0;0
282200049;200;124;124;5;80;119;1;80;0;2;78;0;0;0
282200050;100;68;68;6;38;61;1;38;0;0;38;0;0;0
282200051;800;875;880;8;237;798;2;0;0;0;0;237;2;235
282200052;400;394;394;6;153;399;1;0;0;0;0;153;0;153
282200053;100;29;29;18;31;68;1;31;1;0;30;0;0;0
282200054;100;19;19;3;22;77;1;22;0;0;22;0;0;0
282200055;100;45;45;3;45;54;1;45;2;0;43;0;0;0
282200056;100;41;41;4;45;54;1;45;1;1;43;0;0;0
282200057;100;40;40;3;42;57;1;42;2;0;40;0;0;0
282200058;100;25;25;2;27;70;3;27;3;0;24;0;0;0
282200059;100;22;22;7;28;71;1;28;0;0;28;0;0;0
282300001;500;570;575;8;221;499;1;0;0;0;0;221;2;219
282300002;500;547;553;5;224;499;1;0;0;0;0;224;4;220
282300003;700;747;757;3;317;699;1;0;0;0;0;317;2;315
282300004;400;444;447;5;211;399;1;0;0;0;0;211;2;209
282300005;700;806;806;9;401;699;1;0;0;0;0;401;0;401
282300006;300;354;361;7;189;299;1;0;0;0;0;189;2;187
282300007;500;548;557;8;201;499;1;0;0;0;0;201;2;199
282300008;500;486;486;8;147;499;1;0;0;0;0;147;2;145
282300009;300;315;318;2;165;299;1;0;0;0;0;165;0;165
282300010;400;460;466;7;220;399;1;0;0;0;0;220;1;219
282300011;400;433;433;5;176;399;1;0;0;0;0;176;4;172
282300012;100;63;63;6;63;36;1;63;1;0;62;0;0;0
282400001;600;714;716;3;272;600;0;0;0;0;0;272;10;262
282400002;600;658;659;9;241;600;0;0;0;0;0;241;6;235
282400003;600;724;724;6;284;599;1;0;0;0;0;284;3;281
282400004;600;646;646;9;291;600;0;0;0;0;0;291;3;288
282400005;900;955;957;8;240;900;0;0;0;0;0;240;1;239
282400006;800;869;870;5;308;800;0;0;0;0;0;308;5;303
282400007;700;785;785;9;124;700;0;0;0;0;0;124;1;123
282400008;700;797;798;7;97;700;0;0;0;0;0;97;1;96
282400009;800;931;932;9;323;800;0;0;0;0;0;323;3;320
282400010;700;777;779;10;265;700;0;0;0;0;0;265;3;262
282400011;600;605;606;8;217;600;0;0;0;0;0;217;3;214
282400012;700;802;802;5;267;700;0;0;0;0;0;267;3;264
282400013;700;777;778;11;306;700;0;0;0;0;0;306;7;299
282400014;600;645;647;8;228;600;0;0;0;0;0;228;3;225
282400015;700;762;762;10;307;700;0;0;0;0;0;307;3;304
282400016;800;819;820;4;270;799;1;0;0;0;0;270;5;265
282400017;700;802;802;6;229;700;0;0;0;0;0;229;4;225
282400018;700;768;769;0;274;700;0;0;0;0;0;274;2;272
282400019;200;238;238;8;128;71;1;128;2;1;125;0;0;0
282400020;200;211;211;5;76;123;1;76;4;0;72;0;0;0
282400021;400;499;499;5;72;400;0;0;0;0;0;72;0;72
282400022;100;108;108;7;58;41;1;58;1;0;57;0;0;0
282400023;100;83;83;7;55;44;1;55;3;1;51;0;0;0
282400024;100;29;29;6;25;74;1;25;0;1;24;0;0;0
282400025;500;513;513;7;169;500;0;0;0;0;0;169;3;166
282400026;500;570;570;5;148;500;0;0;0;0;0;148;1;147
282400027;500;502;502;4;98;500;0;0;0;0;0;98;0;98
282400028;100;72;72;5;36;63;1;36;2;0;34;0;0;0
282400029;200;213;213;6;76;123;1;76;6;2;68;0;0;0
282400030;300;393;393;4;110;300;0;0;0;0;0;110;0;110
282400031;300;335;335;5;63;300;0;0;0;0;0;63;0;63
282400032;100;72;72;7;46;53;1;46;1;0;45;0;0;0
282400033;700;765;765;7;118;700;0;0;0;0;0;118;0;118
282400034;200;185;185;6;126;73;1;126;2;0;124;0;0;0
282400035;100;108;108;6;58;41;1;58;2;0;56;0;0;0
282400036;300;397;398;5;75;300;0;0;0;0;0;75;0;75
282400037;600;684;685;7;68;600;0;0;0;0;0;68;0;68
282400038;400;502;502;6;171;399;1;0;0;0;0;171;3;168
282400039;300;288;288;6;176;123;1;176;4;3;169;0;0;0
282400040;100;35;35;7;27;70;3;27;2;0;25;0;0;0
282400041;600;672;672;5;143;600;0;0;0;0;0;143;1;142
282400042;100;61;61;6;48;51;1;48;0;0;48;0;0;0
282400043;400;465;469;3;192;400;0;0;0;0;0;192;2;190
282400044;100;89;89;8;46;54;0;46;3;0;43;0;0;0
282400045;200;332;332;5;178;21;1;178;3;0;175;0;0;0
282400046;100;32;32;7;32;67;1;32;0;1;31;0;0;0
282400047;100;142;142;6;73;26;1;73;2;0;71;0;0;0
282400048;600;668;668;2;194;600;0;0;0;0;0;194;3;191
282400049;900;909;909;5;177;900;0;0;0;0;0;177;3;174
282400050;700;720;720;6;201;700;0;0;0;0;0;201;0;201
282400051;200;200;202;6;70;129;1;70;1;0;69;0;0;0
282400052;100;128;128;6;72;27;1;72;1;0;71;0;0;0
282400053;100;12;12;13;16;83;1;16;1;0;15;0;0;0
283500001;600;774;776;5;353;599;1;0;0;0;0;353;5;348
283500002;600;647;647;7;244;599;1;0;0;0;0;244;0;244
283500003;600;674;675;6;250;599;1;0;0;0;0;250;5;245
283500004;600;915;915;6;329;599;1;0;0;0;0;329;6;323
283500005;600;676;676;8;270;599;1;0;0;0;0;270;4;266
283500006;700;786;786;7;265;699;1;0;0;0;0;265;4;261
283500007;700;712;712;8;276;699;1;0;0;0;0;276;1;275
283500008;700;736;740;8;256;699;1;0;0;0;0;256;1;255
283500009;700;657;658;7;214;699;1;0;0;0;0;214;5;209
283500010;700;739;739;5;224;699;1;0;0;0;0;224;6;218
283500011;700;900;901;5;269;699;1;0;0;0;0;269;2;267
283500012;600;657;658;7;244;599;1;0;0;0;0;244;1;243
283500013;800;911;914;6;364;800;0;0;0;0;0;364;2;362
283500014;800;918;919;8;371;799;1;0;0;0;0;371;5;366
283500015;800;900;901;8;400;799;1;0;0;0;0;400;6;394
283500016;700;785;785;8;295;699;1;0;0;0;0;295;2;293
283500017;700;799;799;6;328;699;1;0;0;0;0;328;4;324
283500018;800;878;881;6;374;800;0;0;0;0;0;374;5;369
283500019;700;747;751;7;335;700;0;0;0;0;0;335;0;335
283500020;700;717;718;10;287;699;1;0;0;0;0;287;6;281
283500021;800;906;908;4;398;800;0;0;0;0;0;398;8;390
283500022;800;958;959;5;373;799;1;0;0;0;0;373;4;369
283500023;800;928;930;7;383;800;0;0;0;0;0;383;6;377
283500024;600;656;656;6;161;600;0;0;0;0;0;161;3;158
283500025;800;919;921;5;300;799;1;0;0;0;0;300;5;295
283500026;700;702;704;9;323;699;1;0;0;0;0;323;6;317
283500027;800;899;901;8;337;799;1;0;0;0;0;337;6;331
283500028;500;560;560;6;244;499;1;0;0;0;0;244;3;241
283500029;600;669;671;5;286;600;0;0;0;0;0;286;0;286
283500030;600;577;577;9;278;599;1;0;0;0;0;278;3;275
283500031;700;686;687;8;314;699;1;0;0;0;0;314;2;312
283500032;800;752;753;7;357;799;1;0;0;0;0;357;5;352
283500033;600;629;630;9;275;600;0;0;0;0;0;275;3;272
283500034;800;765;756;10;335;799;1;0;0;0;0;335;4;331
283500035;800;870;871;9;314;799;1;0;0;0;0;314;5;309
283500036;800;904;904;5;333;799;1;0;0;0;0;333;11;322
283500037;700;680;683;9;267;699;1;0;0;0;0;267;1;266
283500038;800;808;809;7;301;800;0;0;0;0;0;301;6;295
283500039;600;633;636;8;216;599;1;0;0;0;0;216;0;216
283500040;800;971;972;7;285;799;1;0;0;0;0;285;4;281
283500041;600;674;674;9;198;599;1;0;0;0;0;198;1;197
283500042;700;847;847;7;119;699;1;0;0;0;0;119;1;118
283500043;800;1025;1026;7;101;799;1;0;0;0;0;101;1;100
283500044;700;815;816;10;273;699;1;0;0;0;0;273;2;271
283500045;500;497;497;5;198;499;1;0;0;0;0;198;1;197
283500046;400;499;499;5;189;399;1;0;0;0;0;189;3;186
283500047;300;375;375;8;127;299;1;0;0;0;0;127;0;127
283500048;200;258;259;5;101;97;2;101;2;2;97;0;0;0
283500049;150;125;125;6;77;72;1;77;1;3;73;0;0;0
283500050;700;841;842;6;311;388;1;311;8;6;297;0;0;0
283500051;200;162;163;6;88;110;2;88;1;0;87;0;0;0
283500052;300;299;305;8;137;300;0;0;0;0;0;137;0;137
283500053;300;313;314;9;175;300;0;0;0;0;0;175;1;174
283500054;400;508;510;2;155;399;1;0;0;0;0;155;1;154
283500055;600;596;596;8;96;599;1;0;0;0;0;96;0;96
283500056;300;269;269;7;99;200;1;99;2;0;97;0;0;0
283500057;800;846;846;4;108;799;1;0;0;0;0;108;0;108
283500058;400;436;437;6;133;399;1;0;0;0;0;133;0;133
283500059;500;508;509;7;87;500;0;0;0;0;0;87;1;86
283500060;400;391;392;6;36;399;1;0;0;0;0;36;0;36
283500061;100;90;91;8;31;68;1;31;0;0;31;0;0;0
283500062;300;320;322;4;99;299;1;0;0;0;0;99;2;97
283500063;400;405;406;4;178;399;1;0;0;0;0;178;1;177
283500064;400;445;445;8;165;399;1;0;0;0;0;165;1;164
283500065;400;449;449;6;148;400;0;0;0;0;0;148;0;148
283500066;400;402;403;5;131;399;1;0;0;0;0;131;3;128
283500067;400;468;468;7;144;399;1;0;0;0;0;144;0;144
283500068;500;495;495;6;188;499;1;0;0;0;0;188;6;182
283500069;200;225;225;7;133;66;1;133;11;0;122;0;0;0
283500070;100;67;67;5;48;51;1;48;4;0;44;0;0;0
283500071;200;188;189;6;85;114;1;85;4;1;80;0;0;0
283500072;500;538;538;7;124;500;0;0;0;0;0;124;3;121
283500073;400;428;428;5;93;400;0;0;0;0;0;93;1;92
283500074;300;394;397;5;156;299;1;0;0;0;0;156;1;155
283500075;200;231;232;6;114;85;1;114;1;1;112;0;0;0
283500076;500;595;596;4;198;499;1;0;0;0;0;198;1;197
283500077;200;210;210;6;153;46;1;153;1;1;151;0;0;0
283500078;150;149;149;5;75;74;1;75;1;0;74;0;0;0
283500079;100;81;81;6;50;48;2;50;5;0;45;0;0;0
283500080;400;416;419;6;91;399;1;0;0;0;0;91;1;90
283500081;600;639;646;9;326;599;1;0;0;0;0;326;0;326
283500082;50;38;38;4;27;22;1;27;1;0;26;0;0;0
283500083;400;390;390;6;101;399;1;0;0;0;0;101;2;99
283500084;400;417;418;5;130;399;1;0;0;0;0;130;0;130
283500085;400;427;428;4;99;399;1;0;0;0;0;99;0;99
283500086;300;341;341;7;84;299;1;0;0;0;0;84;0;84
283500087;500;504;505;7;57;499;1;0;0;0;0;57;1;56
283500088;200;223;223;7;124;73;3;124;5;0;119;0;0;0
283500089;200;209;209;6;91;108;1;91;5;0;86;0;0;0
283500090;300;373;373;7;141;299;1;0;0;0;0;141;0;141
283500091;100;113;113;8;68;31;1;68;1;2;65;0;0;0
283500092;100;97;97;5;56;43;1;56;4;0;52;0;0;0
283500093;600;606;607;9;244;599;1;0;0;0;0;244;2;242
283500094;200;193;199;5;61;138;1;61;2;0;59;0;0;0
283500095;500;520;520;4;110;499;1;0;0;0;0;110;0;110
283500096;400;421;421;7;121;399;1;0;0;0;0;121;0;121
283500097;250;263;264;6;63;186;1;63;1;0;62;0;0;0
283500098;600;670;670;5;240;600;0;0;0;0;0;240;1;239
283500099;300;324;324;6;121;299;1;0;0;0;0;121;2;119
283500100;500;550;559;9;176;499;1;0;0;0;0;176;0;176
283500101;250;229;229;7;75;174;1;75;0;0;75;0;0;0
283500102;100;81;81;6;48;51;1;48;4;2;42;0;0;0
283500103;700;786;788;11;332;699;1;0;0;0;0;332;3;329
283500104;50;26;26;11;21;28;1;21;0;0;21;0;0;0
283500105;50;39;39;0;39;10;1;39;1;0;38;0;0;0
290900001;300;464;464;5;184;299;1;0;0;0;0;184;4;180
290900002;300;676;676;5;273;299;1;0;0;0;0;273;2;271
290900003;628;628;628;7;294;627;1;0;0;0;0;294;4;290
290900004;200;370;370;4;141;199;1;0;0;0;0;141;0;141
290900005;200;445;445;6;152;199;1;0;0;0;0;152;3;149
290900006;300;523;523;3;224;299;1;0;0;0;0;224;3;221
290900007;200;462;462;3;187;199;1;0;0;0;0;187;1;186
290900008;300;610;611;6;219;299;1;0;0;0;0;219;0;219
290900009;300;622;622;5;251;299;1;0;0;0;0;251;0;251
290900010;300;528;524;8;232;299;1;0;0;0;0;232;3;229
290900011;300;553;554;7;180;299;1;0;0;0;0;180;0;180
290900012;300;640;642;3;230;299;1;0;0;0;0;230;3;227
290900013;300;694;694;6;263;299;1;0;0;0;0;263;2;261
290900014;400;741;743;5;328;399;1;0;0;0;0;328;4;324
290900015;300;493;494;10;214;299;1;0;0;0;0;215;3;212
290900016;300;658;658;5;237;299;1;0;0;0;0;237;1;236
290900017;300;632;632;8;277;299;1;0;0;0;0;277;2;275
290900018;400;676;676;6;302;399;1;0;0;0;0;302;1;301
290900019;400;701;702;7;267;399;1;0;0;0;0;267;7;260
290900020;300;658;659;6;256;299;1;0;0;0;0;256;1;255
290900021;300;649;653;9;262;299;1;0;0;0;0;262;3;259
290900022;300;617;617;6;262;299;1;0;0;0;0;262;6;256
290900023;200;488;488;6;165;199;1;0;0;0;0;165;2;163
290900024;300;672;673;5;265;299;1;0;0;0;0;265;2;263
290900025;300;780;781;6;319;299;1;0;0;0;0;319;6;313
290900026;300;966;968;9;368;300;0;0;0;0;0;368;6;362
290900027;300;541;542;8;221;299;1;0;0;0;0;221;1;220
290900028;300;637;637;8;243;299;1;0;0;0;0;243;4;239
290900029;300;551;552;9;209;299;1;0;0;0;0;209;6;203
290900030;300;644;644;7;214;299;1;0;0;0;0;214;2;212
290900031;400;711;711;4;278;399;1;0;0;0;0;278;3;275
290900032;300;640;642;9;243;61;1;238;6;5;227;5;0;5
290900033;300;580;580;5;233;299;1;0;0;0;0;233;5;228
290900034;200;467;468;7;173;199;1;0;0;0;0;173;4;169
290900035;200;391;391;6;139;199;1;0;0;0;0;139;2;137
290900036;400;852;854;4;343;399;1;0;0;0;0;343;3;340
290900037;300;949;949;7;368;299;1;0;0;0;0;368;2;366
290900038;400;750;750;5;315;399;1;0;0;0;0;315;0;315
290900039;300;617;617;10;254;299;1;0;0;0;0;254;5;249
290900040;300;543;543;10;236;299;1;0;0;0;0;236;3;233
290900041;300;485;485;3;189;299;1;0;0;0;0;189;2;187
290900042;300;590;592;6;257;299;1;0;0;0;0;257;6;251
290900043;300;607;607;9;280;299;1;0;0;0;0;280;9;271
290900044;300;519;519;7;258;299;1;0;0;0;0;258;2;256
290900045;400;697;692;5;288;399;1;0;0;0;0;288;2;286
290900046;300;621;622;5;253;299;1;0;0;0;0;253;1;252
290900047;300;610;610;8;244;299;1;0;0;0;0;244;2;242
290900048;300;524;524;8;173;299;1;0;0;0;0;173;1;172
290900049;400;909;910;6;228;398;2;0;0;0;0;228;3;225
290900050;300;682;682;4;169;299;1;0;0;0;0;169;1;168
290900051;300;652;652;2;159;299;1;0;0;0;0;159;1;158
290900052;200;285;285;1;50;149;1;50;10;1;39;0;0;0
290900053;200;457;458;5;88;199;1;0;0;0;0;88;1;87
290900054;300;636;636;7;153;299;1;0;0;0;0;153;2;151
290900055;200;514;514;8;146;198;2;0;0;0;0;146;2;144
290900056;300;582;582;5;78;299;1;0;0;0;0;78;1;77
290900057;500;788;789;5;82;499;1;0;0;0;0;82;1;81
290900058;500;770;770;10;75;499;1;0;0;0;0;75;1;74
290900059;100;21;21;20;39;60;1;39;0;0;39;0;0;0
290900060;400;397;398;6;157;399;1;0;0;0;0;157;0;157
290900061;100;56;56;6;42;56;2;42;1;0;41;0;0;0
290900062;400;482;482;4;265;399;1;0;0;0;0;265;2;263
290900063;400;415;415;4;221;399;1;0;0;0;0;221;6;215
290900064;300;318;321;6;139;299;1;0;0;0;0;139;2;137
290900065;100;40;40;5;36;63;1;36;0;0;36;0;0;0
290900066;400;440;441;4;241;399;1;0;0;0;0;241;2;239
290900067;500;621;621;4;312;499;1;0;0;0;0;312;4;308
290900068;400;317;317;4;174;224;2;174;5;2;167;0;0;0
290900069;300;392;392;2;131;299;1;0;0;0;0;131;1;130
290900070;400;656;661;4;156;399;1;0;0;0;0;156;1;155
290900071;300;287;287;1;154;145;1;154;8;0;146;0;0;0
290900072;300;412;413;5;168;299;1;0;0;0;0;168;0;168
290900073;300;213;213;7;106;183;11;106;9;1;96;0;0;0
290900074;200;187;188;6;104;95;1;104;0;0;104;0;0;0
290900075;100;60;60;4;42;57;1;42;2;0;40;0;0;0
290900076;300;388;388;4;115;299;1;0;0;0;0;115;1;114
290900077;300;441;442;3;141;299;1;0;0;0;0;141;1;140
290900078;400;539;540;4;129;399;1;0;0;0;0;129;3;126
290900079;200;126;128;4;73;126;1;73;7;0;66;0;0;0
290900080;500;617;617;6;228;499;1;0;0;0;0;228;4;224
290900081;500;605;601;4;217;499;1;0;0;0;0;217;1;216
290900082;500;822;823;6;259;499;1;0;0;0;0;259;3;256
290900083;300;264;265;7;118;181;1;118;5;1;112;0;0;0
290900084;200;139;139;6;92;106;2;92;3;1;88;0;0;0
290900085;200;175;175;5;104;95;1;104;7;1;96;0;0;0
290900086;300;368;368;5;175;144;1;155;7;0;148;20;0;20
290900087;500;808;808;5;252;499;1;0;0;0;0;252;0;252
290900088;200;194;194;4;111;88;1;111;3;1;107;0;0;0
290900089;100;94;94;6;74;25;1;74;0;0;74;0;0;0
290900090;500;575;578;7;267;499;1;0;0;0;0;267;4;263
290900091;200;174;174;5;96;103;1;96;4;1;91;0;0;0
291100001;300;565;569;2;296;300;0;0;0;0;0;296;8;288
291100002;300;608;612;7;297;299;1;0;0;0;0;297;4;293
291100003;300;857;860;4;481;299;1;0;0;0;0;481;6;475
291100004;300;719;724;7;367;299;1;0;0;0;0;367;4;363
291100005;300;408;408;7;243;299;1;0;0;0;0;243;2;241
291100006;300;265;272;6;163;136;1;163;8;2;153;0;0;0
291100007;100;55;59;6;49;50;1;49;1;0;48;0;0;0
291100008;200;196;196;5;98;101;1;98;2;0;96;0;0;0
291100009;100;71;73;6;54;45;1;54;0;0;54;0;0;0
291100010;100;64;64;6;49;50;1;49;1;0;48;0;0;0
291100011;100;86;86;7;25;74;1;25;0;2;23;0;0;0
291100012;100;51;51;6;22;78;0;22;4;0;18;0;0;0
291100013;200;328;328;5;80;200;0;0;0;0;0;80;0;80
291100014;100;41;41;9;32;67;1;32;0;1;31;0;0;0
291100015;200;108;108;6;76;123;1;76;1;0;75;0;0;0
291100016;100;84;84;4;63;36;1;63;0;3;60;0;0;0
291100017;200;104;104;5;74;125;1;74;3;1;70;0;0;0
291100018;200;214;214;5;71;128;1;71;0;1;70;0;0;0
291100019;200;150;150;7;53;146;1;53;1;0;52;0;0;0
291100020;200;111;534;7;118;199;1;0;0;0;0;118;0;118
291100021;200;329;329;6;75;199;1;0;0;0;0;75;0;75
291100022;329;329;329;6;95;329;0;0;0;0;0;95;0;95
291100023;200;160;160;6;60;139;1;60;6;0;54;0;0;0
291100024;50;14;14;5;15;34;1;15;1;1;13;0;0;0
291100025;50;26;26;0;26;23;1;26;0;0;26;0;0;0
291700001;550;558;559;5;283;549;1;0;0;0;0;283;4;279
291700002;650;671;671;1;264;649;1;0;0;0;0;264;0;264
291700003;700;666;668;1;326;699;1;0;0;0;0;326;3;323
291700004;700;699;699;8;361;699;1;0;0;0;0;361;6;355
291700005;550;560;560;5;320;549;1;0;0;0;0;320;7;313
291700006;650;661;661;2;343;649;1;0;0;0;0;343;4;339
291700007;650;637;638;3;372;649;1;0;0;0;0;372;6;366
291700008;450;436;437;5;233;449;1;0;0;0;0;233;2;231
291700009;300;263;263;7;129;170;1;129;4;0;125;0;0;0
291700010;550;555;555;6;92;549;1;0;0;0;0;92;0;92
291700011;400;401;403;3;35;399;1;0;0;0;0;35;0;35
291700012;350;335;336;4;154;195;1;154;3;0;151;0;0;0
291700013;200;211;211;3;149;50;1;149;9;0;140;0;0;0
291700014;200;200;200;3;64;134;2;64;1;4;59;0;0;0
291700015;100;86;86;6;65;33;2;65;1;0;64;0;0;0
291700016;500;494;494;4;300;499;1;0;0;0;0;300;1;299
291700017;150;150;150;5;103;46;1;103;5;1;97;0;0;0
291700018;50;30;30;8;26;23;1;26;0;0;26;0;0;0
291700019;200;178;178;3;101;97;2;101;1;0;100;0;0;0
291700020;100;68;69;3;41;58;1;41;2;0;39;0;0;0
291800001;100;580;580;7;300;100;0;0;0;0;0;300;2;298
291800002;150;169;170;7;109;39;2;109;1;0;108;0;0;0
291800003;70;57;59;4;45;24;1;45;1;0;44;0;0;0
291800004;100;352;362;7;137;99;1;0;0;0;0;137;1;136
291800005;100;452;426;9;98;99;1;0;0;0;0;98;0;98
291800006;50;49;49;6;27;22;1;27;0;0;27;0;0;0
291800007;100;107;107;9;62;36;2;62;1;1;60;0;0;0
291800008;100;447;447;9;98;99;1;0;0;0;0;98;0;98
291800009;50;66;66;7;26;23;1;26;1;0;25;0;0;0
291800010;100;218;218;7;81;17;2;81;2;0;79;0;0;0
291800011;200;185;186;4;49;150;1;49;2;1;46;0;0;0
291800012;50;54;54;6;39;10;1;39;1;0;38;0;0;0
291800013;100;192;187;7;61;38;1;61;0;0;61;0;0;0
291800014;50;104;104;7;28;21;1;28;1;0;27;0;0;0
291800015;100;49;49;3;51;48;1;51;2;0;49;0;0;0
291900001;400;534;544;8;300;399;1;0;0;0;0;300;4;296
291900002;400;534;534;5;317;399;1;0;0;0;0;317;6;311
291900003;300;394;399;5;231;299;1;0;0;0;0;231;0;231
291900004;400;575;580;8;223;399;1;0;0;0;0;223;1;222
291900005;300;271;272;5;169;130;1;169;5;0;164;0;0;0
291900006;200;137;146;3;95;103;2;95;4;0;91;0;0;0
291900007;200;141;142;7;82;117;1;82;0;0;82;0;0;0
291900008;100;95;95;7;72;27;1;72;2;0;70;0;0;0
291900009;300;235;252;5;153;145;2;153;1;1;151;0;0;0
291900010;500;616;671;6;357;500;0;0;0;0;0;357;0;357
291900011;500;673;746;9;301;499;1;0;0;0;0;301;0;301
291900012;500;611;611;6;240;500;0;0;0;0;0;240;1;239
291900013;400;450;450;5;237;399;1;0;0;0;0;237;0;237
291900014;400;527;527;8;298;400;0;0;0;0;0;298;1;297
291900015;500;813;871;6;422;499;1;0;0;0;0;422;1;421
291900016;100;30;30;4;32;67;1;32;3;0;29;0;0;0
291900017;100;71;71;2;73;25;2;73;0;0;73;0;0;0
291900018;100;55;55;0;54;45;1;54;0;0;54;0;0;0
291900019;100;56;56;1;57;42;1;57;0;0;57;0;0;0
291900020;100;42;42;1;42;57;1;42;0;0;42;0;0;0
291900021;100;58;58;3;61;38;1;61;0;0;61;0;0;0
292800001;600;630;630;9;290;599;1;0;0;0;0;290;3;287
292800002;600;598;598;5;279;599;1;0;0;0;0;279;2;277
292800003;500;544;546;4;275;499;1;0;0;0;0;275;3;272
292800004;600;676;676;9;332;599;1;0;0;0;0;332;5;327
292800005;600;644;644;5;286;599;1;0;0;0;0;286;6;280
292800006;500;529;529;5;214;499;1;0;0;0;0;214;0;214
292800007;500;550;550;5;209;499;1;0;0;0;0;209;5;204
292800008;600;596;596;6;288;599;1;0;0;0;0;288;3;285
292800009;600;618;618;6;295;599;1;0;0;0;0;295;2;293
292800010;500;524;524;5;261;499;1;0;0;0;0;261;1;260
292800011;500;518;518;7;261;416;1;83;3;0;80;178;0;178
292800012;600;687;687;7;352;599;1;0;0;0;0;352;3;349
292800013;600;602;602;8;285;599;1;0;0;0;0;285;3;282
292800014;500;544;545;4;251;499;1;0;0;0;0;251;1;250
292800015;500;468;468;6;211;499;1;0;0;0;0;211;2;209
292800016;600;593;592;1;248;599;1;0;0;0;0;248;1;247
292800017;600;572;572;6;271;599;1;0;0;0;0;271;1;270
292800018;500;520;520;7;188;499;1;0;0;0;0;188;2;186
292800019;600;608;608;6;303;599;1;0;0;0;0;303;1;302
292800020;500;546;547;7;250;499;1;0;0;0;0;250;3;247
292800021;500;499;499;10;59;499;1;0;0;0;0;59;1;58
292800022;500;493;493;6;53;499;1;0;0;0;0;53;0;53
292800023;500;569;569;9;136;499;1;0;0;0;0;136;0;136
292800024;400;388;388;7;149;399;1;0;0;0;0;149;1;148
292800025;500;529;529;4;221;499;1;0;0;0;0;221;5;216
292800026;600;685;685;4;258;599;1;0;0;0;0;258;1;257
292800027;600;673;673;4;159;599;1;0;0;0;0;159;3;156
292800028;200;115;115;3;67;130;3;67;2;0;65;0;0;0
292800029;200;183;183;2;108;91;1;108;11;1;96;0;0;0
292800030;200;115;115;8;65;132;3;65;2;1;62;0;0;0
292800031;200;177;177;3;111;88;1;111;1;1;109;0;0;0
292800032;200;107;107;4;63;136;1;63;1;1;61;0;0;0
292800033;500;485;486;1;222;499;1;0;0;0;0;222;4;218
292800034;300;225;225;2;97;202;1;97;2;0;95;0;0;0
292800035;400;309;310;2;137;262;1;137;6;1;130;0;0;0
292800036;400;439;439;1;150;399;1;0;0;0;0;150;1;149
292800037;200;121;121;6;51;148;1;51;2;0;49;0;0;0
292800038;100;39;39;7;28;72;0;28;1;0;27;0;0;0
292800039;100;87;87;3;48;51;1;48;2;0;46;0;0;0
292800040;300;208;208;7;82;217;1;82;5;0;77;0;0;0
292800041;200;178;179;6;91;108;1;91;1;0;90;0;0;0
292800042;609;609;609;5;224;608;1;0;0;0;0;224;4;220
292800043;200;117;117;3;43;156;1;43;2;0;41;0;0;0
292900001;600;697;699;3;234;599;1;0;0;0;0;234;0;234
292900002;800;889;889;3;326;799;1;0;0;0;0;326;1;325
292900003;400;443;445;3;155;399;1;0;0;0;0;155;0;155
292900004;600;605;606;7;280;599;1;0;0;0;0;280;6;274
292900005;800;849;851;4;275;799;1;0;0;0;0;275;2;273
292900006;800;871;871;1;198;799;1;0;0;0;0;198;1;197
292900007;600;614;616;5;223;599;1;0;0;0;0;223;6;217
292900008;500;522;522;7;231;499;1;0;0;0;0;231;1;230
292900009;300;332;332;1;150;299;1;0;0;0;0;150;1;149
292900010;200;168;168;4;93;106;1;93;9;2;82;0;0;0
292900011;100;84;84;7;57;42;1;57;0;0;57;0;0;0
292900012;300;254;254;5;183;116;1;183;6;0;177;0;0;0
292900013;200;132;208;3;135;64;1;135;3;0;132;0;0;0
292900014;200;177;177;3;103;95;2;103;1;0;102;0;0;0
292900015;100;64;64;7;50;49;1;50;3;2;45;0;0;0
292900016;200;185;185;7;98;101;1;98;7;0;91;0;0;0
293000001;500;769;785;5;261;499;1;0;0;0;0;261;2;259
293000002;400;358;358;5;146;400;0;0;0;0;0;146;0;146
293000003;500;486;486;11;127;500;0;0;0;0;0;127;0;127
293000004;300;357;357;9;98;300;0;0;0;0;0;98;0;98
293000005;200;206;208;5;75;123;2;75;0;1;74;0;0;0
293000006;400;463;475;5;160;400;0;0;0;0;0;160;0;160
293000007;300;342;353;7;70;299;1;0;0;0;0;70;0;70
293000008;400;427;429;5;117;400;0;0;0;0;0;117;0;117
293000009;500;509;513;9;206;499;1;0;0;0;0;206;0;206
293000010;200;288;288;5;75;199;1;0;0;0;0;75;0;75
293000011;500;704;736;8;174;500;0;0;0;0;0;174;0;174
293000012;500;793;799;6;312;500;0;0;0;0;0;312;1;311
293000013;400;505;505;12;156;399;1;0;0;0;0;156;1;155
293000014;100;89;93;6;56;43;1;56;0;0;56;0;0;0
293000015;300;246;260;9;92;207;1;92;0;1;91;0;0;0
293000016;500;842;864;9;251;499;1;0;0;0;0;251;1;250
293000017;500;441;465;8;142;499;1;0;0;0;0;142;2;140
293000018;500;823;856;11;239;499;1;0;0;0;0;239;4;235
293000019;400;502;523;11;189;399;1;0;0;0;0;189;1;188
293000020;500;778;806;12;256;500;0;0;0;0;0;256;2;254
293000021;200;252;252;6;78;116;6;78;4;1;73;0;0;0
293000022;500;592;617;23;183;500;0;0;0;0;0;183;0;183
293000023;300;391;406;9;134;300;0;0;0;0;0;134;0;134
293000024;300;324;341;6;87;300;0;0;0;0;0;87;0;87
293000025;200;169;169;3;77;120;3;77;3;0;74;0;0;0
293000026;300;312;313;4;155;144;1;155;4;0;151;0;0;0
293000027;200;69;69;3;72;128;0;72;0;0;72;0;0;0
293000028;200;110;110;3;110;88;2;110;1;1;108;0;0;0
293000029;200;80;80;3;82;118;0;82;1;0;81;0;0;0
293000030;200;89;89;3;86;114;0;86;0;0;86;0;0;0
293200001;500;559;560;5;252;499;1;0;0;0;0;252;1;251
293200002;600;627;628;1;223;599;1;0;0;0;0;223;0;223
293200003;800;841;843;5;278;799;1;0;0;0;0;278;7;271
293200004;600;582;582;0;256;599;1;0;0;0;0;256;1;255
293200005;600;626;628;0;297;599;1;0;0;0;0;297;5;292
293200006;600;596;597;2;256;599;1;0;0;0;0;256;1;255
293200007;800;855;857;6;373;800;0;0;0;0;0;373;3;370
293200009;100;109;110;4;66;34;0;66;3;0;63;0;0;0
293200010;100;75;75;5;43;56;1;43;1;0;42;0;0;0
293200011;100;26;83;7;33;66;1;33;3;0;30;0;0;0
293200012;100;40;40;8;26;73;1;26;0;0;26;0;0;0
293200013;200;205;205;5;102;97;1;102;5;0;97;0;0;0
293200014;300;281;281;7;128;171;1;128;6;1;121;0;0;0
293200015;400;448;450;3;167;399;1;0;0;0;0;167;0;167
293200016;300;379;379;3;155;299;1;0;0;0;0;155;5;150
293200017;500;504;505;3;168;500;0;0;0;0;0;168;1;167
293200018;100;84;84;6;57;42;1;57;4;0;53;0;0;0
293200019;300;366;367;5;141;299;1;0;0;0;0;141;0;141
293200020;300;282;282;2;175;124;1;175;14;1;160;0;0;0
293200021;300;401;405;1;165;299;1;0;0;0;0;165;2;163
293200022;300;387;388;4;168;299;1;0;0;0;0;168;1;167
293200023;300;395;395;4;170;300;0;0;0;0;0;170;3;167
293200024;100;22;22;6;13;86;1;13;0;1;12;0;0;0
293200025;100;12;12;0;12;88;0;12;0;0;12;0;0;0
293300001;700;733;733;7;282;699;1;0;0;0;0;282;1;281
293300002;800;817;817;4;323;800;0;0;0;0;0;323;6;317
293300003;750;767;767;7;370;749;1;0;0;0;0;370;4;366
293300004;800;814;814;6;338;799;1;0;0;0;0;338;5;333
293300005;750;777;778;0;210;749;1;0;0;0;0;210;1;209
293300006;900;925;908;5;127;899;1;0;0;0;0;127;0;127
293300007;700;711;711;0;110;699;1;0;0;0;0;110;0;110
293300008;600;617;612;6;135;599;1;0;0;0;0;135;1;134
293300009;800;836;837;7;335;800;0;0;0;0;0;335;7;328
293300010;850;893;893;6;395;849;1;0;0;0;0;395;7;388
293300011;750;804;806;2;333;749;1;0;0;0;0;333;1;332
293300012;750;780;781;3;333;749;1;0;0;0;0;333;2;331
293300013;750;778;772;4;349;749;1;0;0;0;0;349;1;348
293300014;550;590;590;2;281;549;1;0;0;0;0;281;0;281
293300015;900;817;817;7;358;899;1;0;0;0;0;358;3;355
293300016;550;584;582;7;234;549;1;0;0;0;0;234;3;231
293300017;750;770;772;3;351;749;1;0;0;0;0;351;1;350
293300018;650;672;670;11;258;649;1;0;0;0;0;258;1;257
293300019;800;852;853;6;328;799;1;0;0;0;0;328;3;325
293300020;800;856;858;0;299;799;1;0;0;0;0;299;4;295
293300021;700;770;757;9;169;699;1;0;0;0;0;169;1;168
293300022;300;347;347;8;154;299;1;0;0;0;0;154;5;149
293300023;600;636;636;6;344;599;1;0;0;0;0;344;3;341
293300024;30;19;19;7;12;17;1;12;0;0;12;0;0;0
293300025;313;313;313;3;53;312;1;0;0;0;0;53;1;52
293300026;100;84;84;6;44;54;2;44;6;0;38;0;0;0
293300027;300;318;318;3;142;299;1;0;0;0;0;142;2;140
293300028;300;281;281;5;108;190;2;108;9;1;98;0;0;0
293300029;270;254;255;5;120;149;1;120;2;3;115;0;0;0
293300030;30;15;15;6;16;13;1;16;1;0;15;0;0;0
293300031;250;240;240;4;110;138;2;110;7;2;101;0;0;0
293300032;200;177;177;6;94;105;1;94;6;0;88;0;0;0
293300033;100;63;63;6;51;48;1;51;3;0;48;0;0;0
293300034;250;250;248;6;66;182;2;66;2;0;64;0;0;0
293300035;100;93;93;5;60;39;1;60;1;0;59;0;0;0
293300036;200;168;168;4;98;99;3;98;3;0;95;0;0;0
293300037;100;74;74;4;48;51;1;48;3;0;45;0;0;0
293300038;170;157;157;1;75;94;1;75;1;1;73;0;0;0
293300039;240;236;236;7;94;145;1;94;1;0;93;0;0;0
293300040;110;89;89;9;51;58;1;51;1;0;50;0;0;0
293300041;600;582;584;7;196;600;0;0;0;0;0;196;1;195
293300042;140;126;126;4;78;61;1;78;3;0;75;0;0;0
293300043;150;131;131;5;85;64;1;85;2;1;82;0;0;0
293300044;110;69;69;5;48;61;1;48;2;0;46;0;0;0
293300045;750;766;766;10;206;750;0;0;0;0;0;206;0;206
293400001;800;836;836;9;274;799;1;0;0;0;0;274;2;272
293400002;900;899;902;8;292;899;1;0;0;0;0;292;2;290
293400003;900;889;892;8;318;899;1;0;0;0;0;318;9;309
293400004;900;933;933;5;273;899;1;0;0;0;0;273;1;272
293400005;900;921;923;4;328;899;1;0;0;0;0;328;1;327
293400006;800;937;940;8;349;799;1;0;0;0;0;349;6;343
293400007;800;841;841;7;355;799;1;0;0;0;0;355;4;351
293400008;700;735;736;5;332;699;1;0;0;0;0;332;11;321
293400009;900;968;968;7;460;899;1;0;0;0;0;460;3;457
293400010;800;824;826;8;305;799;1;0;0;0;0;305;10;295
293400011;700;670;672;5;309;699;1;0;0;0;0;309;3;306
293400012;800;789;791;8;362;799;1;0;0;0;0;362;9;353
293400013;500;527;527;9;228;499;1;0;0;0;0;228;2;226
293400014;600;582;584;7;282;599;1;0;0;0;0;282;4;278
293400015;500;470;472;8;226;499;1;0;0;0;0;226;1;225
293400016;500;549;551;4;228;499;1;0;0;0;0;228;4;224
293400017;500;477;477;5;212;499;1;0;0;0;0;212;5;207
293400018;500;470;472;6;197;499;1;0;0;0;0;197;3;194
293400019;500;552;552;6;232;499;1;0;0;0;0;232;1;231
293400020;900;887;889;7;415;899;1;0;0;0;0;415;8;407
293400021;400;350;352;5;142;399;1;0;0;0;0;142;1;141
293400022;500;510;511;7;286;499;1;0;0;0;0;286;2;284
293400023;400;363;363;4;162;399;1;0;0;0;0;162;2;160
293400024;500;469;471;6;231;499;1;0;0;0;0;231;0;231
293400025;600;628;631;4;286;599;1;0;0;0;0;286;2;284
293400026;800;807;810;6;320;799;1;0;0;0;0;320;4;316
293400027;600;615;618;5;282;599;1;0;0;0;0;282;3;279
293400028;700;726;729;8;337;699;1;0;0;0;0;337;4;333
293400029;500;474;474;6;225;500;0;0;0;0;0;225;2;223
293400030;300;320;320;7;147;300;0;0;0;0;0;147;1;146
293400031;700;691;691;7;273;699;1;0;0;0;0;273;2;271
293400032;600;565;567;5;265;599;1;0;0;0;0;265;3;262
293400033;400;379;379;7;156;399;1;0;0;0;0;156;0;156
293400034;500;492;492;8;238;499;1;0;0;0;0;238;3;235
293400035;500;460;460;5;206;499;1;0;0;0;0;206;2;204
293400036;500;179;454;6;185;499;1;0;0;0;0;185;4;181
293400037;400;404;406;6;209;399;1;0;0;0;0;209;4;205
293400038;600;621;621;8;260;599;1;0;0;0;0;260;1;259
293400039;400;415;415;4;179;399;1;0;0;0;0;179;0;179
293400040;500;459;460;4;156;499;1;0;0;0;0;156;1;155
293400041;500;503;503;5;161;499;1;0;0;0;0;161;1;160
293400042;500;546;548;7;198;499;1;0;0;0;0;198;2;196
293400043;600;653;653;5;206;599;1;0;0;0;0;206;0;206
293400044;400;360;362;8;101;399;1;0;0;0;0;101;0;101
293400045;800;785;786;4;204;800;0;0;0;0;0;204;2;202
293400046;600;566;566;4;141;599;1;0;0;0;0;141;1;140
293400047;700;675;676;7;188;700;0;0;0;0;0;188;0;188
293400048;500;526;527;8;172;500;0;0;0;0;0;172;3;169
293400049;600;179;598;3;182;600;0;0;0;0;0;182;3;179
293400050;600;584;586;6;230;600;0;0;0;0;0;230;4;226
293400051;800;836;836;6;381;799;1;0;0;0;0;381;2;379
293400052;800;819;820;8;360;800;0;0;0;0;0;360;3;357
293400053;800;795;797;6;304;800;0;0;0;0;0;304;3;301
293400054;600;637;639;4;228;599;1;0;0;0;0;228;6;222
293400055;900;921;923;6;219;899;1;0;0;0;0;219;3;216
293400056;600;629;631;3;232;600;0;0;0;0;0;232;4;228
293400057;700;710;713;4;212;699;1;0;0;0;0;212;2;210
293400058;600;612;605;7;196;599;1;0;0;0;0;196;1;195
293400059;600;629;631;7;190;600;0;0;0;0;0;190;0;190
293400060;900;885;888;9;192;899;1;0;0;0;0;192;0;192
293400061;900;936;937;10;282;899;1;0;0;0;0;282;2;280
293400062;900;892;894;8;267;899;1;0;0;0;0;267;0;267
293400063;600;635;636;8;159;599;1;0;0;0;0;159;3;156
293400064;900;1043;1047;9;218;899;1;0;0;0;0;218;0;218
293400065;900;964;965;10;207;899;1;0;0;0;0;207;0;207
293400066;500;481;481;6;208;499;1;0;0;0;0;208;0;208
293400067;600;561;562;5;176;599;1;0;0;0;0;176;1;175
293400068;900;880;880;4;249;899;1;0;0;0;0;249;2;247
293400069;700;706;710;8;320;699;1;0;0;0;0;320;7;313
293400070;700;799;799;9;334;699;1;0;0;0;0;334;4;330
293400071;600;640;640;7;289;599;1;0;0;0;0;289;6;283
293400072;600;609;615;9;300;599;1;0;0;0;0;300;4;296
293400073;600;561;562;8;263;599;1;0;0;0;0;263;5;258
293400074;600;636;637;8;293;599;1;0;0;0;0;293;5;288
293400075;600;652;655;8;283;599;1;0;0;0;0;283;0;283
293400076;600;653;653;5;306;599;1;0;0;0;0;306;1;305
293400077;600;192;631;6;198;599;1;0;0;0;0;198;2;196
293400078;600;581;573;8;276;599;1;0;0;0;0;276;5;271
293400079;700;683;684;26;366;700;0;0;0;0;0;366;3;363
293400080;800;820;821;4;330;799;1;0;0;0;0;330;5;325
293400081;700;731;731;9;267;699;1;0;0;0;0;267;1;266
293400082;700;725;725;5;255;700;0;0;0;0;0;255;2;253
293400083;600;612;614;7;223;599;1;0;0;0;0;223;1;222
293400084;600;647;648;9;227;599;1;0;0;0;0;227;1;226
293400085;600;152;624;7;159;599;1;0;0;0;0;159;1;158
293400086;900;894;896;14;155;900;0;0;0;0;0;155;0;155
293400087;800;836;836;4;151;800;0;0;0;0;0;151;0;151
293400088;912;912;912;6;222;912;0;0;0;0;0;222;0;222
293400089;700;720;720;8;144;700;0;0;0;0;0;144;2;142
293400090;700;728;728;10;154;699;1;0;0;0;0;154;2;152
293400091;700;743;745;7;181;699;1;0;0;0;0;181;0;181
293400092;400;343;345;4;169;400;0;0;0;0;0;169;2;167
293400093;400;416;417;8;201;399;1;0;0;0;0;201;1;200
293400094;500;503;503;10;252;499;1;0;0;0;0;252;3;249
293400095;400;395;395;5;219;400;0;0;0;0;0;219;2;217
293400096;500;456;458;7;245;500;0;0;0;0;0;245;4;241
293400097;500;443;444;5;207;500;0;0;0;0;0;207;2;205
293400098;700;672;673;8;294;699;1;0;0;0;0;294;5;289
293400099;600;587;588;6;288;599;1;0;0;0;0;288;4;284
293400100;500;442;442;5;195;499;1;0;0;0;0;195;1;194
293400101;800;850;851;5;386;800;0;0;0;0;0;386;3;383
293400102;800;803;803;6;337;799;1;0;0;0;0;337;5;332
293400103;800;780;783;9;276;799;1;0;0;0;0;276;6;270
293400104;900;941;943;7;327;899;1;0;0;0;0;327;3;324
293400105;900;883;884;3;266;900;0;0;0;0;0;266;3;263
293400106;900;907;909;7;311;900;0;0;0;0;0;311;1;310
293400107;900;958;958;5;327;900;0;0;0;0;0;327;0;327
293400108;400;433;434;6;209;399;1;0;0;0;0;209;1;208
293400109;400;367;367;5;149;399;1;0;0;0;0;149;3;146
293400110;400;364;364;3;136;399;1;0;0;0;0;136;1;135
293400111;300;277;283;31;158;141;1;158;18;2;138;0;0;0
293400112;200;110;188;7;117;82;1;117;4;1;112;0;0;0
293400113;600;552;552;6;205;600;0;0;0;0;0;205;1;204
293400114;500;444;446;5;288;500;0;0;0;0;0;288;5;283
293400115;600;579;579;3;309;600;0;0;0;0;0;309;1;308
293400116;500;209;495;6;209;499;1;0;0;0;0;209;2;207
293400117;800;719;725;6;245;799;1;0;0;0;0;245;2;243
293400118;200;189;189;3;116;83;1;116;3;1;112;0;0;0
293400119;700;686;687;5;169;699;1;0;0;0;0;169;0;169
293400120;600;589;589;2;194;599;1;0;0;0;0;194;0;194
293400121;200;202;202;3;151;48;1;151;9;1;141;0;0;0
293400122;700;686;686;6;206;700;0;0;0;0;0;206;1;205
293400123;400;358;360;5;130;399;1;0;0;0;0;130;2;128
293400124;400;397;398;6;91;399;1;0;0;0;0;91;1;90
293400125;200;128;129;5;87;112;1;87;1;0;86;0;0;0
293400126;600;580;582;6;155;599;1;0;0;0;0;155;3;152
293400127;200;158;158;4;91;98;11;91;7;0;84;0;0;0
293400128;100;52;52;5;32;67;1;32;0;0;32;0;0;0
293400129;800;742;742;7;198;799;1;0;0;0;0;198;0;198
293400130;400;362;364;4;122;399;1;0;0;0;0;122;0;122
293400131;500;456;456;3;128;500;0;0;0;0;0;128;0;128
293400132;500;507;507;5;163;500;0;0;0;0;0;163;0;163
293400133;500;427;429;6;157;499;1;0;0;0;0;157;2;155
293400134;300;222;222;3;146;151;3;146;4;0;142;0;0;0
293400135;306;306;306;1;117;188;1;117;0;0;117;0;0;0
293400136;200;195;195;0;86;113;1;86;7;1;78;0;0;0
293400137;300;260;260;4;90;209;1;90;3;1;86;0;0;0
293400138;600;510;510;5;179;599;1;0;0;0;0;179;1;178
293400139;700;629;630;6;181;699;1;0;0;0;0;181;2;179
293400140;700;651;652;6;147;699;1;0;0;0;0;147;1;146
293400141;500;219;439;4;223;500;0;0;0;0;0;223;0;223
293400142;400;361;362;2;150;400;0;0;0;0;0;150;0;150
293400143;700;610;610;8;204;699;1;0;0;0;0;204;1;203
293400144;700;630;631;8;281;699;1;0;0;0;0;281;1;280
293400145;600;632;632;5;179;599;1;0;0;0;0;179;0;179
293400146;600;576;580;11;169;599;1;0;0;0;0;169;5;164
293400147;600;593;593;6;337;599;1;0;0;0;0;337;0;337
293400148;800;725;726;6;382;799;1;0;0;0;0;382;0;382
293400149;500;447;447;5;225;499;1;0;0;0;0;225;0;225
293400150;100;32;32;4;32;68;0;32;0;0;32;0;0;0
293400151;100;28;28;5;32;67;1;32;0;0;32;0;0;0
293400152;100;24;24;6;13;86;1;13;0;0;13;0;0;0
293400153;200;119;119;31;40;158;2;40;0;0;40;0;0;0
293400154;100;32;32;3;27;72;1;27;2;0;25;0;0;0
300700001;900;900;955;5;348;899;1;0;0;0;0;348;0;348
300700002;700;685;692;8;171;699;1;0;0;0;0;171;1;170
300700003;500;505;503;2;129;499;1;0;0;0;0;129;3;126
300700004;1200;1213;1241;3;428;1199;1;0;0;0;0;428;4;424
300700005;600;566;583;4;208;599;1;0;0;0;0;208;2;206
300700006;300;233;233;5;96;203;1;96;1;0;95;0;0;0
300700007;500;459;460;3;158;499;1;0;0;0;0;158;0;158
300700008;1100;1186;1186;7;275;1099;1;0;0;0;0;275;2;273
300700009;900;822;840;2;291;900;0;0;0;0;0;291;0;291
300700010;600;595;595;6;268;599;1;0;0;0;0;268;1;267
300700011;100;107;107;4;55;44;1;55;0;0;55;0;0;0
300700012;700;710;710;2;297;699;1;0;0;0;0;297;1;296
300700013;800;727;733;2;298;799;1;0;0;0;0;298;5;293
300700014;900;914;914;4;317;899;1;0;0;0;0;317;2;315
300700015;900;809;823;3;328;899;1;0;0;0;0;328;4;324
300700016;100;82;82;0;80;19;1;80;1;0;79;0;0;0
300700017;100;90;90;0;86;14;0;86;5;0;81;0;0;0
301000001;400;437;437;6;133;400;0;0;0;0;0;133;0;133
301000002;600;555;586;6;213;599;1;0;0;0;0;213;0;213
301000003;700;707;751;6;276;699;1;0;0;0;0;276;0;276
301000004;800;804;831;7;267;798;2;0;0;0;0;267;1;266
301000005;1100;1162;1162;5;279;1098;2;0;0;0;0;279;1;278
301000006;1100;1212;1212;8;333;1099;1;0;0;0;0;333;0;333
301000007;400;403;415;2;162;400;0;0;0;0;0;162;1;161
301000008;300;266;266;6;138;161;1;138;4;0;134;0;0;0
301000009;300;338;354;3;90;299;1;0;0;0;0;90;0;90
301000010;100;90;90;6;53;46;1;53;2;0;51;0;0;0
301000011;400;420;448;2;124;399;1;0;0;0;0;124;0;124
301000012;400;416;427;3;201;399;1;0;0;0;0;201;2;199
301000013;500;512;548;4;196;499;1;0;0;0;0;196;0;196
301000014;500;511;511;5;136;499;1;0;0;0;0;136;0;136
301000015;500;456;472;3;226;499;1;0;0;0;0;226;3;223
301000016;800;773;788;7;264;799;1;0;0;0;0;264;0;264
301000017;300;342;353;4;142;299;1;0;0;0;0;142;2;140
301000018;800;800;884;8;271;799;1;0;0;0;0;271;0;271
301000019;600;638;638;6;224;599;1;0;0;0;0;224;1;223
301000020;200;129;129;4;124;75;1;124;5;0;119;0;0;0
301000021;200;120;120;6;121;77;2;121;0;0;121;0;0;0
301000022;200;148;148;8;152;47;1;152;2;1;149;0;0;0
301000023;200;151;151;6;155;44;1;155;0;1;154;0;0;0
301100001;400;403;403;4;101;399;1;0;0;0;0;101;1;100
301100002;400;273;273;6;111;288;1;111;2;1;108;0;0;0
301100003;600;558;558;8;113;599;1;0;0;0;0;113;0;113
301100004;400;398;402;3;127;399;1;0;0;0;0;127;3;124
301100005;1000;1035;1044;3;299;999;1;0;0;0;0;299;7;292
301100006;400;361;361;4;115;399;1;0;0;0;0;115;0;115
301100007;300;342;342;6;69;299;1;0;0;0;0;69;0;69
301100008;400;392;392;5;86;399;1;0;0;0;0;86;1;85
301100009;800;782;782;2;155;800;0;0;0;0;0;155;4;151
301100010;600;518;518;6;101;600;0;0;0;0;0;101;0;101
301100011;300;338;339;6;109;299;1;0;0;0;0;109;0;109
301100012;300;217;217;6;94;205;1;94;5;1;88;0;0;0
301100013;400;423;449;3;188;399;1;0;0;0;0;188;3;185
301100014;1400;1442;1455;6;356;1399;1;0;0;0;0;356;3;353
301100015;400;363;363;4;94;399;1;0;0;0;0;94;0;94
301100016;300;289;289;3;73;226;1;73;5;0;68;0;0;0
301100018;600;650;680;3;170;599;1;0;0;0;0;170;0;170
301100019;400;442;455;4;125;400;0;0;0;0;0;125;0;125
301100020;800;136;775;8;136;799;1;0;0;0;0;136;1;135
301100021;400;412;412;4;87;399;1;0;0;0;0;87;0;87
301100022;200;95;95;0;90;109;1;90;1;0;89;0;0;0
301800001;740;707;716;4;255;739;1;0;0;0;0;255;0;255
301800002;1040;1000;1022;2;317;1040;0;0;0;0;0;317;1;316
301800003;760;764;764;9;285;760;0;0;0;0;0;285;1;284
301800004;530;524;524;1;183;530;0;0;0;0;0;183;2;181
301800005;481;469;469;4;171;480;1;0;0;0;0;171;1;170
301800006;1050;1024;1024;2;467;1050;0;0;0;0;0;467;0;467
301800007;850;823;830;2;215;849;1;0;0;0;0;215;2;213
301800008;670;652;652;4;209;670;0;0;0;0;0;209;1;208
301800009;920;882;886;1;286;919;1;0;0;0;0;286;0;286
301800010;1020;966;993;5;260;1019;1;0;0;0;0;260;2;258
301800011;1020;968;997;7;251;1019;1;0;0;0;0;251;3;248
301800012;30;23;23;6;24;5;1;24;0;0;24;0;0;0
301800013;720;689;705;8;209;719;1;0;0;0;0;209;1;208
301800014;970;739;739;4;256;970;0;0;0;0;0;256;4;252
301800015;20;18;18;4;19;0;1;19;1;0;18;0;0;0
301800016;880;842;846;5;263;879;1;0;0;0;0;263;2;261
301800017;810;775;777;4;222;809;1;0;0;0;0;222;0;222
301800018;590;566;581;3;228;589;1;0;0;0;0;228;1;227
301800019;880;845;848;1;315;880;0;0;0;0;0;315;0;315
301800020;1000;980;982;6;222;999;1;0;0;0;0;222;1;221
301800021;1000;960;961;5;216;1000;0;0;0;0;0;216;0;216
301800022;990;918;918;3;285;990;0;0;0;0;0;285;2;283
301800023;1000;918;927;7;404;999;1;0;0;0;0;404;1;403
301800024;240;230;230;0;227;13;0;227;0;0;227;0;0;0
301900001;400;410;417;0;157;399;1;0;0;0;0;157;1;156
301900002;500;498;498;2;219;499;1;0;0;0;0;219;3;216
301900003;700;733;738;2;237;699;1;0;0;0;0;237;2;235
301900004;700;757;764;4;313;699;1;0;0;0;0;313;2;311
301900005;600;574;577;4;93;599;1;0;0;0;0;93;1;92
301900006;700;678;678;3;188;699;1;0;0;0;0;188;0;188
301900007;200;201;201;1;57;141;2;57;1;1;55;0;0;0
301900008;200;240;240;3;100;99;1;100;1;0;99;0;0;0
301900009;400;384;385;6;139;399;1;0;0;0;0;139;3;136
301900010;400;369;369;4;148;399;1;0;0;0;0;148;1;147
301900011;500;531;531;3;131;499;1;0;0;0;0;131;3;128
301900012;300;317;319;1;110;299;1;0;0;0;0;110;0;110
301900013;300;260;260;6;144;155;1;144;2;3;139;0;0;0
301900014;400;437;437;4;152;399;1;0;0;0;0;152;1;151
301900015;200;159;159;4;56;143;1;56;3;0;53;0;0;0
301900016;200;239;239;8;109;90;1;109;8;2;99;0;0;0
301900017;100;27;27;3;30;69;1;30;0;0;30;0;0;0
302100001;100;50;52;6;38;60;2;38;1;0;37;0;0;0
302100002;900;982;982;3;383;900;0;0;0;0;0;383;1;382
302100003;800;859;872;6;439;800;0;0;0;0;0;439;2;437
302100004;500;197;480;2;198;500;0;0;0;0;0;198;0;198
302100005;100;100;102;2;71;28;1;71;5;0;66;0;0;0
302100006;500;486;493;3;219;499;1;0;0;0;0;219;0;219
302100007;700;768;778;2;327;699;1;0;0;0;0;327;5;322
302100008;700;720;722;1;230;700;0;0;0;0;0;230;0;230
302100009;500;510;509;1;151;500;0;0;0;0;0;151;1;150
302100010;500;474;474;4;181;499;1;0;0;0;0;181;1;180
302100011;400;310;315;2;150;399;1;0;0;0;0;150;1;149
302100012;400;403;407;4;177;400;0;0;0;0;0;177;1;176
302100013;700;657;671;5;275;700;0;0;0;0;0;275;1;274
302100014;100;83;83;4;86;14;0;86;1;0;85;0;0;0
302200001;820;810;811;7;216;819;1;0;0;0;0;216;1;215
302200002;1050;1032;1035;10;301;1049;1;0;0;0;0;301;1;300
302200003;950;940;940;6;203;949;1;0;0;0;0;203;1;202
302200004;540;525;526;1;186;539;1;0;0;0;0;186;1;185
302200005;700;688;688;6;199;699;1;0;0;0;0;199;1;198
302200006;630;611;612;2;216;629;1;0;0;0;0;216;1;215
302200007;540;528;528;6;227;539;1;0;0;0;0;227;0;227
302200008;670;656;656;0;224;669;1;0;0;0;0;224;2;222
302200009;520;514;514;6;148;519;1;0;0;0;0;148;2;146
302200010;590;576;577;6;162;590;0;0;0;0;0;162;0;162
302200011;760;749;751;9;254;759;1;0;0;0;0;254;1;253
302200012;520;498;498;8;173;519;1;0;0;0;0;173;2;171
302200013;550;533;533;2;222;549;1;0;0;0;0;222;4;218
302200014;630;611;611;7;175;629;1;0;0;0;0;175;0;175
302200015;640;624;625;3;266;639;1;0;0;0;0;266;4;262
302200016;470;446;446;4;167;469;1;0;0;0;0;167;3;164
302200017;640;627;630;9;227;639;1;0;0;0;0;227;5;222
302200018;610;602;602;8;225;609;1;0;0;0;0;225;2;223
302200019;50;41;30;3;35;13;2;35;9;0;26;0;0;0
302200020;1030;1015;1016;4;315;1029;1;0;0;0;0;315;2;313
302200022;520;504;504;4;136;519;1;0;0;0;0;136;0;136
302200023;320;315;315;7;111;319;1;0;0;0;0;111;2;109
302200024;160;146;146;3;59;100;1;59;3;0;56;0;0;0
302200025;170;158;159;5;95;74;1;95;4;0;91;0;0;0
302200026;410;401;401;5;105;409;1;0;0;0;0;105;0;105
302200027;310;296;296;7;58;310;0;0;0;0;0;58;0;58
302200028;690;677;677;6;155;690;0;0;0;0;0;155;0;155
302200029;790;771;771;7;158;789;1;0;0;0;0;158;1;157
302200030;40;15;30;5;20;19;1;20;0;0;20;0;0;0
302200031;360;360;360;1;130;359;1;0;0;0;0;130;0;130
302200032;180;171;171;4;71;108;1;71;4;0;67;0;0;0
302200033;110;103;103;7;62;47;1;62;3;1;58;0;0;0
302200034;350;334;334;5;138;349;1;0;0;0;0;138;2;136
302200035;70;66;66;3;44;25;1;44;1;3;40;0;0;0
302300001;700;690;697;6;261;699;1;0;0;0;0;261;3;258
302300002;800;815;818;4;248;799;1;0;0;0;0;248;3;245
302300003;700;718;724;2;289;699;1;0;0;0;0;289;1;288
302300004;600;623;627;5;258;599;1;0;0;0;0;258;8;250
302300005;800;802;805;5;247;799;1;0;0;0;0;247;6;241
302300006;1000;1001;1002;8;190;999;1;0;0;0;0;190;1;189
302300007;500;493;496;9;192;499;1;0;0;0;0;192;2;190
302300008;800;824;827;7;262;799;1;0;0;0;0;262;3;259
302300009;500;504;504;8;150;499;1;0;0;0;0;150;1;149
302300010;800;844;849;7;268;799;1;0;0;0;0;268;3;265
302300011;700;696;696;3;258;699;1;0;0;0;0;258;4;254
302300012;900;965;966;5;147;899;1;0;0;0;0;147;1;146
302300013;300;292;297;4;92;207;1;92;1;0;91;0;0;0
302300014;622;622;623;3;183;621;1;0;0;0;0;183;5;178
302300015;600;625;625;6;192;599;1;0;0;0;0;192;1;191
302300016;300;311;311;4;101;299;1;0;0;0;0;101;1;100
302300017;300;284;284;6;104;195;1;104;2;0;102;0;0;0
302300018;300;232;233;5;151;148;1;151;3;3;145;0;0;0
302300019;100;73;73;4;42;57;1;42;1;0;41;0;0;0
302300020;700;667;667;5;196;699;1;0;0;0;0;196;3;193
302300021;300;248;249;1;146;153;1;146;2;1;143;0;0;0
302300022;100;20;20;8;18;81;1;18;0;0;18;0;0;0
302300023;100;38;38;3;39;60;1;39;3;1;35;0;0;0
302500001;800;850;850;7;267;799;1;0;0;0;0;267;0;267
302500002;700;713;714;10;187;699;1;0;0;0;0;187;2;185
302500003;800;951;953;9;322;799;1;0;0;0;0;322;2;320
302500004;700;713;715;7;283;699;1;0;0;0;0;283;7;276
302500005;100;37;37;6;34;65;1;34;1;2;31;0;0;0
302500006;200;207;207;5;88;111;1;88;10;2;76;0;0;0
302500007;500;511;511;3;134;499;1;0;0;0;0;134;3;131
302500008;100;40;40;7;25;74;1;25;0;0;25;0;0;0
302500009;100;109;109;5;87;12;1;87;2;2;83;0;0;0
302500010;100;113;111;8;61;38;1;61;3;2;56;0;0;0
302500011;600;635;635;2;162;599;1;0;0;0;0;162;1;161
302500012;100;39;39;8;23;76;1;23;1;0;22;0;0;0
302500013;500;587;587;6;221;278;1;221;7;2;212;0;0;0
302500014;100;26;26;2;27;72;1;27;3;1;23;0;0;0
303000001;800;782;783;11;287;799;1;0;0;0;0;287;4;283
303000002;900;829;829;4;232;899;1;0;0;0;0;232;3;229
303000003;800;792;792;10;243;799;1;0;0;0;0;243;3;240
303000004;800;827;829;6;221;799;1;0;0;0;0;221;2;219
303000005;900;942;942;8;245;899;1;0;0;0;0;245;1;244
303000006;800;792;792;7;140;799;1;0;0;0;0;140;2;138
303000007;900;898;898;6;200;899;1;0;0;0;0;200;1;199
303000008;973;973;973;7;226;972;1;0;0;0;0;226;2;224
303000009;1000;929;929;9;138;999;1;0;0;0;0;138;0;138
303000010;800;821;821;9;87;799;1;0;0;0;0;87;2;85
303000011;900;871;871;5;222;899;1;0;0;0;0;222;6;216
303000012;899;873;873;3;231;898;1;0;0;0;0;231;1;230
303000013;800;807;810;9;231;799;1;0;0;0;0;231;3;228
303000014;900;901;901;7;228;899;1;0;0;0;0;228;7;221
303000015;1000;1037;1037;11;220;999;1;0;0;0;0;220;6;214
303000016;800;806;809;7;243;799;1;0;0;0;0;243;3;240
303000017;1000;1031;1033;9;193;999;1;0;0;0;0;193;0;193
303000018;700;693;694;7;297;699;1;0;0;0;0;297;7;290
303000019;700;699;701;6;243;699;1;0;0;0;0;243;3;240
303000020;800;790;790;10;272;799;1;0;0;0;0;272;1;271
303000021;800;765;767;9;308;799;1;0;0;0;0;308;4;304
303000022;800;751;752;4;307;799;1;0;0;0;0;307;4;303
303000023;800;828;831;5;317;799;1;0;0;0;0;317;2;315
303000024;800;815;815;8;331;799;1;0;0;0;0;331;3;328
303000025;700;713;715;0;235;699;1;0;0;0;0;235;5;230
303000026;800;814;814;1;268;799;1;0;0;0;0;268;4;264
303000027;800;760;760;5;231;799;1;0;0;0;0;231;3;228
303000028;800;752;752;7;272;799;1;0;0;0;0;272;2;270
303000029;800;794;796;5;268;799;1;0;0;0;0;268;5;263
303000030;700;667;669;3;231;699;1;0;0;0;0;231;3;228
303000031;1000;1033;1033;3;344;999;1;0;0;0;0;344;7;337
303000032;900;918;922;5;351;899;1;0;0;0;0;351;3;348
303000033;900;934;934;8;358;899;1;0;0;0;0;358;11;347
303000034;900;860;861;8;346;900;0;0;0;0;0;346;4;342
303000035;600;565;565;4;248;599;1;0;0;0;0;248;3;245
303000036;600;552;554;5;186;599;1;0;0;0;0;186;5;181
303000037;1000;1002;954;8;79;999;1;0;0;0;0;79;0;79
303000038;900;901;902;6;225;899;1;0;0;0;0;225;3;222
303000039;900;852;852;9;186;899;1;0;0;0;0;186;2;184
303000040;800;758;759;7;219;799;1;0;0;0;0;219;1;218
303000041;800;834;834;9;222;799;1;0;0;0;0;222;2;220
303000042;900;947;948;9;171;899;1;0;0;0;0;171;0;171
303000043;900;861;861;5;267;899;1;0;0;0;0;267;3;264
303000044;900;874;876;7;319;899;1;0;0;0;0;319;4;315
303000045;800;812;814;8;293;799;1;0;0;0;0;293;2;291
303000046;1000;976;979;8;394;999;1;0;0;0;0;394;5;389
303000047;900;891;896;10;310;899;1;0;0;0;0;310;7;303
303000048;1000;1000;977;5;393;999;1;0;0;0;0;393;6;387
303000049;600;599;601;7;237;599;1;0;0;0;0;237;3;234
303000050;900;892;892;8;368;899;1;0;0;0;0;368;5;363
303000051;800;836;836;6;345;799;1;0;0;0;0;345;5;340
303000052;800;785;788;7;41;799;1;0;0;0;0;41;0;41
303000053;500;514;514;9;152;499;1;0;0;0;0;152;4;148
303000054;900;855;856;8;349;899;1;0;0;0;0;349;2;347
303000055;800;779;780;8;369;799;1;0;0;0;0;369;6;363
303000056;700;733;735;9;321;699;1;0;0;0;0;321;4;317
303000057;900;855;857;6;338;899;1;0;0;0;0;338;4;334
303000058;1000;989;990;9;439;999;1;0;0;0;0;439;13;426
303000059;800;750;750;10;355;800;0;0;0;0;0;355;1;354
303000060;800;779;779;7;337;799;1;0;0;0;0;337;1;336
303000061;800;779;779;7;328;799;1;0;0;0;0;328;2;326
303000062;800;766;766;11;278;799;1;0;0;0;0;278;2;276
303000063;800;757;759;0;329;799;1;0;0;0;0;329;8;321
303000064;800;804;804;7;337;799;1;0;0;0;0;337;5;332
303000065;800;813;814;11;383;799;1;0;0;0;0;383;11;372
303000066;800;393;814;9;402;799;1;0;0;0;0;402;1;401
303000067;800;770;771;9;368;799;1;0;0;0;0;368;1;367
303000068;700;708;709;10;329;699;1;0;0;0;0;329;5;324
303000069;900;875;876;7;381;899;1;0;0;0;0;381;5;376
303000070;700;706;708;8;312;699;1;0;0;0;0;312;3;309
303000071;800;816;818;23;417;799;1;0;0;0;0;417;6;411
303000072;700;696;697;9;265;699;1;0;0;0;0;265;1;264
303000073;800;789;790;8;328;799;1;0;0;0;0;328;0;328
303000074;900;883;885;10;372;899;1;0;0;0;0;372;2;370
303000075;800;816;816;6;360;799;1;0;0;0;0;360;5;355
303000076;900;912;914;10;411;899;1;0;0;0;0;411;7;404
303000077;900;851;851;11;341;899;1;0;0;0;0;341;1;340
303000078;700;723;724;6;328;699;1;0;0;0;0;328;0;328
303000079;752;752;753;10;297;751;1;0;0;0;0;297;6;291
303000080;700;670;670;7;306;699;1;0;0;0;0;306;2;304
303000081;640;640;640;9;293;639;1;0;0;0;0;293;8;285
303000082;700;688;691;9;328;699;1;0;0;0;0;328;6;322
303000083;700;708;710;7;305;699;1;0;0;0;0;305;3;302
303000084;700;678;678;10;293;699;1;0;0;0;0;293;2;291
303000085;800;794;795;8;289;799;1;0;0;0;0;289;5;284
303000086;900;929;931;8;327;899;1;0;0;0;0;327;9;318
303000087;800;758;758;8;350;799;1;0;0;0;0;350;6;344
303000088;900;841;843;7;350;899;1;0;0;0;0;350;2;348
303000089;700;693;695;8;278;699;1;0;0;0;0;278;7;271
303000090;500;501;501;6;212;499;1;0;0;0;0;212;3;209
303000091;800;785;788;7;309;799;1;0;0;0;0;309;2;307
303000092;800;794;796;8;324;799;1;0;0;0;0;324;3;321
303000093;800;792;792;8;332;799;1;0;0;0;0;332;3;329
303000094;700;646;646;6;254;699;1;0;0;0;0;254;6;248
303000095;100;48;48;7;34;65;1;34;4;0;30;0;0;0
303000096;200;104;104;4;65;134;1;65;1;1;63;0;0;0
303000097;200;110;110;8;42;157;1;42;2;1;39;0;0;0
303000098;200;152;152;4;106;93;1;106;2;0;104;0;0;0
303000099;300;199;199;0;114;185;1;114;1;1;112;0;0;0
303000100;300;260;260;4;122;177;1;122;2;1;119;0;0;0
303000101;600;559;559;4;129;599;1;0;0;0;0;129;1;128
303000102;900;827;827;6;209;899;1;0;0;0;0;209;0;209
303000103;800;754;754;2;310;799;1;0;0;0;0;310;4;306
303000104;1000;972;973;4;268;999;1;0;0;0;0;268;1;267
303000105;600;540;540;4;91;599;1;0;0;0;0;91;0;91
303000106;600;635;635;6;193;599;1;0;0;0;0;193;1;192
303000107;400;331;334;5;130;269;1;130;7;1;122;0;0;0
303000108;200;110;111;3;48;151;1;48;1;1;46;0;0;0
303000109;400;349;349;7;154;399;1;0;0;0;0;154;2;152
303000110;100;24;24;7;23;76;1;23;0;0;23;0;0;0
303000111;300;202;203;4;128;171;1;128;2;0;126;0;0;0
303000112;400;399;399;4;146;399;1;0;0;0;0;146;0;146
303000113;500;460;460;5;149;499;1;0;0;0;0;149;2;147
303000114;400;376;381;1;143;399;1;0;0;0;0;143;5;138
303000115;500;528;530;4;152;500;0;0;0;0;0;152;0;152
303000116;100;89;89;4;63;36;1;63;3;0;60;0;0;0
303000117;300;227;228;7;132;166;2;132;3;2;127;0;0;0
303000118;300;207;207;4;117;179;4;117;2;2;113;0;0;0
303000119;600;576;576;4;145;599;1;0;0;0;0;145;1;144
303000120;500;461;462;3;149;499;1;0;0;0;0;149;1;148
303000121;400;385;385;5;129;400;0;0;0;0;0;129;2;127
303000122;600;544;548;3;219;599;1;0;0;0;0;219;2;217
303000123;600;571;575;5;185;599;1;0;0;0;0;185;0;185
303000124;500;117;495;7;124;499;1;0;0;0;0;124;0;124
303000125;100;37;37;31;51;47;2;51;1;1;49;0;0;0
303000126;100;30;30;13;36;63;1;36;5;0;31;0;0;0
303000127;100;18;18;0;18;79;3;18;1;1;16;0;0;0
303000128;100;20;20;4;22;77;1;22;0;0;22;0;0;0
303000129;100;23;23;6;29;70;1;29;0;0;29;0;0;0
310300001;300;298;302;3;177;121;2;177;4;2;171;0;0;0
310300002;500;639;645;5;360;499;1;0;0;0;0;360;2;358
310300003;100;71;74;4;56;43;1;56;2;0;54;0;0;0
310300004;100;19;20;6;18;81;1;18;0;0;18;0;0;0
310300005;100;44;45;7;44;55;1;44;0;0;44;0;0;0
310300006;200;161;161;3;109;90;1;109;7;5;97;0;0;0
310300007;300;366;373;3;214;299;1;0;0;0;0;214;3;211
310300008;100;39;39;0;30;69;1;30;3;0;27;0;0;0
310300009;100;41;41;3;36;63;1;36;2;1;33;0;0;0
310300010;100;33;33;3;28;71;1;28;3;0;25;0;0;0
310300011;100;15;17;6;15;84;1;15;0;0;15;0;0;0
310300012;200;193;202;4;95;104;1;95;7;0;88;0;0;0
310300013;100;23;24;5;19;80;1;19;0;0;19;0;0;0
310300014;300;266;276;2;152;147;1;152;8;0;144;0;0;0
310300015;100;85;79;6;55;44;1;55;1;0;54;0;0;0
310300016;100;100;103;3;66;33;1;66;1;1;64;0;0;0
310300017;100;67;67;3;43;55;2;43;1;0;42;0;0;0
310300018;100;20;20;2;21;78;1;21;0;0;21;0;0;0
310300019;300;252;252;1;140;159;1;140;8;0;132;0;0;0
310300020;100;26;26;3;19;80;1;19;0;0;19;0;0;0
310300021;100;50;50;0;46;53;1;46;4;0;42;0;0;0
310700001;700;663;663;0;275;699;1;0;0;0;0;275;1;274
310700002;700;692;692;10;297;663;1;36;1;1;34;261;1;260
310700003;700;699;699;6;288;699;1;0;0;0;0;288;1;287
310700004;900;883;886;2;344;899;1;0;0;0;0;344;4;340
310700005;800;794;800;0;339;799;1;0;0;0;0;339;4;335
310700006;900;901;901;5;300;899;1;0;0;0;0;300;3;297
310700007;800;772;773;1;282;799;1;0;0;0;0;282;2;280
310700008;900;899;901;2;275;899;1;0;0;0;0;275;2;273
310700009;800;830;832;1;266;799;1;0;0;0;0;266;2;264
310700010;900;918;919;0;252;899;1;0;0;0;0;252;6;246
310700011;900;858;861;0;312;899;1;0;0;0;0;312;5;307
310700012;500;515;515;4;176;499;1;0;0;0;0;176;3;173
310700013;100;63;64;5;31;68;1;31;1;0;30;0;0;0
310700014;100;95;94;4;44;55;1;44;2;0;42;0;0;0
310700015;100;66;66;6;37;62;1;37;5;0;32;0;0;0
310700016;100;53;54;7;33;66;1;33;3;1;29;0;0;0
310700017;300;298;298;3;125;174;1;125;7;0;118;0;0;0
310700018;200;168;168;4;94;105;1;94;1;0;93;0;0;0
310700019;100;54;54;4;29;70;1;29;1;0;28;0;0;0
310700020;100;73;73;5;56;43;1;56;2;1;53;0;0;0
310700021;200;204;204;4;94;105;1;94;1;0;93;0;0;0
310700022;400;418;420;3;107;400;0;0;0;0;0;107;0;107
310700023;300;335;336;1;104;299;1;0;0;0;0;104;0;104
310700024;300;389;389;3;166;299;1;0;0;0;0;166;5;161
310700025;100;116;116;0;57;42;1;57;11;0;46;0;0;0
310700026;400;434;434;4;158;399;1;0;0;0;0;158;1;157
310700027;200;200;201;3;78;121;1;78;3;0;75;0;0;0
310700028;400;434;438;5;107;400;0;0;0;0;0;107;0;107
310700029;100;55;55;8;31;68;1;31;1;0;30;0;0;0
310700030;100;13;13;0;10;89;1;10;0;0;10;0;0;0
312200001;400;463;463;11;192;399;1;0;0;0;0;192;3;189
312200002;800;843;844;0;313;799;1;0;0;0;0;313;6;307
312200003;700;710;710;3;182;699;1;0;0;0;0;182;1;181
312200004;800;841;842;3;220;799;1;0;0;0;0;220;1;219
312200005;500;558;558;10;185;499;1;0;0;0;0;185;1;184
312200006;500;529;529;6;169;499;1;0;0;0;0;169;3;166
312200007;700;789;789;4;131;699;1;0;0;0;0;131;0;131
312200008;100;101;101;3;60;38;2;60;1;3;56;0;0;0
312200009;100;136;138;5;66;33;1;66;4;1;61;0;0;0
312200010;100;47;47;4;30;69;1;30;1;0;29;0;0;0
312200011;300;327;330;2;159;299;1;0;0;0;0;159;1;158
312200012;300;248;249;3;120;179;1;120;9;1;110;0;0;0
312200013;200;236;236;4;129;69;2;129;2;1;126;0;0;0
312200014;400;494;494;5;190;399;1;0;0;0;0;190;2;188
312200015;800;808;811;0;210;799;1;0;0;0;0;210;1;209
312200016;300;279;280;5;120;179;1;120;6;2;112;0;0;0
312200017;300;316;316;4;109;299;1;0;0;0;0;109;0;109
312200018;100;30;30;5;24;75;1;24;0;0;24;0;0;0
312200019;400;449;453;3;185;399;1;0;0;0;0;185;0;185
312200020;200;153;153;5;79;120;1;79;1;0;78;0;0;0
312200021;200;186;190;2;80;119;1;80;0;2;78;0;0;0
312200022;200;168;169;4;75;123;2;75;5;0;70;0;0;0
312200023;100;86;87;4;63;36;1;63;2;0;61;0;0;0
312200024;200;150;150;2;79;120;1;79;4;0;75;0;0;0
312200025;100;70;70;2;56;38;6;56;5;0;51;0;0;0
312200026;200;163;163;5;82;117;1;82;3;2;77;0;0;0
312200027;100;80;80;4;41;58;1;41;2;0;39;0;0;0
312200028;100;135;137;1;67;33;0;67;4;1;62;0;0;0
312200029;200;230;230;4;121;78;1;121;0;1;120;0;0;0
312200030;100;23;23;0;23;76;1;23;0;0;23;0;0;0
312500001;100;78;78;6;44;55;1;44;3;0;41;0;0;0
312500002;400;457;458;3;167;399;1;0;0;0;0;167;1;166
312500003;400;460;460;2;206;399;1;0;0;0;0;206;6;200
312500004;600;650;657;4;249;599;1;0;0;0;0;249;2;247
312500005;200;230;231;6;135;64;1;135;6;2;127;0;0;0
312500006;500;495;500;3;150;499;1;0;0;0;0;150;0;150
312500007;400;435;450;2;179;399;1;0;0;0;0;179;1;178
312500008;800;870;870;4;362;799;1;0;0;0;0;362;4;358
312500009;100;22;22;7;21;78;1;21;1;0;20;0;0;0
312500010;500;589;594;1;281;499;1;0;0;0;0;281;0;281
312500011;200;244;244;9;157;42;1;157;3;1;153;0;0;0
312500012;200;258;260;2;130;69;1;130;3;1;126;0;0;0
312500013;200;201;202;3;121;78;1;121;7;0;114;0;0;0
312500014;500;564;565;3;186;499;1;0;0;0;0;186;1;185
312500015;100;62;63;4;43;56;1;43;2;0;41;0;0;0
312500016;100;83;84;2;47;52;1;47;2;0;45;0;0;0
312500017;700;767;774;3;236;700;0;0;0;0;0;236;0;236
312500018;100;119;120;3;74;25;1;74;0;1;73;0;0;0
312500019;700;795;808;2;433;699;1;0;0;0;0;433;2;431
312500020;300;387;405;2;190;299;1;0;0;0;0;190;1;189
312500021;200;197;197;3;118;80;2;118;3;0;115;0;0;0
312500022;300;321;321;3;145;299;1;0;0;0;0;145;0;145
312500023;100;114;131;4;76;17;7;76;6;1;69;0;0;0
312500024;300;409;409;4;128;299;1;0;0;0;0;128;0;128
312500025;500;570;570;3;227;499;1;0;0;0;0;227;5;222
312500026;700;744;744;3;235;699;1;0;0;0;0;235;0;235
312500027;500;558;573;5;242;499;1;0;0;0;0;242;0;242
312500028;200;173;175;1;100;99;1;100;4;4;92;0;0;0
312500029;100;118;119;5;61;38;1;61;0;0;61;0;0;0
312500030;200;188;188;3;93;106;1;93;6;0;87;0;0;0
312500031;300;346;346;4;137;299;1;0;0;0;0;137;2;135
312500032;300;344;344;1;150;299;1;0;0;0;0;150;0;150
312500033;400;474;474;2;152;399;1;0;0;0;0;152;1;151
312500034;400;453;484;3;190;399;1;0;0;0;0;190;1;189
312500035;100;76;76;7;47;52;1;47;2;0;45;0;0;0
312500036;400;448;450;3;151;399;1;0;0;0;0;151;0;151
312500037;400;460;460;3;163;400;0;0;0;0;0;163;0;163
312500038;100;122;122;2;54;45;1;54;3;0;51;0;0;0
312500039;200;201;202;6;142;56;2;142;3;0;139;0;0;0
312500040;400;418;421;2;185;399;1;0;0;0;0;185;1;184
312500041;100;125;128;6;71;28;1;71;1;2;68;0;0;0
312500042;200;299;299;3;192;7;1;192;6;1;185;0;0;0
312500043;500;609;619;0;232;499;1;0;0;0;0;232;2;230
312500044;500;616;623;2;221;499;1;0;0;0;0;221;4;217
312500045;100;129;130;4;72;27;1;72;3;0;69;0;0;0
312500046;400;471;471;3;127;399;1;0;0;0;0;127;0;127
312500047;400;450;451;2;195;399;1;0;0;0;0;195;0;195
312500048;400;464;466;2;176;399;1;0;0;0;0;176;1;175
312500049;200;267;267;4;139;60;1;139;5;1;133;0;0;0
312500050;100;17;17;6;22;77;1;22;4;0;18;0;0;0
312500051;100;13;13;0;13;87;0;13;0;0;13;0;0;0
312500052;100;48;48;4;51;48;1;51;2;1;48;0;0;0
312500053;100;19;19;3;22;76;2;22;0;1;21;0;0;0
312500054;100;55;55;7;62;37;1;62;0;0;62;0;0;0
312600001;600;667;668;11;302;599;1;0;0;0;0;302;7;295
312600002;600;595;598;8;255;599;1;0;0;0;0;255;6;249
312600003;400;458;458;6;171;399;1;0;0;0;0;171;2;169
312600004;500;537;541;9;201;499;1;0;0;0;0;201;5;196
312600005;500;543;546;4;236;499;1;0;0;0;0;236;3;233
312600006;600;638;643;7;277;599;1;0;0;0;0;277;1;276
312600007;700;705;705;5;315;699;1;0;0;0;0;315;3;312
312600008;700;708;711;8;299;699;1;0;0;0;0;299;3;296
312600009;500;515;515;5;241;499;1;0;0;0;0;241;3;238
312600010;500;557;558;4;247;499;1;0;0;0;0;247;2;245
312600011;500;566;567;6;247;499;1;0;0;0;0;247;5;242
312600012;500;527;529;6;208;499;1;0;0;0;0;208;4;204
312600013;500;546;547;9;264;499;1;0;0;0;0;264;4;260
312600014;900;915;915;7;391;899;1;0;0;0;0;391;8;383
312600015;500;576;576;7;230;499;1;0;0;0;0;230;3;227
312600016;400;474;476;7;215;255;2;143;3;2;138;72;1;71
312600017;700;759;762;10;309;699;1;0;0;0;0;309;4;305
312600018;600;576;580;11;231;599;1;0;0;0;0;231;2;229
312600019;600;674;674;7;344;599;1;0;0;0;0;344;4;340
312600020;700;748;751;6;320;699;1;0;0;0;0;320;4;316
312600021;600;568;571;7;210;599;1;0;0;0;0;210;7;203
312600022;700;680;681;5;260;699;1;0;0;0;0;260;3;257
312600023;600;596;596;5;212;599;1;0;0;0;0;212;2;210
312600024;700;720;720;7;255;699;1;0;0;0;0;255;0;255
312600025;700;739;740;3;275;699;1;0;0;0;0;275;4;271
312600026;700;703;695;8;225;699;1;0;0;0;0;225;2;223
312600027;600;648;651;8;264;599;1;0;0;0;0;264;2;262
312600028;600;655;656;5;257;599;1;0;0;0;0;257;6;251
312600029;700;722;723;4;281;699;1;0;0;0;0;281;5;276
312600030;400;490;455;3;117;399;1;0;0;0;0;117;1;116
312600031;300;329;323;13;194;104;2;194;6;3;185;0;0;0
312600032;500;533;534;7;219;499;1;0;0;0;0;219;2;217
312600033;400;451;451;5;195;399;1;0;0;0;0;195;4;191
312600034;600;607;608;5;298;599;1;0;0;0;0;298;4;294
312600035;500;539;540;7;211;499;1;0;0;0;0;211;6;205
312600036;500;537;538;5;218;499;1;0;0;0;0;218;4;214
312600037;800;781;783;6;377;799;1;0;0;0;0;377;4;373
312600038;600;673;677;7;245;599;1;0;0;0;0;245;3;242
312600039;500;537;543;8;196;499;1;0;0;0;0;196;3;193
312600040;500;572;573;10;233;499;1;0;0;0;0;233;2;231
312600041;700;755;755;9;97;699;1;0;0;0;0;97;2;95
312600042;800;845;849;9;110;799;1;0;0;0;0;110;1;109
312600043;900;973;973;6;80;899;1;0;0;0;0;80;0;80
312600044;900;944;944;11;125;899;1;0;0;0;0;125;0;125
312600045;800;810;810;9;47;799;1;0;0;0;0;47;2;45
312600046;900;987;988;10;39;899;1;0;0;0;0;39;0;39
312600047;900;970;971;11;49;899;1;0;0;0;0;49;0;49
312600048;1000;1029;1031;6;67;999;1;0;0;0;0;67;1;66
312600049;900;893;893;8;63;899;1;0;0;0;0;63;0;63
312600050;700;695;696;3;176;699;1;0;0;0;0;176;3;173
312600051;700;710;713;5;208;699;1;0;0;0;0;208;3;205
312600052;700;762;764;5;209;699;1;0;0;0;0;209;3;206
312600053;700;716;717;3;181;699;1;0;0;0;0;181;1;180
312600054;500;490;491;1;149;499;1;0;0;0;0;149;5;144
312600055;600;620;622;4;158;599;1;0;0;0;0;158;1;157
312600056;500;551;551;5;112;499;1;0;0;0;0;112;0;112
312600057;500;563;567;4;183;499;1;0;0;0;0;183;0;183
312600058;600;622;623;4;184;599;1;0;0;0;0;184;2;182
312600059;600;649;651;7;286;599;1;0;0;0;0;286;1;285
312600060;700;716;719;7;300;699;1;0;0;0;0;300;2;298
312600061;500;552;552;8;240;499;1;0;0;0;0;240;5;235
312600062;500;505;506;17;239;499;1;0;0;0;0;239;3;236
312600063;600;645;647;6;255;599;1;0;0;0;0;255;2;253
312600064;400;427;430;4;165;399;1;0;0;0;0;165;2;163
312600065;400;465;466;7;208;399;1;0;0;0;0;208;4;204
312600066;600;588;590;4;248;599;1;0;0;0;0;248;1;247
312600067;800;774;776;3;297;799;1;0;0;0;0;297;5;292
312600068;600;623;626;4;242;599;1;0;0;0;0;242;0;242
312600069;400;446;448;6;169;399;1;0;0;0;0;169;2;167
312600070;600;627;628;3;236;599;1;0;0;0;0;236;4;232
312600071;600;585;586;8;181;599;1;0;0;0;0;181;4;177
312600072;700;679;683;3;257;699;1;0;0;0;0;257;9;248
312600073;700;717;719;6;286;699;1;0;0;0;0;286;8;278
312600074;600;621;622;8;228;599;1;0;0;0;0;228;3;225
312600075;400;404;404;4;156;399;1;0;0;0;0;156;3;153
312600076;700;677;679;6;216;699;1;0;0;0;0;216;4;212
312600077;600;643;645;6;257;599;1;0;0;0;0;257;4;253
312600078;500;535;537;4;219;499;1;0;0;0;0;219;5;214
312600079;700;707;707;4;290;699;1;0;0;0;0;290;2;288
312600080;700;712;713;5;292;699;1;0;0;0;0;292;5;287
312600081;700;740;742;5;273;699;1;0;0;0;0;273;3;270
312600082;800;779;780;4;263;799;1;0;0;0;0;263;8;255
312600083;600;628;628;4;202;599;1;0;0;0;0;202;0;202
312600084;600;621;622;8;277;599;1;0;0;0;0;277;2;275
312600085;600;634;635;4;275;600;0;0;0;0;0;275;6;269
312600086;600;573;575;4;220;599;1;0;0;0;0;220;6;214
312600087;700;671;673;4;285;700;0;0;0;0;0;285;5;280
312600088;700;724;725;2;280;700;0;0;0;0;0;280;2;278
312600089;700;764;764;0;321;699;1;0;0;0;0;321;4;317
312600090;600;579;582;5;259;599;1;0;0;0;0;259;0;259
312600091;700;676;677;1;267;699;1;0;0;0;0;267;1;266
312600092;600;674;674;6;288;1;599;0;0;0;0;288;9;279
312600093;600;595;595;7;208;599;1;0;0;0;0;208;3;205
312600094;600;649;650;3;235;599;1;0;0;0;0;235;4;231
312600095;600;631;631;7;298;599;1;0;0;0;0;298;5;293
312600096;600;636;639;7;236;599;1;0;0;0;0;236;2;234
312600097;600;600;601;6;193;599;1;0;0;0;0;193;0;193
312600098;800;784;786;7;279;799;1;0;0;0;0;279;9;270
312600099;600;542;542;1;193;599;1;0;0;0;0;193;4;189
312600100;400;431;433;6;189;399;1;0;0;0;0;189;0;189
312600101;500;524;527;3;228;499;1;0;0;0;0;228;5;223
312600102;100;79;79;2;76;24;0;76;2;1;73;0;0;0
312600103;100;19;19;34;53;46;1;53;0;1;52;0;0;0
312600104;100;17;17;16;26;73;1;26;0;0;26;0;0;0
312600105;100;14;14;20;20;79;1;20;0;0;20;0;0;0
320100001;200;8;8;28;34;165;1;34;0;1;33;0;0;0
320100002;100;48;48;19;51;47;2;51;0;0;51;0;0;0
320100003;200;48;48;51;96;101;3;96;0;1;95;0;0;0
320100004;300;60;60;81;134;164;2;134;0;4;130;0;0;0
320100005;200;55;55;59;107;92;1;107;5;8;94;0;0;0
320100006;400;55;55;106;132;267;1;132;1;0;131;0;0;0
320100007;400;53;53;55;95;297;8;95;1;0;94;0;0;0
320200008;800;104;104;318;397;799;1;0;0;0;0;397;6;391
320200009;800;57;57;125;164;632;4;164;4;6;154;0;0;0
320200010;500;153;153;153;153;344;3;153;4;2;147;0;0;0
320200011;300;68;68;21;52;247;1;52;2;2;48;0;0;0
320200012;400;61;61;129;180;218;2;180;1;3;176;0;0;0
320200013;300;21;21;119;133;164;3;133;3;1;129;0;0;0
320200014;600;72;72;270;321;599;1;0;0;0;0;321;4;317
320200015;600;37;37;277;303;600;0;0;0;0;0;303;5;298
320200016;600;98;98;258;330;599;1;0;0;0;0;330;3;327
320200017;600;71;71;214;285;599;1;0;0;0;0;285;4;281
320200018;600;55;55;241;286;599;1;0;0;0;0;286;5;281
320200019;500;20;20;288;308;499;1;0;0;0;0;308;9;299
320200020;500;66;66;131;182;314;4;182;3;4;175;0;0;0
320200021;600;87;87;283;351;600;0;0;0;0;0;351;2;349
320200022;700;85;85;233;310;699;1;0;0;0;0;310;2;308
320200023;300;18;18;84;102;195;3;102;2;0;100;0;0;0
320200024;500;68;68;216;274;499;1;0;0;0;0;274;6;268
320300025;100;11;11;8;19;79;2;19;1;0;18;0;0;0
320400026;300;21;21;104;122;176;2;122;1;2;119;0;0;0
320400027;300;54;54;84;112;187;1;112;0;0;112;0;0;0
320400028;300;52;52;34;76;222;2;76;0;0;76;0;0;0
320500029;100;7;7;28;35;64;1;35;4;0;31;0;0;0
320600030;100;22;22;10;28;70;2;28;6;1;21;0;0;0
320700031;100;14;14;19;32;67;1;32;0;0;32;0;0;0
320800032;200;9;9;14;22;177;1;22;0;0;22;0;0;0
320900033;800;67;67;386;424;799;1;0;0;0;0;424;10;414
320900034;500;56;56;177;224;498;2;0;0;0;0;224;2;222
320900035;800;45;45;80;100;697;3;100;5;0;95;0;0;0
320900036;0;0;0;0;249;0;0;0;0;0;0;249;2;247
320900037;600;61;61;227;266;332;2;266;6;2;258;0;0;0
320900038;600;61;61;485;526;599;1;0;0;0;0;526;4;522
320900039;500;51;51;199;218;281;1;218;18;1;199;0;0;0
320900040;400;48;48;225;261;399;1;0;0;0;0;261;2;259
320900041;500;0;0;109;109;389;2;109;3;3;103;0;0;0
320900042;400;43;43;78;110;288;2;110;5;7;98;0;0;0
320900043;700;37;37;282;309;699;1;0;0;0;0;309;4;305
320900044;700;44;44;76;91;607;2;91;6;0;85;0;0;0
320900045;900;26;26;332;342;900;0;0;0;0;0;342;0;342
320900046;400;49;49;161;205;399;1;0;0;0;0;205;1;204
320900047;400;62;62;62;104;293;3;104;2;0;102;0;0;0
320900048;500;74;74;154;202;499;1;0;0;0;0;202;3;199
321000049;100;5;5;23;28;71;1;28;0;2;26;0;0;0
321100050;100;1;1;8;9;90;1;9;0;0;9;0;0;0
321100051;200;41;41;2;9;190;1;9;0;0;9;0;0;0
321200052;1000;234;234;189;321;999;1;0;0;0;0;321;2;319
321200053;1000;133;133;360;428;999;1;0;0;0;0;428;3;425
321200054;1000;85;85;560;621;999;1;0;0;0;0;621;6;615
321200055;1000;68;68;234;275;999;1;0;0;0;0;275;6;269
321200056;1000;73;73;200;244;753;3;244;11;2;231;0;0;0
321200057;1000;98;98;125;194;803;3;194;2;4;188;0;0;0
321200058;1000;91;91;74;137;859;4;137;1;1;135;0;0;0
321200059;1000;55;55;185;219;777;4;219;11;1;207;0;0;0
321200060;1000;99;99;200;272;1000;0;0;0;0;0;272;9;263
321200061;1000;54;54;53;95;904;1;95;7;0;88;0;0;0
321200062;1000;54;54;96;137;859;4;137;2;1;134;0;0;0
321200063;600;45;45;112;138;458;4;138;5;2;131;0;0;0
321200064;900;142;142;426;539;359;2;539;16;3;520;0;0;0
321200065;800;57;57;63;100;699;1;100;4;0;96;0;0;0
321200066;1000;41;41;245;286;713;1;286;7;0;279;0;0;0
321200067;800;69;69;130;184;609;7;184;4;4;176;0;0;0
321200068;1000;69;69;168;225;774;1;225;6;1;218;0;0;0
321200069;1000;93;93;257;332;1000;0;0;0;0;0;332;1;331
321200070;1000;189;189;339;467;999;1;0;0;0;0;467;4;463
321200071;1000;100;100;151;223;999;1;0;0;0;0;223;3;220
321200072;500;59;59;48;80;417;3;80;4;2;74;0;0;0
321200073;1000;105;105;128;214;1000;0;0;0;0;0;214;3;211
321200074;600;58;58;124;173;426;1;173;7;0;166;0;0;0
321200075;1000;125;125;277;377;999;1;0;0;0;0;377;0;377
321200076;1000;35;35;172;207;792;1;207;7;1;199;0;0;0
321200077;10;37;37;176;207;10;0;0;0;0;0;207;3;204
321200078;1000;54;54;143;185;811;4;185;4;0;181;0;0;0
321200079;700;101;101;248;335;700;0;0;0;0;0;335;3;332
321200080;1000;52;52;66;106;891;3;106;4;0;102;0;0;0
321200081;800;50;50;99;140;652;8;140;6;4;130;0;0;0
321200082;1000;54;54;113;161;837;2;161;7;1;153;0;0;0
321200083;1000;91;91;375;447;999;1;0;0;0;0;447;3;444
321200084;800;190;190;167;243;553;4;243;13;0;230;0;0;0
321200085;0;125;125;247;329;0;0;0;0;0;0;329;2;327
321200086;1000;0;0;93;93;905;2;93;5;0;88;0;0;0
321200087;1000;87;87;156;222;999;1;0;0;0;0;222;4;218
321200088;1000;73;73;196;246;746;8;246;9;6;231;0;0;0
321200089;800;101;101;179;263;799;1;0;0;0;0;263;3;260
321200090;1000;47;47;275;313;999;1;0;0;0;0;313;2;311
321200091;1000;192;192;94;161;1000;0;0;0;0;0;161;2;159
321200092;1000;0;0;131;131;865;4;131;3;3;125;0;0;0
321200093;1000;21;21;349;370;628;1;371;5;4;362;0;0;0
321200094;800;69;69;148;206;592;2;206;2;3;201;0;0;0
321200095;1000;84;84;218;288;1000;0;0;0;0;0;288;4;284
321200096;600;37;37;61;94;505;1;94;0;1;93;0;0;0
321200097;700;198;198;349;492;696;4;0;0;0;0;492;4;488
321200098;700;0;0;299;299;399;2;299;9;5;285;0;0;0
321200099;1000;103;103;134;206;999;1;0;0;0;0;206;0;206
321200100;1000;65;65;101;150;847;3;150;3;0;147;0;0;0
321200101;800;77;77;89;146;654;0;146;2;1;143;0;0;0
321200102;1000;55;55;325;371;999;1;0;0;0;0;371;2;369
321200103;600;79;79;170;238;599;1;0;0;0;0;238;7;231
321200104;1000;114;114;333;427;1000;0;0;0;0;0;427;3;424
321200105;1000;62;62;338;378;1000;0;0;0;0;0;378;7;371
321200106;1000;90;90;305;378;1000;0;0;0;0;0;378;6;372
321200107;800;123;123;270;393;799;1;0;0;0;0;393;3;390
321200108;1000;66;66;392;437;562;1;437;19;1;417;0;0;0
321200109;800;33;33;184;213;583;4;213;7;3;203;0;0;0
321200110;800;54;54;185;231;567;2;231;5;1;225;0;0;0
321200111;1000;94;94;248;315;1000;0;0;0;0;0;315;3;312
321200112;1000;0;0;154;154;845;1;154;14;0;140;0;0;0
321200113;800;147;147;244;356;800;0;0;0;0;0;356;2;354
321200114;800;0;0;107;107;689;4;107;4;0;103;0;0;0
321200116;1000;97;97;84;171;827;2;171;7;0;164;0;0;0
321200117;800;90;90;168;243;799;1;0;0;0;0;243;4;239
321200118;1000;98;98;236;317;999;1;0;0;0;0;317;5;312
321200119;2000;285;285;695;870;2000;0;0;0;0;0;870;11;859
321200120;1200;95;95;112;153;1045;2;153;6;4;143;0;0;0
321200121;1000;94;94;325;388;1000;0;0;0;0;0;388;3;385
321200122;1200;211;211;477;637;557;6;637;14;4;619;0;0;0
321200123;1000;86;86;131;204;793;3;204;5;0;199;0;0;0
321200124;1000;80;80;175;228;768;4;228;4;1;223;0;0;0
321200125;1000;59;59;310;333;663;4;333;20;1;312;0;0;0
321200126;800;73;73;200;273;800;0;0;0;0;0;273;2;271
321200127;800;19;19;158;175;800;0;0;0;0;0;175;5;170
321200128;1000;250;250;391;555;441;4;555;18;6;531;0;0;0
321200129;700;94;94;172;252;700;0;0;0;0;0;252;3;249
321200130;1000;59;59;205;264;733;3;264;6;1;257;0;0;0
321200131;600;85;85;235;307;600;0;0;0;0;0;307;3;304
321200132;1000;133;133;287;309;686;5;309;17;1;291;0;0;0
321200133;800;94;94;170;246;800;0;0;0;0;0;246;2;244
321200134;600;52;52;128;174;425;1;174;9;2;163;0;0;0
321200135;800;52;52;68;103;693;4;103;2;1;100;0;0;0
321200136;500;45;45;160;193;304;3;193;4;3;186;0;0;0
321200137;700;112;112;186;282;699;1;0;0;0;0;282;2;280
321200138;700;143;143;214;308;389;3;308;12;3;293;0;0;0
321200139;700;60;60;254;304;700;0;0;0;0;0;304;2;302
321200140;700;84;84;139;211;487;2;211;7;3;201;0;0;0
321200141;800;77;77;304;363;799;1;0;0;0;0;363;4;359
321200142;1000;72;72;358;414;999;1;0;0;0;0;414;6;408
321200143;600;79;79;119;184;414;2;184;3;5;176;0;0;0
321200144;1000;73;73;260;323;999;1;0;0;0;0;323;4;319
321200145;800;119;119;181;275;799;1;0;0;0;0;275;1;274
321200146;1000;57;57;167;217;999;1;0;0;0;0;217;4;213
321200147;1000;476;476;389;476;999;1;0;0;0;0;476;6;470
321200148;600;25;25;119;142;455;3;142;1;0;141;0;0;0
321200149;1000;274;274;202;417;1000;0;0;0;0;0;417;4;413
321200150;1000;42;42;446;470;999;1;0;0;0;0;470;2;468
321200151;1000;31;31;80;103;896;1;103;1;1;101;0;0;0
321200152;1000;41;41;73;103;896;1;103;4;1;98;0;0;0
321200153;600;61;61;125;167;432;1;167;1;3;163;0;0;0
321200154;1000;68;68;271;312;1000;0;0;0;0;0;312;2;310
321200155;1000;79;79;165;185;810;5;185;9;1;175;0;0;0
321200156;700;128;128;341;449;699;1;0;0;0;0;449;1;448
321200157;900;137;137;376;489;899;1;0;0;0;0;489;4;485
321200158;1000;18;18;164;172;824;4;172;6;2;164;0;0;0
321200159;1000;137;137;331;418;1000;0;0;0;0;0;418;3;415
321200160;1000;48;48;311;351;999;1;0;0;0;0;351;3;348
321200161;1000;53;53;168;210;789;1;210;5;7;198;0;0;0
321200162;1100;169;169;429;556;1099;1;0;0;0;0;556;6;550
321200163;500;55;55;90;136;363;1;136;7;1;128;0;0;0
321200164;700;47;47;73;111;588;1;111;5;2;104;0;0;0
321200165;1000;122;122;353;455;999;1;0;0;0;0;455;4;451
321200166;1000;77;77;421;468;999;1;0;0;0;0;468;5;463
321200167;800;51;51;149;182;617;1;182;1;2;179;0;0;0
321300169;100;12;12;24;31;68;1;31;0;2;29;0;0;0
321400170;600;39;39;263;291;599;1;0;0;0;0;291;1;290
321400171;600;38;38;119;147;445;8;147;7;2;138;0;0;0
321400172;500;12;12;141;149;350;1;149;2;1;146;0;0;0
321400173;600;16;16;194;210;599;1;0;0;0;0;210;0;210
321400174;600;0;0;223;223;599;1;0;0;0;0;223;1;222
321400175;600;186;186;0;186;599;1;0;0;0;0;186;1;185
321400176;1500;73;73;449;522;975;3;522;29;0;493;0;0;0
321400177;700;91;91;406;462;235;3;462;5;4;453;0;0;0
321400178;500;17;17;47;59;440;1;59;3;1;55;0;0;0
321400179;300;5;5;127;132;167;1;132;4;0;128;0;0;0
321400180;500;27;27;36;63;436;1;63;0;2;61;0;0;0
321400181;1200;85;85;613;674;519;7;674;10;6;658;0;0;0
321400182;1300;77;77;1028;1093;200;7;1093;9;19;1065;0;0;0
321400183;1500;187;187;1224;1382;111;7;1382;12;11;1359;0;0;0
321400184;1200;91;91;156;224;975;1;224;5;3;216;0;0;0
321400185;500;41;41;60;92;406;2;92;0;0;92;0;0;0
321400186;500;3;3;43;43;456;1;43;2;0;41;0;0;0
321400187;500;10;10;114;124;371;5;124;6;4;114;0;0;0
321400188;500;11;11;61;69;430;1;69;9;4;56;0;0;0
321400189;500;46;46;71;106;391;3;106;11;2;93;0;0;0
321400190;500;28;28;99;125;374;1;125;0;4;121;0;0;0
321400191;500;28;28;163;185;313;2;185;3;3;179;0;0;0
321400192;500;78;78;271;335;164;1;335;0;0;335;0;0;0
321400193;1000;88;88;314;383;613;4;383;4;3;376;0;0;0
321400194;500;87;87;69;142;357;1;142;2;2;138;0;0;0
321400195;500;43;43;125;162;335;3;162;0;3;159;0;0;0
321400196;1200;76;76;480;535;663;2;535;7;8;520;0;0;0
321400197;500;68;68;85;138;359;3;138;5;1;132;0;0;0
321400198;2000;60;60;501;541;1454;5;541;30;8;503;0;0;0
321400199;1200;104;104;533;608;590;2;608;5;8;595;0;0;0
321400200;500;48;48;30;54;445;1;54;1;1;52;0;0;0
321400201;500;57;57;62;90;407;3;90;0;1;89;0;0;0
321500202;1000;73;73;262;319;1000;0;0;0;0;0;319;3;316
321500203;1000;69;69;249;304;1000;0;0;0;0;0;304;8;296
321500204;400;35;35;86;117;282;1;117;0;2;115;0;0;0
321500205;400;25;25;60;81;318;1;81;0;2;79;0;0;0
321500206;400;48;48;109;144;251;5;144;1;3;140;0;0;0
321500207;400;32;32;116;131;268;1;131;2;3;126;0;0;0
321500208;500;7;7;89;91;408;1;91;2;1;88;0;0;0
321500209;500;49;49;8;52;446;2;52;0;3;49;0;0;0
321500210;400;23;23;61;83;315;2;83;0;0;83;0;0;0
321500211;400;40;40;121;154;240;6;154;2;3;149;0;0;0
321600212;300;41;41;15;25;273;2;25;0;0;25;0;0;0
321700213;200;1;1;28;29;171;0;29;0;0;29;0;0;0
321800214;500;20;20;142;155;343;2;155;5;3;147;0;0;0
321900215;100;7;7;6;13;86;1;13;0;1;12;0;0;0
322000216;700;175;175;267;397;700;0;0;0;0;0;397;4;393
322000217;400;41;41;72;89;306;5;89;1;0;88;0;0;0
322000218;300;62;62;47;103;196;1;103;4;0;99;0;0;0
322000219;300;62;62;71;123;176;1;123;0;3;120;0;0;0
322000220;300;90;90;89;167;132;1;167;1;5;161;0;0;0
322100221;300;34;34;64;98;201;1;98;3;2;93;0;0;0
322200222;800;42;42;291;323;799;1;0;0;0;0;323;2;321
322200223;800;45;45;276;311;799;1;0;0;0;0;311;5;306
322200224;700;49;49;243;281;699;1;0;0;0;0;281;1;280
322200225;600;56;56;66;104;495;1;104;1;0;103;0;0;0
322200226;500;62;62;218;255;499;1;0;0;0;0;255;1;254
322200227;500;51;51;289;317;500;0;0;0;0;0;317;4;313
322200228;500;63;63;181;223;276;1;223;3;0;220;0;0;0
322200229;500;47;47;205;249;499;1;0;0;0;0;248;0;248
322200230;1000;13;13;54;64;934;2;64;1;0;63;0;0;0
322200231;1000;126;126;328;432;1000;0;0;0;0;0;432;6;426
322200232;1000;126;126;260;340;1000;0;0;0;0;0;340;4;336
322200233;0;51;51;111;137;0;0;0;0;0;0;137;1;136
322200234;800;81;81;237;305;799;1;0;0;0;0;305;5;300
322200235;1500;172;172;318;461;1500;0;0;0;0;0;461;8;453
322200236;1500;0;0;386;385;1500;0;0;0;0;0;386;3;383
322200237;1200;135;135;367;472;1200;0;0;0;0;0;472;4;468
322200238;500;45;45;43;73;426;1;73;4;2;67;0;0;0
322200239;800;38;38;54;77;721;2;77;0;1;76;0;0;0
322200240;600;100;100;392;465;599;1;0;0;0;0;465;7;458
322200241;600;0;0;116;116;483;1;116;13;1;102;0;0;0
322200242;600;0;0;81;80;515;5;80;1;0;79;0;0;0
322200243;400;32;32;117;143;254;3;143;2;1;140;0;0;0
322200244;600;71;71;176;239;359;2;239;9;3;227;0;0;0
322200245;600;53;53;153;189;410;1;189;5;0;184;0;0;0
322200246;400;8;8;145;150;249;1;150;6;1;143;0;0;0
322200247;1000;84;84;192;245;748;7;245;18;0;227;0;0;0
322200248;300;20;20;65;80;219;1;80;1;1;78;0;0;0
322200249;600;37;37;65;91;508;1;91;4;3;84;0;0;0
322200250;300;112;112;110;196;98;6;196;8;5;183;0;0;0
322200251;700;126;126;339;438;699;1;0;0;0;0;438;2;436
322200252;700;50;50;147;182;514;4;182;10;1;171;0;0;0
322200253;300;67;67;30;85;214;1;85;1;1;83;0;0;0
322200254;1000;25;25;63;82;917;1;82;0;3;79;0;0;0
322200255;800;34;34;147;176;623;1;176;6;1;169;0;0;0
322200256;500;73;73;215;271;499;1;0;0;0;0;271;1;270
322200257;600;118;118;190;276;600;0;0;0;0;0;276;4;272
322200258;700;92;92;234;305;699;1;0;0;0;0;305;3;302
322200259;500;51;51;60;91;407;2;91;3;4;84;0;0;0
322200260;600;102;102;247;330;599;1;0;0;0;0;330;11;319
322200261;600;36;36;232;257;599;1;0;0;0;0;257;0;257
322200262;500;70;70;227;285;499;1;0;0;0;0;285;3;282
322200263;700;37;37;201;238;699;1;0;0;0;0;238;3;235
322200264;300;45;45;63;83;215;2;83;3;0;80;0;0;0
322200265;500;29;29;80;107;392;1;107;4;1;102;0;0;0
322200266;1500;198;198;373;526;1500;0;0;0;0;0;526;5;521
322200267;1500;0;0;348;348;1147;5;348;7;4;337;0;0;0
322200268;600;139;139;404;506;600;0;0;0;0;0;506;3;503
322200269;600;0;0;137;137;460;3;137;9;0;128;0;0;0
322200270;400;14;14;121;128;271;1;128;1;0;127;0;0;0
322200271;500;11;11;60;70;429;1;70;3;1;66;0;0;0
322200272;600;130;130;321;296;600;0;0;0;0;0;296;1;295
322200273;300;36;36;90;120;177;3;120;0;0;120;0;0;0
322200274;500;104;104;146;235;499;1;0;0;0;0;236;5;231
322200275;400;43;43;99;134;264;2;134;4;0;130;0;0;0
322200276;500;68;68;64;66;433;1;66;0;1;65;0;0;0
322200277;800;54;54;267;307;799;1;0;0;0;0;307;4;303
322200278;1200;46;46;76;122;1076;2;122;2;2;118;0;0;0
322200279;400;11;11;111;121;275;4;121;2;0;119;0;0;0
322200280;800;85;85;140;213;799;1;0;0;0;0;213;4;209
322200281;800;70;70;349;411;799;1;0;0;0;0;411;4;407
322200282;400;74;74;81;141;258;1;141;0;3;138;0;0;0
322200283;600;41;41;66;89;510;1;89;3;2;84;0;0;0
322200284;500;27;27;118;140;359;1;140;8;1;131;0;0;0
322200285;700;45;45;238;271;700;0;0;0;0;0;270;3;267
322200286;700;0;0;135;135;563;2;135;5;0;130;0;0;0
322200287;693;144;144;354;474;692;1;0;0;0;0;474;3;471
322200288;500;4;4;124;126;372;2;126;9;2;115;0;0;0
322300289;1300;15;15;199;206;1091;3;206;4;3;199;0;0;0
322300290;1200;36;36;160;185;1009;6;185;15;0;170;0;0;0
322300291;1000;76;76;71;121;878;1;121;0;3;118;0;0;0
322300292;1000;52;52;28;64;935;1;64;0;0;64;0;0;0
322300293;1000;83;83;122;195;803;2;195;5;3;187;0;0;0
322300294;1000;69;69;165;217;780;3;217;3;0;214;0;0;0
322300295;1000;56;56;91;133;865;2;133;5;1;127;0;0;0
322300296;1000;10;10;52;62;936;2;62;1;0;61;0;0;0
322300297;1000;45;45;72;104;893;3;104;0;0;104;0;0;0
322300298;1000;45;45;18;44;955;1;44;0;0;44;0;0;0
322300299;600;50;50;205;241;599;1;0;0;0;0;241;0;241
322300300;600;50;50;245;280;319;1;280;5;3;272;0;0;0
322300301;800;114;114;429;508;799;1;0;0;0;0;508;2;506
322300302;1000;51;51;34;60;939;1;60;1;1;58;0;0;0
322300303;1000;74;74;118;168;831;1;168;5;0;163;0;0;0
322300304;1000;79;79;180;247;751;2;247;7;2;238;0;0;0
322300305;1000;54;54;79;111;882;7;111;2;0;109;0;0;0
322300306;1000;63;63;68;121;878;1;121;1;1;119;0;0;0
322300307;1000;5;5;90;95;903;2;95;2;2;91;0;0;0
322300308;1000;34;34;60;78;920;2;78;0;1;77;0;0;0
322300309;1000;89;89;206;279;999;1;0;0;0;0;279;0;279
322300310;1000;64;64;81;126;872;2;126;1;3;122;0;0;0
322300311;1000;53;53;79;118;876;6;118;1;2;115;0;0;0
322300312;1000;49;49;96;145;852;3;145;2;1;142;0;0;0
322300313;1000;65;65;96;142;855;3;142;3;1;138;0;0;0
322300314;1000;45;45;28;60;939;1;60;1;0;59;0;0;0
322300315;1000;17;17;71;82;917;1;82;0;0;82;0;0;0
322300316;1000;51;51;27;53;944;3;53;7;0;46;0;0;0
322400317;100;14;14;33;46;50;4;46;1;0;45;0;0;0
322500318;400;52;52;179;224;172;4;224;3;3;218;0;0;0
322500319;600;78;78;276;348;600;0;0;0;0;0;348;4;344
322500320;600;119;119;172;277;599;1;0;0;0;0;277;1;276
322500321;300;70;70;185;239;59;2;239;4;3;232;0;0;0
322500322;300;42;42;50;88;211;1;88;0;0;88;0;0;0
322500323;300;48;48;113;150;148;2;150;3;1;146;0;0;0
322500324;200;53;53;19;54;142;4;54;0;1;53;0;0;0
322500325;200;57;57;54;100;99;1;100;1;2;97;0;0;0
322500326;700;128;128;259;369;699;1;0;0;0;0;369;1;368
322500327;500;94;94;205;282;499;1;0;0;0;0;282;2;280
322500328;500;68;68;212;201;499;1;0;0;0;0;201;0;201
322500329;300;86;86;39;80;219;1;80;1;0;79;0;0;0
322500330;200;65;65;61;118;79;3;118;1;1;116;0;0;0
322500331;1000;40;40;242;274;1000;0;0;0;0;0;274;3;271
322500332;500;43;43;98;128;371;1;128;2;0;126;0;0;0
322500333;200;48;48;1;36;163;1;36;0;0;36;0;0;0
322600334;200;10;10;30;38;161;1;38;2;0;36;0;0;0
322700335;1100;98;98;338;395;1099;1;0;0;0;0;395;2;393
322700336;800;145;145;0;145;654;1;145;2;1;142;0;0;0
322700337;500;50;50;104;129;371;0;129;3;2;124;0;0;0
322700338;1000;86;86;335;401;999;1;0;0;0;0;401;4;397
322700339;700;116;116;401;497;699;1;0;0;0;0;497;4;493
322700340;800;96;96;298;374;799;1;0;0;0;0;374;1;373
322700341;1500;152;152;310;433;1499;1;0;0;0;0;433;2;431
322700342;500;48;48;47;77;422;1;77;0;1;76;0;0;0
322800343;100;17;17;16;29;70;1;29;0;3;26;0;0;0
322800344;100;24;24;20;39;59;2;39;0;0;39;0;0;0
322900345;200;8;8;47;53;146;1;53;2;3;48;0;0;0
323000346;300;27;27;34;57;242;1;57;1;0;56;0;0;0
323100347;200;0;0;14;14;185;1;14;0;0;14;0;0;0
323200348;200;13;13;23;35;164;1;35;0;0;35;0;0;0
323300349;600;105;105;355;439;599;1;0;0;0;0;439;7;432
323300350;800;40;40;177;210;582;8;210;4;0;206;0;0;0
323400351;1500;80;80;249;319;1500;0;0;0;0;0;319;3;316
323400352;1500;95;95;327;401;1493;7;0;0;0;0;401;3;398
323500353;100;0;0;31;31;67;2;31;1;1;29;0;0;0
323600354;100;8;8;10;16;83;1;16;0;2;14;0;0;0
323700355;1000;5;5;440;441;554;5;441;97;2;342;0;0;0
323700356;1000;12;12;91;101;897;2;101;14;0;87;0;0;0
323700357;500;52;52;79;95;402;3;95;12;0;83;0;0;0
323700358;500;11;11;254;265;234;1;265;34;0;231;0;0;0
323700359;500;66;66;151;210;289;1;210;17;1;192;0;0;0
323700360;500;51;51;144;143;352;5;143;23;0;120;0;0;0
323800361;100;7;7;10;17;81;2;17;0;1;16;0;0;0
323900362;1500;50;50;483;519;1499;1;0;0;0;0;519;3;516
323900363;1500;52;52;301;332;1499;1;0;0;0;0;332;8;324
323900364;1000;96;96;333;358;639;3;358;17;4;337;0;0;0
323900365;1500;120;120;320;418;1498;2;0;0;0;0;418;15;403
323900366;1500;49;49;341;377;1499;1;0;0;0;0;377;2;375
323900367;1500;61;61;264;310;1189;1;310;10;3;297;0;0;0
323900368;1000;23;23;101;113;885;2;113;0;1;112;0;0;0
323900369;1000;54;54;288;330;999;1;0;0;0;0;330;5;325
323900370;1000;11;11;81;91;905;4;91;1;3;87;0;0;0
323900371;1000;41;41;239;272;724;4;272;7;3;262;0;0;0
323900372;1000;42;42;60;90;909;1;90;3;2;85;0;0;0
323900373;1000;42;42;119;151;999;1;0;0;0;0;151;4;147
323900374;1000;22;22;114;132;866;2;132;7;5;120;0;0;0
323900375;1000;10;10;79;89;910;1;89;1;1;87;0;0;0
323900376;1000;12;12;52;61;938;1;61;2;0;59;0;0;0
323900377;1000;46;46;46;66;933;1;66;2;0;64;0;0;0
323900378;1000;89;89;341;412;999;1;0;0;0;0;412;5;407
323900379;1000;38;38;175;207;999;1;0;0;0;0;207;3;204
323900380;1000;20;20;193;207;999;1;0;0;0;0;207;3;204
323900381;1000;45;45;121;162;836;2;162;2;0;160;0;0;0
324000382;300;45;45;110;151;143;6;151;4;4;143;0;0;0
324000383;200;46;46;3;39;160;1;39;1;1;37;0;0;0
324100384;800;174;174;132;268;800;0;0;0;0;0;268;8;260
324100385;800;0;0;60;60;739;1;60;1;2;57;0;0;0
324100386;500;32;32;50;79;420;1;79;1;0;78;0;0;0
324100387;300;57;57;8;35;264;1;35;0;0;35;0;0;0
324100388;300;22;22;33;51;248;1;51;0;1;50;0;0;0
324100389;300;39;39;58;87;212;1;87;0;2;85;0;0;0
324100390;300;45;45;11;45;254;1;45;0;0;45;0;0;0
324100391;500;57;57;67;114;385;1;114;0;0;114;0;0;0
324100392;300;35;35;39;66;233;1;66;1;0;65;0;0;0
324100393;300;49;49;16;54;245;1;54;1;0;53;0;0;0
324100394;300;38;38;28;64;235;1;64;1;1;62;0;0;0
324200395;200;18;18;42;54;143;3;54;1;1;52;0;0;0
324200396;1000;51;51;169;205;999;1;0;0;0;0;205;0;205
324300397;500;75;75;85;146;499;1;0;0;0;0;146;0;146
324300398;800;106;106;167;250;800;0;0;0;0;0;250;2;248
324300399;500;42;42;117;143;354;3;143;1;2;140;0;0;0
324300400;500;87;87;92;161;334;5;161;6;3;152;0;0;0
324300401;500;67;67;102;160;338;2;160;1;1;158;0;0;0
324300402;500;80;80;66;122;376;2;122;0;1;121;0;0;0
324300403;0;35;35;295;321;0;0;0;0;0;0;321;4;317
324300404;800;104;104;48;119;680;1;119;1;2;116;0;0;0
324300405;500;82;82;146;210;287;3;210;4;2;204;0;0;0
324300406;500;70;70;204;258;237;5;258;4;3;251;0;0;0
324300407;800;96;96;138;215;581;4;215;6;2;207;0;0;0
324300408;500;57;57;294;344;152;4;344;8;2;334;0;0;0
324300409;800;138;138;158;256;800;0;0;0;0;0;256;0;256
324300410;800;117;117;146;240;799;1;0;0;0;0;240;0;240
324300411;800;107;107;129;214;584;2;214;8;1;205;0;0;0
324300412;500;74;74;189;263;233;4;263;11;3;249;0;0;0
324300413;800;119;119;223;317;475;8;317;13;3;301;0;0;0
324300414;500;94;94;224;304;187;9;304;4;3;297;0;0;0
324300415;500;81;81;162;198;299;3;198;5;0;193;0;0;0
324300416;500;139;139;202;279;214;7;279;4;1;274;0;0;0
324300417;800;82;82;200;265;799;1;0;0;0;0;265;3;262
324300418;800;72;72;114;167;630;3;167;5;1;161;0;0;0
324300419;800;170;170;112;236;799;1;0;0;0;0;236;0;236
324300420;500;79;79;52;115;384;1;115;3;2;110;0;0;0
324300421;500;62;62;93;143;354;3;143;6;1;136;0;0;0
324300422;500;78;78;61;129;369;2;129;0;6;123;0;0;0
324300423;500;60;60;44;96;403;1;96;4;2;90;0;0;0
324300424;800;129;129;163;268;529;3;268;23;1;244;0;0;0
324300425;800;138;138;148;265;799;1;0;0;0;0;265;3;262
324300426;500;62;62;34;88;410;2;88;2;5;81;0;0;0
324300427;800;58;58;234;292;800;0;0;0;0;0;292;3;289
324300428;800;72;72;68;127;671;2;127;2;1;124;0;0;0
324300429;500;43;43;311;345;154;1;345;9;4;332;0;0;0
324300430;500;68;68;40;90;409;1;90;0;1;89;0;0;0
324300431;800;66;66;287;353;800;0;0;0;0;0;353;2;351
324300432;800;50;50;60;110;690;0;110;1;2;107;0;0;0
324300433;500;26;26;115;133;365;2;133;2;0;131;0;0;0
324300434;500;132;132;144;243;253;4;243;7;2;234;0;0;0
324300435;500;79;79;110;154;344;2;154;6;1;147;0;0;0
324300436;500;54;54;83;114;386;0;114;0;1;113;0;0;0
324300437;800;131;131;256;337;459;4;337;5;3;329;0;0;0
324300438;800;85;85;154;239;547;14;239;16;1;222;0;0;0
324300439;500;107;107;190;277;499;1;0;0;0;0;277;0;277
324300440;500;71;71;118;183;312;5;183;14;3;166;0;0;0
324300441;500;212;212;461;613;500;0;0;0;0;0;613;6;607
324300442;500;181;181;204;320;179;1;320;9;1;310;0;0;0
324300443;500;0;0;567;567;500;0;0;0;0;0;567;3;564
324300444;500;0;0;236;236;263;1;236;1;1;234;0;0;0
324300445;1000;62;62;197;230;767;3;230;14;5;211;0;0;0
324300446;800;73;73;282;355;430;15;355;3;2;350;0;0;0
324300447;500;59;59;384;422;499;1;0;0;0;0;422;6;416
324300448;500;231;231;242;392;499;1;0;0;0;0;392;8;384
324300449;500;104;104;206;282;500;0;0;0;0;0;282;3;279
324300450;500;99;99;122;190;500;0;0;0;0;0;190;2;188
324300451;500;118;118;124;200;500;0;0;0;0;0;200;1;199
324300452;500;40;40;108;118;376;6;118;2;0;116;0;0;0
324300453;800;173;173;317;446;351;3;446;6;2;438;0;0;0
324300454;1000;367;367;225;367;1000;0;0;0;0;0;367;5;362
324300455;500;57;57;223;261;499;1;0;0;0;0;261;2;259
324300456;500;86;86;196;259;239;2;259;5;0;254;0;0;0
324300457;800;109;109;336;418;799;1;0;0;0;0;418;7;411
324300458;500;186;186;300;424;500;0;0;0;0;0;424;9;415
324300459;500;190;190;220;361;500;0;0;0;0;0;361;5;356
324300460;500;63;63;110;142;356;2;142;1;1;140;0;0;0
324300461;500;53;53;233;273;225;2;273;1;3;269;0;0;0
324300462;800;149;149;300;417;799;1;0;0;0;0;417;3;414
324300463;500;296;296;142;370;499;1;0;0;0;0;371;3;368
324300464;500;108;108;234;300;499;1;0;0;0;0;300;2;298
324300465;500;105;105;227;303;499;1;0;0;0;0;303;2;301
324300466;500;94;94;220;289;499;1;0;0;0;0;289;3;286
324300467;500;157;157;197;316;500;0;0;0;0;0;316;3;313
324300468;500;81;81;124;176;500;0;0;0;0;0;176;3;173
324300469;500;87;87;195;268;500;0;0;0;0;0;268;2;266
324300470;800;51;51;149;187;800;0;0;0;0;0;187;3;184
324300471;0;180;180;0;180;0;0;0;0;0;0;180;3;177
324300472;800;233;233;203;381;800;0;0;0;0;0;381;2;379
324300473;800;54;54;310;337;800;0;0;0;0;0;337;6;331
324300474;500;108;108;270;312;500;0;0;0;0;0;312;6;306
324300475;800;194;194;306;462;799;1;0;0;0;0;462;1;461
324300476;500;55;55;419;447;498;2;0;0;0;0;447;4;443
324300477;500;6;6;82;88;499;1;0;0;0;0;88;1;87
324300478;1000;176;176;281;393;999;1;0;0;0;0;393;2;391
324300479;800;23;23;144;160;799;1;0;0;0;0;160;1;159
324300480;8;78;78;184;246;8;0;0;0;0;0;246;0;246
324300481;500;94;94;226;301;500;0;0;0;0;0;301;1;300
324300482;800;22;22;508;508;799;1;0;0;0;0;519;4;515
324300483;800;196;196;191;387;799;1;0;0;0;0;387;6;381
324300484;800;192;192;302;413;799;1;0;0;0;0;413;1;412
324300485;800;0;0;106;106;799;1;0;0;0;0;106;3;103
324300486;500;120;120;97;188;499;1;0;0;0;0;188;2;186
324300487;500;0;0;67;67;432;1;67;8;1;58;0;0;0
324300488;800;207;207;303;426;799;1;0;0;0;0;426;4;422
324300489;800;0;0;267;267;531;2;267;6;6;255;0;0;0
324300490;1000;185;185;426;574;424;2;574;14;3;557;0;0;0
324300491;500;99;99;302;389;105;6;389;8;2;379;0;0;0
324300492;800;142;142;220;336;799;1;0;0;0;0;336;4;332
324300493;800;197;197;250;404;799;1;0;0;0;0;404;2;402
324300494;800;95;95;119;190;598;12;190;1;4;185;0;0;0
324300495;500;151;151;230;356;134;10;356;5;5;346;0;0;0
324300496;500;154;154;277;431;500;0;0;0;0;0;431;4;427
324300497;500;54;54;18;61;437;2;61;1;0;60;0;0;0
324300498;800;68;68;106;166;630;4;166;8;6;152;0;0;0
324300499;800;109;109;225;315;483;2;315;12;2;301;0;0;0
324300500;500;56;56;90;132;368;0;132;3;1;128;0;0;0
324300501;800;118;118;178;275;519;6;275;7;4;264;0;0;0
324300502;500;136;136;158;265;233;2;265;4;2;259;0;0;0
324300503;800;59;59;67;112;686;2;112;6;1;105;0;0;0
324300504;800;144;144;333;434;362;4;434;7;2;425;0;0;0
324300505;500;124;124;98;186;310;4;186;3;3;180;0;0;0
324300506;500;65;65;66;116;384;0;116;1;0;115;0;0;0
324300507;800;194;194;150;305;799;1;0;0;0;0;305;3;302
324300508;800;0;0;122;122;676;2;122;2;1;119;0;0;0
324300509;800;48;48;171;210;587;3;210;2;3;205;0;0;0
324300510;500;73;73;70;132;366;2;132;3;0;129;0;0;0
324300511;500;105;105;114;203;293;4;203;6;2;195;0;0;0
324300512;800;94;94;90;172;626;2;172;1;4;167;0;0;0
324300513;500;117;117;131;231;265;4;231;1;4;226;0;0;0
324300514;500;124;124;162;259;225;16;259;4;2;253;0;0;0
324300515;500;66;66;246;312;186;2;312;12;3;297;0;0;0
324300516;800;55;55;194;226;572;2;226;7;3;216;0;0;0
324300517;800;128;128;163;264;532;4;264;1;6;257;0;0;0
324300518;500;115;115;226;321;178;1;321;7;6;308;0;0;0
324300519;500;66;66;187;247;251;2;247;4;5;238;0;0;0
324300520;500;57;57;224;263;233;4;263;5;0;258;0;0;0
324300521;500;12;12;140;140;359;1;140;4;3;133;0;0;0
324300522;500;59;59;73;119;374;7;119;5;1;113;0;0;0
324300523;500;118;118;159;270;227;3;270;7;4;259;0;0;0
324300524;500;85;85;195;265;234;1;265;9;1;255;0;0;0
324300525;500;75;75;126;185;499;1;0;0;0;0;185;2;183
324300526;800;215;215;268;398;799;1;0;0;0;0;398;6;392
324300527;800;2;2;84;84;714;2;84;3;2;79;0;0;0
324300528;500;0;0;68;68;427;3;68;3;3;62;0;0;0
324300529;800;123;123;31;122;800;0;0;0;0;0;122;0;122
324300530;800;0;0;189;189;609;2;189;4;3;182;0;0;0
324300531;500;73;73;111;176;323;1;176;2;1;173;0;0;0
324400532;400;45;45;116;152;247;1;152;3;2;147;0;0;0
324400533;300;52;52;71;102;197;1;102;1;3;98;0;0;0
324500534;700;84;84;231;296;699;1;0;0;0;0;296;3;293
324500535;500;80;80;78;148;351;1;148;2;0;146;0;0;0
324500536;500;47;47;94;128;371;1;128;3;0;125;0;0;0
324600537;100;14;14;10;22;77;1;22;0;0;22;0;0;0
324700538;1000;12;12;112;123;876;1;123;4;3;116;0;0;0
324700539;1000;13;13;90;103;896;1;103;9;0;94;0;0;0
324700540;1000;40;40;60;80;919;1;80;5;1;74;0;0;0
324700541;1000;12;12;160;169;830;1;169;10;4;155;0;0;0
324700542;1000;81;81;93;108;891;1;108;7;0;101;0;0;0
324700543;1000;46;46;28;50;949;1;50;2;0;48;0;0;0
324800544;300;30;30;33;58;241;1;58;2;0;56;0;0;0
324800545;500;87;87;87;157;342;1;157;3;0;154;0;0;0
324800546;300;47;47;37;76;222;2;76;0;0;76;0;0;0
324900547;500;38;38;143;174;325;1;174;0;2;172;0;0;0
325000548;800;60;60;121;170;800;0;0;0;0;0;170;1;169
325000549;100;4;4;8;11;88;1;11;0;0;11;0;0;0
325000550;400;50;50;48;85;313;2;85;4;0;81;0;0;0
325000551;200;9;9;51;57;141;2;57;4;1;52;0;0;0
325000552;200;45;45;7;23;176;1;23;3;0;20;0;0;0
325100553;100;0;0;18;18;81;1;18;0;1;17;0;0;0
325200554;300;52;52;66;113;186;1;113;3;0;110;0;0;0
325200555;500;8;8;498;502;499;1;0;0;0;0;502;2;500
325200556;700;77;77;313;379;699;1;0;0;0;0;379;2;377
325200557;300;51;51;45;91;208;1;91;0;0;91;0;0;0
325200558;500;75;75;138;188;500;0;0;0;0;0;188;0;188
325200559;500;98;98;175;242;257;1;242;4;0;238;0;0;0
325200560;400;30;30;118;141;256;3;141;2;1;138;0;0;0
325200561;200;54;54;25;66;132;2;66;0;1;65;0;0;0
325200562;800;73;73;423;480;799;1;0;0;0;0;480;2;478
325200563;200;56;56;40;86;111;3;86;0;0;86;0;0;0
325200564;300;28;28;69;90;209;1;90;0;0;90;0;0;0
325200565;500;26;26;173;199;300;1;199;2;3;194;0;0;0
325200566;600;38;38;558;586;599;1;0;0;0;0;586;8;578
325200567;600;71;71;131;188;599;1;0;0;0;0;188;2;186
325200568;600;0;0;182;182;599;1;0;0;0;0;182;2;180
325200569;600;0;0;19;19;579;2;19;0;0;19;0;0;0
325200570;500;5;5;124;129;368;3;129;3;1;125;0;0;0
325200571;200;61;61;25;61;137;2;61;0;0;61;0;0;0
325200572;300;48;48;29;56;241;3;56;0;0;56;0;0;0
325200573;500;17;17;112;127;372;1;127;0;0;127;0;0;0
325200574;700;74;74;255;307;699;1;0;0;0;0;307;4;303
325200575;700;0;0;58;58;641;1;58;0;0;58;0;0;0
325200576;400;47;47;178;215;183;2;215;7;1;207;0;0;0
325200577;500;54;54;390;433;499;1;0;0;0;0;433;6;427
325200578;500;53;53;168;211;499;1;0;0;0;0;211;1;210
325200579;300;49;49;23;56;243;1;56;0;1;55;0;0;0
325200580;500;32;32;69;97;402;1;97;3;0;94;0;0;0
325200581;400;8;8;116;123;276;1;123;1;1;121;0;0;0
325200582;200;47;47;23;50;148;2;50;0;0;50;0;0;0
325200583;200;19;19;72;87;111;2;87;6;1;80;0;0;0
325200584;200;26;26;65;85;113;2;85;2;0;83;0;0;0
325200585;300;34;34;107;137;161;2;137;1;0;136;0;0;0
325200586;800;46;46;316;353;799;1;0;0;0;0;353;2;351
325200587;400;64;64;139;193;205;2;193;4;1;188;0;0;0
325200588;200;44;44;36;54;144;2;54;0;0;54;0;0;0
325200589;300;62;62;36;79;219;2;79;1;0;78;0;0;0
325200590;200;57;57;30;76;123;1;76;0;0;76;0;0;0
325200591;200;45;45;22;67;132;1;67;0;0;67;0;0;0
325200592;500;7;7;73;79;417;4;79;1;0;78;0;0;0
325200593;200;46;46;23;54;145;1;54;0;0;54;0;0;0
325200594;300;27;27;87;111;187;2;111;2;0;109;0;0;0
325200595;800;30;30;79;102;696;2;102;3;0;99;0;0;0
325200596;500;36;36;139;168;330;2;168;1;0;167;0;0;0
325200597;500;27;27;205;232;499;1;0;0;0;0;232;0;232
325200598;600;157;157;172;305;292;3;305;3;2;300;0;0;0
325200599;500;59;59;52;102;395;3;102;2;1;99;0;0;0
325200600;100;43;43;19;48;51;1;48;1;0;47;0;0;0
325200601;200;5;5;18;19;179;2;19;0;0;19;0;0;0
325200602;500;59;59;156;203;500;0;0;0;0;0;203;4;199
325200603;400;19;19;128;145;253;2;145;2;0;143;0;0;0
325200604;300;72;72;134;189;109;2;189;2;1;186;0;0;0
325200605;300;49;49;52;75;224;1;75;2;0;73;0;0;0
325200606;300;27;27;67;92;208;0;92;1;0;91;0;0;0
325200607;300;24;24;105;127;171;2;127;0;0;127;0;0;0
325200608;300;24;24;61;80;218;2;80;4;0;76;0;0;0
325200609;400;1;1;92;93;306;1;93;1;0;92;0;0;0
325200610;300;57;57;90;137;161;2;137;0;1;136;0;0;0
325200611;200;43;43;36;53;146;1;53;1;0;52;0;0;0
325300612;300;57;57;44;97;200;3;97;1;4;92;0;0;0
325400613;700;35;35;107;142;556;2;142;1;1;140;0;0;0
325500614;300;25;25;116;136;163;1;136;2;0;134;0;0;0
325600615;500;26;26;69;86;413;1;86;4;4;78;0;0;0
325600616;500;73;73;214;238;261;1;238;11;2;225;0;0;0
325600617;500;2;2;74;76;423;1;76;2;0;74;0;0;0
325600618;500;65;65;114;165;333;2;165;4;5;156;0;0;0
325600619;1000;2;2;297;299;700;1;299;9;1;289;0;0;0
325700620;100;2;2;10;10;89;1;10;0;0;10;0;0;0
325800621;2000;118;118;17;76;1922;2;76;6;0;70;0;0;0
325800622;2000;30;30;74;96;1903;1;96;5;2;89;0;0;0
325800623;2000;131;131;120;251;2000;0;0;0;0;0;251;0;251
325800624;2000;52;52;69;94;1905;1;94;6;0;88;0;0;0
325800625;2000;130;130;103;175;1821;4;175;9;1;165;0;0;0
325800626;2000;284;284;100;334;1655;11;334;11;1;322;0;0;0
325800627;2000;162;162;52;152;1845;3;152;2;0;150;0;0;0
325800628;2000;104;104;21;100;1899;1;100;0;0;100;0;0;0
325800629;2000;123;123;172;240;2000;0;0;0;0;0;240;0;240
325800630;2000;35;35;99;134;1999;1;0;0;0;0;134;0;134
325800631;2000;54;54;28;69;1930;1;69;6;0;63;0;0;0
325800632;2000;285;285;259;473;1520;7;473;37;0;436;0;0;0
325800633;2000;172;172;301;388;1999;1;0;0;0;0;388;0;388
325800634;2000;91;91;104;146;1853;1;146;5;0;141;0;0;0
325800635;2000;58;58;145;161;1832;7;161;14;0;147;0;0;0
325800636;2000;244;244;271;387;1603;10;387;24;0;363;0;0;0
325800637;2000;307;307;181;330;2000;0;0;0;0;0;330;1;329
325800638;2000;272;272;372;489;1506;5;489;65;2;422;0;0;0
325800639;2000;59;59;136;164;2000;0;0;0;0;0;164;0;164
325800640;2000;239;239;207;286;1999;1;0;0;0;0;286;0;286
325800641;2000;2;2;146;148;2000;0;0;0;0;0;148;0;148
325800642;2000;56;56;337;393;1999;1;0;0;0;0;393;0;393
325800643;2000;419;419;206;268;1727;5;268;21;1;246;0;0;0
325800644;2000;138;138;160;247;1748;5;247;22;0;225;0;0;0
325800645;2000;97;97;133;200;1795;5;200;0;1;199;0;0;0
325800646;2000;74;74;55;92;1906;2;92;9;0;83;0;0;0
325800647;2000;118;118;103;177;1822;1;177;24;2;151;0;0;0
325800648;2000;238;238;147;259;1728;13;259;31;1;227;0;0;0
325800649;2000;212;212;262;349;1643;8;349;40;0;309;0;0;0
325800650;2000;552;552;147;367;2000;0;0;0;0;0;367;0;367
325800651;2000;45;45;74;91;1906;3;91;4;0;87;0;0;0
325800652;2000;340;340;0;221;1999;1;0;0;0;0;221;0;221
325800653;2000;0;0;434;434;1562;4;434;45;1;388;0;0;0
325800654;2000;803;803;171;706;2000;0;0;0;0;0;706;0;706
325800655;2000;123;123;358;436;1562;2;436;53;0;383;0;0;0
325800656;2000;134;134;146;203;1791;6;203;12;0;191;0;0;0
325800657;2000;291;291;180;362;2000;0;0;0;0;0;362;0;362
325800658;2000;0;0;345;345;2000;0;0;0;0;0;345;0;345
325800659;2000;107;107;130;205;1794;1;205;9;0;196;0;0;0
325800660;2000;112;112;163;205;1787;8;205;14;0;191;0;0;0
325800661;2000;135;135;262;334;1999;1;0;0;0;0;334;0;334
325800662;2000;82;82;79;133;1866;1;133;11;1;121;0;0;0
325800663;2000;485;485;149;336;1998;2;0;0;0;0;336;0;336
325800664;2000;474;474;312;525;1999;1;0;0;0;0;525;0;525
325800665;2000;62;62;97;146;1853;1;146;23;2;121;0;0;0
325800666;2000;593;593;202;452;1999;1;0;0;0;0;452;0;452
325800667;2000;536;536;96;312;1999;1;0;0;0;0;312;0;312
325800668;2000;344;344;96;278;2000;0;0;0;0;0;278;0;278
325800669;2000;177;177;68;163;1999;1;0;0;0;0;163;0;163
325800670;2000;205;205;286;374;1626;0;374;18;0;356;0;0;0
325800671;2000;260;260;186;274;2000;0;0;0;0;0;274;0;274
325800672;2000;260;260;110;230;2000;0;0;0;0;0;230;0;230
325800673;2000;574;574;401;680;1999;1;0;0;0;0;680;0;680
325800674;500;82;82;146;208;499;1;0;0;0;0;208;0;208
325800675;2000;37;37;75;102;2000;0;0;0;0;0;102;0;102
325800676;2000;102;102;109;173;1819;8;173;10;0;163;0;0;0
325800677;2000;63;63;65;65;1933;2;65;5;0;60;0;0;0
325800678;2000;290;290;147;249;2000;0;0;0;0;0;249;1;248
325800679;2000;203;203;116;166;1831;3;166;16;1;149;0;0;0
325800680;2000;0;0;161;161;1837;2;161;11;0;150;0;0;0
325800681;2000;251;251;84;245;1753;2;245;6;0;239;0;0;0
325800682;2000;53;53;79;100;1897;3;100;10;0;90;0;0;0
325800683;2000;326;326;238;368;1999;1;0;0;0;0;368;0;368
325800684;2000;353;353;194;332;1999;1;0;0;0;0;332;0;332
325800685;2000;130;130;239;286;1712;2;286;25;1;260;0;0;0
325800686;2000;109;109;280;300;1698;2;300;39;0;261;0;0;0
325800687;2000;136;136;188;240;1758;2;240;24;0;216;0;0;0
325800688;2000;130;130;266;325;1672;3;325;26;1;298;0;0;0
325800689;2000;104;104;306;351;1643;6;351;48;0;303;0;0;0
325800690;2000;367;367;183;375;2000;0;0;0;0;0;375;0;375
325800691;2000;222;222;131;240;1998;2;0;0;0;0;240;1;239
325800692;500;85;85;115;166;328;6;166;17;1;148;0;0;0
325800693;2000;240;240;282;416;1999;1;0;0;0;0;416;0;416
325800694;2000;114;114;89;144;1845;11;144;8;0;136;0;0;0
325800695;2000;167;167;250;338;1657;5;338;18;1;319;0;0;0
325800696;2000;54;54;303;336;1660;4;336;45;0;291;0;0;0
325800697;2000;128;128;33;121;1877;2;121;4;0;117;0;0;0
325800698;2000;194;194;277;363;1999;1;0;0;0;0;363;1;362
325800699;2000;68;68;110;163;1835;2;163;22;0;141;0;0;0
325800700;2000;273;273;99;245;1999;1;0;0;0;0;245;0;245
325800701;2000;95;95;64;124;1875;1;124;10;0;114;0;0;0
325800702;2000;143;143;115;189;1810;1;189;30;1;158;0;0;0
325800703;2000;89;89;39;100;1899;1;100;7;0;93;0;0;0
325800704;2000;73;73;113;186;1813;1;186;26;0;160;0;0;0
325800705;2000;336;336;169;256;1999;1;0;0;0;0;256;1;255
325800706;2000;52;52;107;159;1999;1;0;0;0;0;159;0;159
325800707;2000;196;196;124;239;2000;0;0;0;0;0;239;0;239
325800708;2000;193;193;133;246;1753;1;246;9;0;237;0;0;0
325800709;2000;224;224;520;660;1339;1;660;25;0;635;0;0;0
325800710;2000;283;283;224;432;1563;5;432;22;2;408;0;0;0
325800711;2000;562;562;338;507;1999;1;0;0;0;0;507;0;507
325800712;2000;167;167;81;171;1826;3;171;18;1;152;0;0;0
325800713;2000;331;331;213;327;1999;1;0;0;0;0;327;0;327
325800714;2000;212;212;141;221;1778;1;221;18;1;202;0;0;0
325800715;2000;189;189;378;411;2000;0;0;0;0;0;411;0;411
325800716;2000;323;323;122;297;1700;3;297;4;2;291;0;0;0
325800717;2000;101;101;230;280;1718;2;280;11;1;268;0;0;0
325800718;2000;143;143;127;168;1827;5;168;20;0;148;0;0;0
325800719;2000;314;314;218;338;1999;1;0;0;0;0;338;0;338
325800720;2000;16;16;75;89;1999;1;0;0;0;0;89;1;88
325800721;2000;134;134;165;201;1793;6;201;15;0;186;0;0;0
325800722;2000;54;54;99;132;1867;1;132;17;0;115;0;0;0
325800723;2000;339;339;290;377;1622;1;377;28;1;348;0;0;0
325800724;0;381;381;344;453;0;0;0;0;0;0;453;1;452
325800725;2000;336;336;176;269;2000;0;0;0;0;0;269;0;269
325800726;2000;363;363;71;168;1999;1;0;0;0;0;168;0;168
325800727;2000;614;614;0;614;2000;0;0;0;0;0;614;0;614
325800728;2000;525;525;323;480;1999;1;0;0;0;0;480;1;479
325800729;2000;541;541;121;286;1999;1;0;0;0;0;286;0;286
325800730;2000;545;545;162;544;1999;1;0;0;0;0;544;0;544
325800731;2000;109;109;37;108;1891;1;108;10;0;98;0;0;0
325800732;2000;334;334;112;334;1662;4;334;7;0;327;0;0;0
325900733;400;8;8;40;48;351;1;48;3;0;45;0;0;0
325900734;500;11;11;54;62;437;1;62;5;0;57;0;0;0
326000735;900;18;18;187;204;693;3;204;5;4;195;0;0;0
326100736;200;30;30;35;61;137;2;61;1;0;60;0;0;0
326100737;400;75;75;153;220;178;2;220;7;0;213;0;0;0
326100738;200;35;35;43;72;127;1;72;0;2;70;0;0;0
326100739;200;51;51;36;68;131;1;68;2;1;65;0;0;0
326200740;1000;73;73;300;355;1000;0;0;0;0;0;355;2;353
326200741;1000;73;73;396;453;999;1;0;0;0;0;453;1;452
326200742;1000;57;57;370;413;999;1;0;0;0;0;413;7;406
326200743;500;52;52;28;67;431;2;67;0;1;66;0;0;0
326200744;1000;69;69;92;145;999;1;0;0;0;0;145;1;144
326200745;1000;86;86;23;43;956;1;43;1;0;42;0;0;0
326200746;600;54;54;84;127;471;2;127;5;0;122;0;0;0
326200747;600;25;25;70;89;510;1;89;0;1;88;0;0;0
326200748;1000;80;80;269;337;999;1;0;0;0;0;337;3;334
326200749;1000;50;50;174;209;789;2;209;5;2;202;0;0;0
326200750;600;18;18;104;119;480;1;119;0;1;118;0;0;0
326200751;500;9;9;27;33;466;1;33;1;0;32;0;0;0
326200752;1000;115;115;278;371;999;1;0;0;0;0;371;3;368
326200753;500;54;54;88;93;402;5;93;2;0;91;0;0;0
326200754;600;37;37;81;110;489;1;110;1;3;106;0;0;0
326200755;600;34;34;149;181;418;1;181;6;7;168;0;0;0
326200756;1000;33;33;165;193;802;5;193;6;0;187;0;0;0
326200757;800;50;50;306;342;454;4;342;6;4;332;0;0;0
326200758;1000;54;54;174;221;998;2;0;0;0;0;221;2;219
326300759;200;28;28;49;74;124;2;74;0;2;72;0;0;0
326400760;200;8;8;16;23;175;2;23;1;0;22;0;0;0
326500761;1500;125;125;314;400;1499;1;0;0;0;0;400;5;395
326500762;1500;101;101;230;331;1164;5;331;12;6;313;0;0;0
326500763;1500;71;71;159;212;1286;2;212;4;5;203;0;0;0
326500764;1000;48;48;97;131;868;1;131;3;4;124;0;0;0
326500765;1000;49;49;86;122;876;2;122;1;1;120;0;0;0
326500766;1500;92;92;93;165;1331;4;165;3;0;162;0;0;0
326500767;1500;154;154;198;313;1179;8;313;16;3;294;0;0;0
326500768;1000;41;41;36;55;941;4;55;3;3;49;0;0;0
326500769;1000;53;53;19;59;939;2;59;3;0;56;0;0;0
326600770;500;37;37;194;226;271;3;226;6;1;219;0;0;0
326600771;500;43;43;181;211;287;2;211;6;2;203;0;0;0
326600772;600;86;86;222;288;599;1;0;0;0;0;288;2;286
326600773;400;44;44;115;148;251;1;148;1;2;145;0;0;0
326600774;300;6;6;66;71;228;1;71;0;1;70;0;0;0
326600775;600;62;62;49;86;512;2;86;0;2;84;0;0;0
326600776;300;32;32;65;87;212;1;87;3;2;82;0;0;0
326600777;500;64;64;186;235;498;2;0;0;0;0;235;1;234
326600778;1000;220;220;231;408;1000;0;0;0;0;0;408;2;406
326600779;1000;38;38;146;176;821;3;176;0;2;174;0;0;0
326700780;1200;76;76;268;330;1200;0;0;0;0;0;330;3;327
326700781;700;35;35;155;187;509;4;187;1;0;186;0;0;0
326700782;700;45;45;134;170;528;2;170;12;1;157;0;0;0
326800783;200;44;44;36;77;122;1;77;1;0;76;0;0;0
326800784;200;47;47;7;33;166;1;33;0;0;33;0;0;0
